9,00001001,60,00111100,69,01000101
91,01011011,111,01101111,202,11001010
35,00100011,83,01010011,118,01110110
76,01001100,18,00010010,94,01011110
113,01110001,74,01001010,187,10111011
98,01100010,97,01100001,195,11000011
43,00101011,3,00000011,46,00101110
12,00001100,100,01100100,112,01110000
58,00111010,1,00000001,59,00111011
113,01110001,0,00000000,113,01110001
39,00100111,24,00011000,63,00111111
58,00111010,36,00100100,94,01011110
99,01100011,69,01000101,168,10101000
6,00000110,3,00000011,9,00001001
98,01100010,121,01111001,219,11011011
40,00101000,60,00111100,100,01100100
33,00100001,28,00011100,61,00111101
68,01000100,26,00011010,94,01011110
96,01100000,120,01111000,216,11011000
109,01101101,51,00110011,160,10100000
73,01001001,53,00110101,126,01111110
69,01000101,33,00100001,102,01100110
7,00000111,125,01111101,132,10000100
94,01011110,72,01001000,166,10100110
118,01110110,84,01010100,202,11001010
7,00000111,67,01000011,74,01001010
85,01010101,91,01011011,176,10110000
108,01101100,67,01000011,175,10101111
102,01100110,84,01010100,186,10111010
71,01000111,83,01010011,154,10011010
95,01011111,0,00000000,95,01011111
5,00000101,91,01011011,96,01100000
107,01101011,30,00011110,137,10001001
73,01001001,83,01010011,156,10011100
7,00000111,21,00010101,28,00011100
101,01100101,92,01011100,193,11000001
8,00001000,43,00101011,51,00110011
46,00101110,0,00000000,46,00101110
104,01101000,51,00110011,155,10011011
38,00100110,89,01011001,127,01111111
74,01001010,115,01110011,189,10111101
98,01100010,123,01111011,221,11011101
87,01010111,96,01100000,183,10110111
83,01010011,26,00011010,109,01101101
78,01001110,32,00100000,110,01101110
115,01110011,70,01000110,185,10111001
97,01100001,44,00101100,141,10001101
59,00111011,57,00111001,116,01110100
50,00110010,45,00101101,95,01011111
105,01101001,4,00000100,109,01101101
57,00111001,93,01011101,150,10010110
91,01011011,17,00010001,108,01101100
35,00100011,66,01000010,101,01100101
20,00010100,45,00101101,65,01000001
57,00111001,79,01001111,136,10001000
119,01110111,36,00100100,155,10011011
105,01101001,62,00111110,167,10100111
4,00000100,113,01110001,117,01110101
114,01110010,77,01001101,191,10111111
30,00011110,109,01101101,139,10001011
87,01010111,98,01100010,185,10111001
35,00100011,73,01001001,108,01101100
90,01011010,55,00110111,145,10010001
26,00011010,118,01110110,144,10010000
22,00010110,76,01001100,98,01100010
79,01001111,98,01100010,177,10110001
90,01011010,51,00110011,141,10001101
102,01100110,46,00101110,148,10010100
80,01010000,61,00111101,141,10001101
60,00111100,47,00101111,107,01101011
122,01111010,104,01101000,226,11100010
0,00000000,10,00001010,10,00001010
75,01001011,13,00001101,88,01011000
71,01000111,94,01011110,165,10100101
6,00000110,45,00101101,51,00110011
117,01110101,30,00011110,147,10010011
15,00001111,41,00101001,56,00111000
38,00100110,53,00110101,91,01011011
43,00101011,82,01010010,125,01111101
7,00000111,92,01011100,99,01100011
65,01000001,41,00101001,106,01101010
66,01000010,114,01110010,180,10110100
92,01011100,78,01001110,170,10101010
101,01100101,91,01011011,192,11000000
118,01110110,100,01100100,218,11011010
31,00011111,93,01011101,124,01111100
50,00110010,124,01111100,174,10101110
46,00101110,93,01011101,139,10001011
114,01110010,33,00100001,147,10010011
12,00001100,96,01100000,108,01101100
105,01101001,80,01010000,185,10111001
66,01000010,72,01001000,138,10001010
115,01110011,125,01111101,240,11110000
10,00001010,112,01110000,122,01111010
90,01011010,27,00011011,117,01110101
56,00111000,120,01111000,176,10110000
65,01000001,64,01000000,129,10000001
69,01000101,88,01011000,157,10011101
34,00100010,79,01001111,113,01110001
3,00000011,60,00111100,63,00111111
110,01101110,37,00100101,147,10010011
43,00101011,83,01010011,126,01111110
88,01011000,70,01000110,158,10011110
20,00010100,6,00000110,26,00011010
28,00011100,115,01110011,143,10001111
6,00000110,66,01000010,72,01001000
92,01011100,92,01011100,184,10111000
102,01100110,101,01100101,203,11001011
123,01111011,69,01000101,192,11000000
109,01101101,73,01001001,182,10110110
100,01100100,54,00110110,154,10011010
77,01001101,21,00010101,98,01100010
123,01111011,31,00011111,154,10011010
81,01010001,35,00100011,116,01110100
109,01101101,115,01110011,224,11100000
122,01111010,8,00001000,130,10000010
126,01111110,25,00011001,151,10010111
21,00010101,45,00101101,66,01000010
101,01100101,86,01010110,187,10111011
16,00010000,25,00011001,41,00101001
110,01101110,119,01110111,229,11100101
37,00100101,127,01111111,164,10100100
1,00000001,5,00000101,6,00000110
70,01000110,12,00001100,82,01010010
90,01011010,74,01001010,164,10100100
123,01111011,54,00110110,177,10110001
78,01001110,62,00111110,140,10001100
72,01001000,71,01000111,143,10001111
45,00101101,5,00000101,50,00110010
47,00101111,59,00111011,106,01101010
42,00101010,67,01000011,109,01101101
10,00001010,114,01110010,124,01111100
57,00111001,91,01011011,148,10010100
89,01011001,3,00000011,92,01011100
125,01111101,78,01001110,203,11001011
82,01010010,69,01000101,151,10010111
58,00111010,4,00000100,62,00111110
17,00010001,69,01000101,86,01010110
63,00111111,94,01011110,157,10011101
24,00011000,3,00000011,27,00011011
69,01000101,40,00101000,109,01101101
36,00100100,58,00111010,94,01011110
49,00110001,55,00110111,104,01101000
24,00011000,33,00100001,57,00111001
18,00010010,97,01100001,115,01110011
78,01001110,113,01110001,191,10111111
7,00000111,53,00110101,60,00111100
107,01101011,46,00101110,153,10011001
112,01110000,116,01110100,228,11100100
127,01111111,33,00100001,160,10100000
81,01010001,29,00011101,110,01101110
12,00001100,118,01110110,130,10000010
46,00101110,118,01110110,164,10100100
32,00100000,34,00100010,66,01000010
115,01110011,87,01010111,202,11001010
124,01111100,25,00011001,149,10010101
46,00101110,114,01110010,160,10100000
107,01101011,52,00110100,159,10011111
105,01101001,110,01101110,215,11010111
64,01000000,76,01001100,140,10001100
118,01110110,73,01001001,191,10111111
18,00010010,4,00000100,22,00010110
7,00000111,3,00000011,10,00001010
48,00110000,76,01001100,124,01111100
37,00100101,116,01110100,153,10011001
109,01101101,48,00110000,157,10011101
109,01101101,82,01010010,191,10111111
51,00110011,49,00110001,100,01100100
71,01000111,90,01011010,161,10100001
49,00110001,110,01101110,159,10011111
29,00011101,3,00000011,32,00100000
74,01001010,84,01010100,158,10011110
106,01101010,65,01000001,171,10101011
119,01110111,20,00010100,139,10001011
80,01010000,42,00101010,122,01111010
114,01110010,28,00011100,142,10001110
26,00011010,87,01010111,113,01110001
52,00110100,48,00110000,100,01100100
66,01000010,102,01100110,168,10101000
9,00001001,2,00000010,11,00001011
116,01110100,108,01101100,224,11100000
105,01101001,89,01011001,194,11000010
124,01111100,117,01110101,241,11110001
100,01100100,90,01011010,190,10111110
68,01000100,105,01101001,173,10101101
10,00001010,12,00001100,22,00010110
104,01101000,97,01100001,201,11001001
37,00100101,39,00100111,76,01001100
32,00100000,122,01111010,154,10011010
33,00100001,26,00011010,59,00111011
99,01100011,89,01011001,188,10111100
50,00110010,88,01011000,138,10001010
82,01010010,20,00010100,102,01100110
94,01011110,28,00011100,122,01111010
72,01001000,18,00010010,90,01011010
25,00011001,24,00011000,49,00110001
39,00100111,106,01101010,145,10010001
123,01111011,28,00011100,151,10010111
24,00011000,18,00010010,42,00101010
67,01000011,44,00101100,111,01101111
83,01010011,45,00101101,128,10000000
54,00110110,0,00000000,54,00110110
10,00001010,67,01000011,77,01001101
6,00000110,91,01011011,97,01100001
99,01100011,57,00111001,156,10011100
70,01000110,19,00010011,89,01011001
34,00100010,50,00110010,84,01010100
114,01110010,102,01100110,216,11011000
20,00010100,43,00101011,63,00111111
118,01110110,0,00000000,118,01110110
100,01100100,109,01101101,209,11010001
105,01101001,66,01000010,171,10101011
97,01100001,12,00001100,109,01101101
15,00001111,118,01110110,133,10000101
33,00100001,23,00010111,56,00111000
12,00001100,5,00000101,17,00010001
38,00100110,1,00000001,39,00100111
10,00001010,6,00000110,16,00010000
125,01111101,6,00000110,131,10000011
102,01100110,38,00100110,140,10001100
75,01001011,114,01110010,189,10111101
85,01010101,126,01111110,211,11010011
114,01110010,50,00110010,164,10100100
51,00110011,2,00000010,53,00110101
76,01001100,29,00011101,105,01101001
9,00001001,115,01110011,124,01111100
72,01001000,5,00000101,77,01001101
116,01110100,53,00110101,169,10101001
107,01101011,65,01000001,172,10101100
43,00101011,79,01001111,122,01111010
62,00111110,76,01001100,138,10001010
47,00101111,76,01001100,123,01111011
21,00010101,120,01111000,141,10001101
18,00010010,89,01011001,107,01101011
13,00001101,94,01011110,107,01101011
92,01011100,108,01101100,200,11001000
105,01101001,85,01010101,190,10111110
6,00000110,100,01100100,106,01101010
48,00110000,40,00101000,88,01011000
26,00011010,30,00011110,56,00111000
5,00000101,15,00001111,20,00010100
63,00111111,101,01100101,164,10100100
37,00100101,59,00111011,96,01100000
113,01110001,95,01011111,208,11010000
96,01100000,112,01110000,208,11010000
80,01010000,32,00100000,112,01110000
62,00111110,10,00001010,72,01001000
12,00001100,93,01011101,105,01101001
64,01000000,29,00011101,93,01011101
90,01011010,103,01100111,193,11000001
22,00010110,19,00010011,41,00101001
5,00000101,36,00100100,41,00101001
83,01010011,127,01111111,210,11010010
100,01100100,5,00000101,105,01101001
92,01011100,76,01001100,168,10101000
26,00011010,113,01110001,139,10001011
83,01010011,12,00001100,95,01011111
102,01100110,7,00000111,109,01101101
52,00110100,80,01010000,132,10000100
29,00011101,0,00000000,29,00011101
87,01010111,79,01001111,166,10100110
74,01001010,124,01111100,198,11000110
3,00000011,61,00111101,64,01000000
67,01000011,16,00010000,83,01010011
112,01110000,73,01001001,185,10111001
84,01010100,116,01110100,200,11001000
101,01100101,127,01111111,228,11100100
56,00111000,62,00111110,118,01110110
56,00111000,48,00110000,104,01101000
17,00010001,117,01110101,134,10000110
57,00111001,9,00001001,66,01000010
108,01101100,62,00111110,170,10101010
79,01001111,102,01100110,181,10110101
78,01001110,33,00100001,111,01101111
4,00000100,16,00010000,20,00010100
100,01100100,71,01000111,171,10101011
62,00111110,23,00010111,85,01010101
91,01011011,110,01101110,201,11001001
7,00000111,125,01111101,132,10000100
22,00010110,98,01100010,120,01111000
30,00011110,118,01110110,148,10010100
80,01010000,27,00011011,107,01101011
47,00101111,111,01101111,158,10011110
114,01110010,11,00001011,125,01111101
87,01010111,78,01001110,165,10100101
103,01100111,30,00011110,133,10000101
90,01011010,34,00100010,124,01111100
54,00110110,81,01010001,135,10000111
35,00100011,71,01000111,106,01101010
109,01101101,59,00111011,168,10101000
112,01110000,37,00100101,149,10010101
68,01000100,53,00110101,121,01111001
13,00001101,101,01100101,114,01110010
19,00010011,107,01101011,126,01111110
8,00001000,96,01100000,104,01101000
81,01010001,69,01000101,150,10010110
124,01111100,100,01100100,224,11100000
1,00000001,125,01111101,126,01111110
29,00011101,5,00000101,34,00100010
80,01010000,102,01100110,182,10110110
120,01111000,40,00101000,160,10100000
22,00010110,30,00011110,52,00110100
127,01111111,19,00010011,146,10010010
4,00000100,20,00010100,24,00011000
106,01101010,74,01001010,180,10110100
123,01111011,67,01000011,190,10111110
86,01010110,60,00111100,146,10010010
101,01100101,122,01111010,223,11011111
93,01011101,41,00101001,134,10000110
40,00101000,60,00111100,100,01100100
81,01010001,51,00110011,132,10000100
40,00101000,59,00111011,99,01100011
106,01101010,94,01011110,200,11001000
29,00011101,97,01100001,126,01111110
94,01011110,110,01101110,204,11001100
37,00100101,126,01111110,163,10100011
88,01011000,16,00010000,104,01101000
99,01100011,39,00100111,138,10001010
29,00011101,124,01111100,153,10011001
65,01000001,23,00010111,88,01011000
72,01001000,0,00000000,72,01001000
87,01010111,37,00100101,124,01111100
111,01101111,63,00111111,174,10101110
26,00011010,89,01011001,115,01110011
89,01011001,6,00000110,95,01011111
88,01011000,119,01110111,207,11001111
79,01001111,101,01100101,180,10110100
41,00101001,17,00010001,58,00111010
80,01010000,112,01110000,192,11000000
43,00101011,110,01101110,153,10011001
69,01000101,118,01110110,187,10111011
19,00010011,111,01101111,130,10000010
22,00010110,109,01101101,131,10000011
11,00001011,11,00001011,22,00010110
33,00100001,7,00000111,40,00101000
119,01110111,26,00011010,145,10010001
48,00110000,71,01000111,119,01110111
111,01101111,54,00110110,165,10100101
96,01100000,100,01100100,196,11000100
82,01010010,87,01010111,169,10101001
21,00010101,126,01111110,147,10010011
2,00000010,8,00001000,10,00001010
10,00001010,5,00000101,15,00001111
38,00100110,38,00100110,76,01001100
100,01100100,65,01000001,165,10100101
117,01110101,59,00111011,176,10110000
36,00100100,5,00000101,41,00101001
5,00000101,38,00100110,43,00101011
35,00100011,88,01011000,123,01111011
49,00110001,79,01001111,128,10000000
84,01010100,114,01110010,198,11000110
9,00001001,119,01110111,128,10000000
4,00000100,49,00110001,53,00110101
24,00011000,94,01011110,118,01110110
2,00000010,83,01010011,85,01010101
3,00000011,77,01001101,80,01010000
11,00001011,13,00001101,24,00011000
100,01100100,81,01010001,181,10110101
26,00011010,70,01000110,96,01100000
47,00101111,98,01100010,145,10010001
21,00010101,20,00010100,41,00101001
42,00101010,122,01111010,164,10100100
57,00111001,17,00010001,74,01001010
101,01100101,89,01011001,190,10111110
116,01110100,85,01010101,201,11001001
55,00110111,100,01100100,155,10011011
68,01000100,111,01101111,179,10110011
98,01100010,11,00001011,109,01101101
98,01100010,97,01100001,195,11000011
110,01101110,19,00010011,129,10000001
112,01110000,11,00001011,123,01111011
97,01100001,25,00011001,122,01111010
97,01100001,95,01011111,192,11000000
45,00101101,6,00000110,51,00110011
89,01011001,88,01011000,177,10110001
109,01101101,38,00100110,147,10010011
51,00110011,16,00010000,67,01000011
23,00010111,90,01011010,113,01110001
3,00000011,90,01011010,93,01011101
46,00101110,122,01111010,168,10101000
29,00011101,2,00000010,31,00011111
5,00000101,121,01111001,126,01111110
71,01000111,15,00001111,86,01010110
78,01001110,35,00100011,113,01110001
52,00110100,103,01100111,155,10011011
118,01110110,7,00000111,125,01111101
51,00110011,102,01100110,153,10011001
121,01111001,51,00110011,172,10101100
29,00011101,55,00110111,84,01010100
113,01110001,11,00001011,124,01111100
67,01000011,77,01001101,144,10010000
122,01111010,55,00110111,177,10110001
88,01011000,123,01111011,211,11010011
124,01111100,120,01111000,244,11110100
68,01000100,117,01110101,185,10111001
115,01110011,86,01010110,201,11001001
57,00111001,93,01011101,150,10010110
102,01100110,11,00001011,113,01110001
78,01001110,82,01010010,160,10100000
89,01011001,108,01101100,197,11000101
3,00000011,37,00100101,40,00101000
7,00000111,29,00011101,36,00100100
78,01001110,11,00001011,89,01011001
73,01001001,11,00001011,84,01010100
16,00010000,60,00111100,76,01001100
123,01111011,103,01100111,226,11100010
63,00111111,59,00111011,122,01111010
1,00000001,18,00010010,19,00010011
53,00110101,28,00011100,81,01010001
64,01000000,85,01010101,149,10010101
88,01011000,73,01001001,161,10100001
8,00001000,82,01010010,90,01011010
11,00001011,92,01011100,103,01100111
117,01110101,51,00110011,168,10101000
81,01010001,55,00110111,136,10001000
15,00001111,3,00000011,18,00010010
106,01101010,88,01011000,194,11000010
85,01010101,28,00011100,113,01110001
58,00111010,85,01010101,143,10001111
78,01001110,111,01101111,189,10111101
65,01000001,76,01001100,141,10001101
11,00001011,25,00011001,36,00100100
103,01100111,11,00001011,114,01110010
90,01011010,109,01101101,199,11000111
34,00100010,1,00000001,35,00100011
126,01111110,16,00010000,142,10001110
1,00000001,16,00010000,17,00010001
33,00100001,33,00100001,66,01000010
44,00101100,102,01100110,146,10010010
40,00101000,72,01001000,112,01110000
77,01001101,106,01101010,183,10110111
83,01010011,114,01110010,197,11000101
32,00100000,23,00010111,55,00110111
68,01000100,31,00011111,99,01100011
22,00010110,64,01000000,86,01010110
101,01100101,31,00011111,132,10000100
79,01001111,83,01010011,162,10100010
15,00001111,51,00110011,66,01000010
121,01111001,12,00001100,133,10000101
45,00101101,10,00001010,55,00110111
116,01110100,105,01101001,221,11011101
80,01010000,70,01000110,150,10010110
21,00010101,94,01011110,115,01110011
67,01000011,80,01010000,147,10010011
64,01000000,1,00000001,65,01000001
50,00110010,96,01100000,146,10010010
107,01101011,123,01111011,230,11100110
82,01010010,82,01010010,164,10100100
57,00111001,22,00010110,79,01001111
15,00001111,15,00001111,30,00011110
28,00011100,71,01000111,99,01100011
27,00011011,88,01011000,115,01110011
57,00111001,58,00111010,115,01110011
88,01011000,76,01001100,164,10100100
13,00001101,18,00010010,31,00011111
78,01001110,78,01001110,156,10011100
20,00010100,71,01000111,91,01011011
55,00110111,44,00101100,99,01100011
107,01101011,117,01110101,224,11100000
91,01011011,44,00101100,135,10000111
15,00001111,125,01111101,140,10001100
87,01010111,75,01001011,162,10100010
77,01001101,126,01111110,203,11001011
29,00011101,95,01011111,124,01111100
110,01101110,82,01010010,192,11000000
4,00000100,28,00011100,32,00100000
65,01000001,49,00110001,114,01110010
49,00110001,87,01010111,136,10001000
57,00111001,80,01010000,137,10001001
41,00101001,90,01011010,131,10000011
112,01110000,66,01000010,178,10110010
47,00101111,17,00010001,64,01000000
20,00010100,38,00100110,58,00111010
64,01000000,6,00000110,70,01000110
108,01101100,22,00010110,130,10000010
79,01001111,74,01001010,153,10011001
34,00100010,40,00101000,74,01001010
38,00100110,118,01110110,156,10011100
21,00010101,34,00100010,55,00110111
117,01110101,32,00100000,149,10010101
42,00101010,127,01111111,169,10101001
44,00101100,99,01100011,143,10001111
41,00101001,121,01111001,162,10100010
103,01100111,27,00011011,130,10000010
123,01111011,48,00110000,171,10101011
127,01111111,10,00001010,137,10001001
68,01000100,17,00010001,85,01010101
3,00000011,101,01100101,104,01101000
94,01011110,87,01010111,181,10110101
29,00011101,102,01100110,131,10000011
123,01111011,30,00011110,153,10011001
75,01001011,66,01000010,141,10001101
93,01011101,60,00111100,153,10011001
7,00000111,51,00110011,58,00111010
116,01110100,73,01001001,189,10111101
87,01010111,64,01000000,151,10010111
112,01110000,17,00010001,129,10000001
40,00101000,115,01110011,155,10011011
21,00010101,94,01011110,115,01110011
26,00011010,15,00001111,41,00101001
112,01110000,17,00010001,129,10000001
10,00001010,17,00010001,27,00011011
3,00000011,103,01100111,106,01101010
73,01001001,29,00011101,102,01100110
67,01000011,71,01000111,138,10001010
80,01010000,98,01100010,178,10110010
4,00000100,61,00111101,65,01000001
90,01011010,100,01100100,190,10111110
6,00000110,32,00100000,38,00100110
81,01010001,119,01110111,200,11001000
118,01110110,117,01110101,235,11101011
37,00100101,119,01110111,156,10011100
27,00011011,51,00110011,78,01001110
78,01001110,59,00111011,137,10001001
86,01010110,95,01011111,181,10110101
8,00001000,56,00111000,64,01000000
29,00011101,28,00011100,57,00111001
95,01011111,34,00100010,129,10000001
58,00111010,127,01111111,185,10111001
126,01111110,81,01010001,207,11001111
92,01011100,111,01101111,203,11001011
16,00010000,72,01001000,88,01011000
59,00111011,119,01110111,178,10110010
108,01101100,7,00000111,115,01110011
12,00001100,32,00100000,44,00101100
84,01010100,107,01101011,191,10111111
75,01001011,93,01011101,168,10101000
40,00101000,0,00000000,40,00101000
84,01010100,109,01101101,193,11000001
92,01011100,77,01001101,169,10101001
37,00100101,47,00101111,84,01010100
61,00111101,103,01100111,164,10100100
50,00110010,68,01000100,118,01110110
110,01101110,76,01001100,186,10111010
57,00111001,119,01110111,176,10110000
101,01100101,112,01110000,213,11010101
4,00000100,105,01101001,109,01101101
36,00100100,80,01010000,116,01110100
82,01010010,37,00100101,119,01110111
94,01011110,117,01110101,211,11010011
110,01101110,35,00100011,145,10010001
48,00110000,0,00000000,48,00110000
49,00110001,57,00111001,106,01101010
9,00001001,50,00110010,59,00111011
97,01100001,48,00110000,145,10010001
113,01110001,12,00001100,125,01111101
70,01000110,124,01111100,194,11000010
115,01110011,36,00100100,151,10010111
99,01100011,102,01100110,201,11001001
36,00100100,30,00011110,66,01000010
114,01110010,19,00010011,133,10000101
38,00100110,44,00101100,82,01010010
35,00100011,14,00001110,49,00110001
29,00011101,51,00110011,80,01010000
60,00111100,120,01111000,180,10110100
81,01010001,67,01000011,148,10010100
29,00011101,27,00011011,56,00111000
3,00000011,33,00100001,36,00100100
117,01110101,51,00110011,168,10101000
118,01110110,27,00011011,145,10010001
100,01100100,56,00111000,156,10011100
21,00010101,39,00100111,60,00111100
106,01101010,74,01001010,180,10110100
29,00011101,113,01110001,142,10001110
29,00011101,61,00111101,90,01011010
58,00111010,24,00011000,82,01010010
114,01110010,16,00010000,130,10000010
64,01000000,100,01100100,164,10100100
98,01100010,123,01111011,221,11011101
13,00001101,1,00000001,14,00001110
123,01111011,2,00000010,125,01111101
66,01000010,19,00010011,85,01010101
116,01110100,122,01111010,238,11101110
76,01001100,30,00011110,106,01101010
39,00100111,85,01010101,124,01111100
77,01001101,49,00110001,126,01111110
26,00011010,115,01110011,141,10001101
12,00001100,113,01110001,125,01111101
64,01000000,1,00000001,65,01000001
36,00100100,10,00001010,46,00101110
106,01101010,32,00100000,138,10001010
126,01111110,28,00011100,154,10011010
58,00111010,66,01000010,124,01111100
92,01011100,65,01000001,157,10011101
77,01001101,83,01010011,160,10100000
47,00101111,81,01010001,128,10000000
36,00100100,71,01000111,107,01101011
53,00110101,70,01000110,123,01111011
9,00001001,15,00001111,24,00011000
18,00010010,29,00011101,47,00101111
53,00110101,60,00111100,113,01110001
42,00101010,82,01010010,124,01111100
2,00000010,29,00011101,31,00011111
17,00010001,35,00100011,52,00110100
120,01111000,19,00010011,139,10001011
16,00010000,23,00010111,39,00100111
12,00001100,99,01100011,111,01101111
109,01101101,56,00111000,165,10100101
66,01000010,20,00010100,86,01010110
3,00000011,81,01010001,84,01010100
44,00101100,38,00100110,82,01010010
42,00101010,74,01001010,116,01110100
37,00100101,106,01101010,143,10001111
40,00101000,111,01101111,151,10010111
27,00011011,4,00000100,31,00011111
51,00110011,22,00010110,73,01001001
37,00100101,35,00100011,72,01001000
30,00011110,7,00000111,37,00100101
88,01011000,88,01011000,176,10110000
111,01101111,15,00001111,126,01111110
10,00001010,19,00010011,29,00011101
77,01001101,103,01100111,180,10110100
56,00111000,101,01100101,157,10011101
103,01100111,18,00010010,121,01111001
71,01000111,60,00111100,131,10000011
24,00011000,32,00100000,56,00111000
108,01101100,39,00100111,147,10010011
116,01110100,104,01101000,220,11011100
126,01111110,111,01101111,237,11101101
116,01110100,100,01100100,216,11011000
106,01101010,16,00010000,122,01111010
52,00110100,90,01011010,142,10001110
104,01101000,80,01010000,184,10111000
46,00101110,96,01100000,142,10001110
94,01011110,84,01010100,178,10110010
23,00010111,15,00001111,38,00100110
44,00101100,83,01010011,127,01111111
119,01110111,55,00110111,174,10101110
98,01100010,27,00011011,125,01111101
45,00101101,98,01100010,143,10001111
81,01010001,87,01010111,168,10101000
27,00011011,77,01001101,104,01101000
48,00110000,87,01010111,135,10000111
94,01011110,5,00000101,99,01100011
121,01111001,103,01100111,224,11100000
97,01100001,113,01110001,210,11010010
98,01100010,28,00011100,126,01111110
116,01110100,65,01000001,181,10110101
68,01000100,85,01010101,153,10011001
72,01001000,124,01111100,196,11000100
114,01110010,33,00100001,147,10010011
118,01110110,99,01100011,217,11011001
48,00110000,99,01100011,147,10010011
89,01011001,69,01000101,158,10011110
65,01000001,99,01100011,164,10100100
71,01000111,1,00000001,72,01001000
1,00000001,71,01000111,72,01001000
25,00011001,100,01100100,125,01111101
77,01001101,108,01101100,185,10111001
50,00110010,27,00011011,77,01001101
96,01100000,43,00101011,139,10001011
19,00010011,98,01100010,117,01110101
45,00101101,100,01100100,145,10010001
80,01010000,112,01110000,192,11000000
106,01101010,121,01111001,227,11100011
43,00101011,67,01000011,110,01101110
8,00001000,83,01010011,91,01011011
46,00101110,64,01000000,110,01101110
116,01110100,20,00010100,136,10001000
96,01100000,98,01100010,194,11000010
107,01101011,5,00000101,112,01110000
85,01010101,24,00011000,109,01101101
2,00000010,125,01111101,127,01111111
125,01111101,71,01000111,196,11000100
108,01101100,75,01001011,183,10110111
115,01110011,28,00011100,143,10001111
118,01110110,95,01011111,213,11010101
65,01000001,80,01010000,145,10010001
114,01110010,82,01010010,196,11000100
14,00001110,21,00010101,35,00100011
111,01101111,111,01101111,222,11011110
69,01000101,33,00100001,102,01100110
106,01101010,2,00000010,108,01101100
27,00011011,104,01101000,131,10000011
119,01110111,19,00010011,138,10001010
15,00001111,71,01000111,86,01010110
108,01101100,29,00011101,137,10001001
35,00100011,97,01100001,132,10000100
48,00110000,49,00110001,97,01100001
80,01010000,56,00111000,136,10001000
63,00111111,88,01011000,151,10010111
58,00111010,5,00000101,63,00111111
51,00110011,122,01111010,173,10101101
61,00111101,106,01101010,167,10100111
83,01010011,17,00010001,100,01100100
45,00101101,96,01100000,141,10001101
62,00111110,22,00010110,84,01010100
97,01100001,102,01100110,199,11000111
9,00001001,5,00000101,14,00001110
76,01001100,61,00111101,137,10001001
42,00101010,119,01110111,161,10100001
16,00010000,59,00111011,75,01001011
17,00010001,68,01000100,85,01010101
60,00111100,25,00011001,85,01010101
14,00001110,109,01101101,123,01111011
61,00111101,53,00110101,114,01110010
81,01010001,29,00011101,110,01101110
70,01000110,28,00011100,98,01100010
74,01001010,5,00000101,79,01001111
100,01100100,100,01100100,200,11001000
84,01010100,55,00110111,139,10001011
114,01110010,50,00110010,164,10100100
86,01010110,53,00110101,139,10001011
10,00001010,43,00101011,53,00110101
59,00111011,30,00011110,89,01011001
59,00111011,14,00001110,73,01001001
115,01110011,48,00110000,163,10100011
120,01111000,125,01111101,245,11110101
56,00111000,65,01000001,121,01111001
104,01101000,7,00000111,111,01101111
69,01000101,15,00001111,84,01010100
119,01110111,105,01101001,224,11100000
52,00110100,32,00100000,84,01010100
87,01010111,78,01001110,165,10100101
34,00100010,29,00011101,63,00111111
51,00110011,89,01011001,140,10001100
53,00110101,4,00000100,57,00111001
64,01000000,123,01111011,187,10111011
26,00011010,84,01010100,110,01101110
5,00000101,122,01111010,127,01111111
88,01011000,17,00010001,105,01101001
68,01000100,56,00111000,124,01111100
32,00100000,113,01110001,145,10010001
81,01010001,72,01001000,153,10011001
73,01001001,100,01100100,173,10101101
31,00011111,94,01011110,125,01111101
73,01001001,108,01101100,181,10110101
48,00110000,99,01100011,147,10010011
32,00100000,14,00001110,46,00101110
61,00111101,87,01010111,148,10010100
32,00100000,56,00111000,88,01011000
28,00011100,43,00101011,71,01000111
97,01100001,50,00110010,147,10010011
46,00101110,108,01101100,154,10011010
72,01001000,37,00100101,109,01101101
120,01111000,2,00000010,122,01111010
17,00010001,15,00001111,32,00100000
67,01000011,85,01010101,152,10011000
112,01110000,114,01110010,226,11100010
93,01011101,101,01100101,194,11000010
120,01111000,22,00010110,142,10001110
82,01010010,7,00000111,89,01011001
55,00110111,49,00110001,104,01101000
26,00011010,120,01111000,146,10010010
4,00000100,109,01101101,113,01110001
89,01011001,26,00011010,115,01110011
60,00111100,115,01110011,175,10101111
111,01101111,83,01010011,194,11000010
78,01001110,18,00010010,96,01100000
121,01111001,96,01100000,217,11011001
91,01011011,36,00100100,127,01111111
102,01100110,20,00010100,122,01111010
127,01111111,108,01101100,235,11101011
3,00000011,18,00010010,21,00010101
77,01001101,51,00110011,128,10000000
49,00110001,31,00011111,80,01010000
97,01100001,18,00010010,115,01110011
12,00001100,111,01101111,123,01111011
91,01011011,103,01100111,194,11000010
98,01100010,71,01000111,169,10101001
94,01011110,45,00101101,139,10001011
80,01010000,65,01000001,145,10010001
88,01011000,16,00010000,104,01101000
45,00101101,127,01111111,172,10101100
91,01011011,37,00100101,128,10000000
50,00110010,24,00011000,74,01001010
48,00110000,76,01001100,124,01111100
4,00000100,112,01110000,116,01110100
51,00110011,46,00101110,97,01100001
40,00101000,14,00001110,54,00110110
113,01110001,10,00001010,123,01111011
27,00011011,78,01001110,105,01101001
102,01100110,13,00001101,115,01110011
4,00000100,86,01010110,90,01011010
15,00001111,29,00011101,44,00101100
78,01001110,42,00101010,120,01111000
25,00011001,75,01001011,100,01100100
95,01011111,91,01011011,186,10111010
22,00010110,110,01101110,132,10000100
43,00101011,84,01010100,127,01111111
55,00110111,125,01111101,180,10110100
2,00000010,25,00011001,27,00011011
125,01111101,120,01111000,245,11110101
0,00000000,95,01011111,95,01011111
56,00111000,110,01101110,166,10100110
70,01000110,82,01010010,152,10011000
86,01010110,62,00111110,148,10010100
127,01111111,46,00101110,173,10101101
123,01111011,89,01011001,212,11010100
77,01001101,12,00001100,89,01011001
62,00111110,37,00100101,99,01100011
83,01010011,31,00011111,114,01110010
119,01110111,28,00011100,147,10010011
59,00111011,120,01111000,179,10110011
83,01010011,40,00101000,123,01111011
104,01101000,121,01111001,225,11100001
89,01011001,111,01101111,200,11001000
29,00011101,28,00011100,57,00111001
52,00110100,42,00101010,94,01011110
10,00001010,84,01010100,94,01011110
17,00010001,0,00000000,17,00010001
39,00100111,38,00100110,77,01001101
98,01100010,65,01000001,163,10100011
48,00110000,86,01010110,134,10000110
45,00101101,122,01111010,167,10100111
49,00110001,22,00010110,71,01000111
103,01100111,126,01111110,229,11100101
92,01011100,65,01000001,157,10011101
85,01010101,66,01000010,151,10010111
32,00100000,50,00110010,82,01010010
70,01000110,102,01100110,172,10101100
35,00100011,117,01110101,152,10011000
100,01100100,23,00010111,123,01111011
115,01110011,122,01111010,237,11101101
82,01010010,102,01100110,184,10111000
89,01011001,110,01101110,199,11000111
79,01001111,113,01110001,192,11000000
27,00011011,85,01010101,112,01110000
1,00000001,9,00001001,10,00001010
115,01110011,81,01010001,196,11000100
11,00001011,64,01000000,75,01001011
119,01110111,67,01000011,186,10111010
121,01111001,61,00111101,182,10110110
54,00110110,36,00100100,90,01011010
84,01010100,126,01111110,210,11010010
19,00010011,111,01101111,130,10000010
69,01000101,84,01010100,153,10011001
125,01111101,62,00111110,187,10111011
68,01000100,41,00101001,109,01101101
80,01010000,16,00010000,96,01100000
57,00111001,5,00000101,62,00111110
96,01100000,22,00010110,118,01110110
3,00000011,8,00001000,11,00001011
62,00111110,92,01011100,154,10011010
41,00101001,74,01001010,115,01110011
102,01100110,92,01011100,194,11000010
95,01011111,108,01101100,203,11001011
11,00001011,34,00100010,45,00101101
91,01011011,49,00110001,140,10001100
71,01000111,39,00100111,110,01101110
102,01100110,119,01110111,221,11011101
58,00111010,5,00000101,63,00111111
73,01001001,88,01011000,161,10100001
12,00001100,104,01101000,116,01110100
97,01100001,59,00111011,156,10011100
78,01001110,109,01101101,187,10111011
15,00001111,4,00000100,19,00010011
22,00010110,52,00110100,74,01001010
66,01000010,71,01000111,137,10001001
109,01101101,72,01001000,181,10110101
5,00000101,39,00100111,44,00101100
79,01001111,79,01001111,158,10011110
41,00101001,89,01011001,130,10000010
22,00010110,89,01011001,111,01101111
89,01011001,19,00010011,108,01101100
62,00111110,29,00011101,91,01011011
9,00001001,11,00001011,20,00010100
125,01111101,99,01100011,224,11100000
26,00011010,103,01100111,129,10000001
127,01111111,82,01010010,209,11010001
72,01001000,127,01111111,199,11000111
1,00000001,99,01100011,100,01100100
114,01110010,113,01110001,227,11100011
46,00101110,55,00110111,101,01100101
10,00001010,74,01001010,84,01010100
24,00011000,127,01111111,151,10010111
95,01011111,43,00101011,138,10001010
91,01011011,13,00001101,104,01101000
78,01001110,55,00110111,133,10000101
5,00000101,23,00010111,28,00011100
42,00101010,103,01100111,145,10010001
49,00110001,101,01100101,150,10010110
102,01100110,75,01001011,177,10110001
117,01110101,56,00111000,173,10101101
43,00101011,24,00011000,67,01000011
81,01010001,21,00010101,102,01100110
94,01011110,18,00010010,112,01110000
63,00111111,89,01011001,152,10011000
29,00011101,37,00100101,66,01000010
49,00110001,40,00101000,89,01011001
113,01110001,106,01101010,219,11011011
95,01011111,103,01100111,198,11000110
11,00001011,56,00111000,67,01000011
117,01110101,63,00111111,180,10110100
14,00001110,32,00100000,46,00101110
65,01000001,121,01111001,186,10111010
117,01110101,65,01000001,182,10110110
36,00100100,122,01111010,158,10011110
25,00011001,76,01001100,101,01100101
72,01001000,50,00110010,122,01111010
12,00001100,24,00011000,36,00100100
19,00010011,67,01000011,86,01010110
10,00001010,7,00000111,17,00010001
52,00110100,92,01011100,144,10010000
14,00001110,72,01001000,86,01010110
46,00101110,99,01100011,145,10010001
35,00100011,81,01010001,116,01110100
23,00010111,61,00111101,84,01010100
117,01110101,53,00110101,170,10101010
12,00001100,45,00101101,57,00111001
7,00000111,122,01111010,129,10000001
47,00101111,110,01101110,157,10011101
39,00100111,94,01011110,133,10000101
19,00010011,106,01101010,125,01111101
109,01101101,50,00110010,159,10011111
65,01000001,43,00101011,108,01101100
82,01010010,78,01001110,160,10100000
123,01111011,89,01011001,212,11010100
101,01100101,120,01111000,221,11011101
56,00111000,72,01001000,128,10000000
50,00110010,34,00100010,84,01010100
90,01011010,11,00001011,101,01100101
108,01101100,11,00001011,119,01110111
104,01101000,36,00100100,140,10001100
126,01111110,49,00110001,175,10101111
76,01001100,81,01010001,157,10011101
95,01011111,74,01001010,169,10101001
48,00110000,74,01001010,122,01111010
11,00001011,93,01011101,104,01101000
34,00100010,74,01001010,108,01101100
76,01001100,113,01110001,189,10111101
39,00100111,112,01110000,151,10010111
10,00001010,2,00000010,12,00001100
121,01111001,111,01101111,232,11101000
75,01001011,46,00101110,121,01111001
51,00110011,116,01110100,167,10100111
41,00101001,122,01111010,163,10100011
91,01011011,3,00000011,94,01011110
16,00010000,63,00111111,79,01001111
64,01000000,13,00001101,77,01001101
38,00100110,4,00000100,42,00101010
3,00000011,19,00010011,22,00010110
81,01010001,16,00010000,97,01100001
126,01111110,71,01000111,197,11000101
24,00011000,11,00001011,35,00100011
22,00010110,60,00111100,82,01010010
91,01011011,2,00000010,93,01011101
8,00001000,72,01001000,80,01010000
89,01011001,38,00100110,127,01111111
52,00110100,97,01100001,149,10010101
88,01011000,63,00111111,151,10010111
21,00010101,4,00000100,25,00011001
31,00011111,115,01110011,146,10010010
75,01001011,37,00100101,112,01110000
7,00000111,22,00010110,29,00011101
124,01111100,42,00101010,166,10100110
59,00111011,95,01011111,154,10011010
54,00110110,73,01001001,127,01111111
115,01110011,51,00110011,166,10100110
82,01010010,23,00010111,105,01101001
83,01010011,25,00011001,108,01101100
57,00111001,69,01000101,126,01111110
89,01011001,45,00101101,134,10000110
111,01101111,88,01011000,199,11000111
51,00110011,59,00111011,110,01101110
44,00101100,26,00011010,70,01000110
120,01111000,117,01110101,237,11101101
43,00101011,121,01111001,164,10100100
32,00100000,30,00011110,62,00111110
14,00001110,71,01000111,85,01010101
96,01100000,61,00111101,157,10011101
1,00000001,118,01110110,119,01110111
47,00101111,124,01111100,171,10101011
109,01101101,118,01110110,227,11100011
43,00101011,90,01011010,133,10000101
15,00001111,68,01000100,83,01010011
74,01001010,85,01010101,159,10011111
39,00100111,106,01101010,145,10010001
107,01101011,94,01011110,201,11001001
86,01010110,0,00000000,86,01010110
81,01010001,58,00111010,139,10001011
12,00001100,91,01011011,103,01100111
43,00101011,54,00110110,97,01100001
125,01111101,47,00101111,172,10101100
22,00010110,31,00011111,53,00110101
116,01110100,34,00100010,150,10010110
98,01100010,42,00101010,140,10001100
68,01000100,122,01111010,190,10111110
62,00111110,36,00100100,98,01100010
83,01010011,44,00101100,127,01111111
81,01010001,112,01110000,193,11000001
111,01101111,70,01000110,181,10110101
6,00000110,48,00110000,54,00110110
9,00001001,28,00011100,37,00100101
77,01001101,56,00111000,133,10000101
9,00001001,85,01010101,94,01011110
66,01000010,9,00001001,75,01001011
110,01101110,120,01111000,230,11100110
36,00100100,28,00011100,64,01000000
116,01110100,64,01000000,180,10110100
74,01001010,124,01111100,198,11000110
13,00001101,107,01101011,120,01111000
2,00000010,37,00100101,39,00100111
71,01000111,87,01010111,158,10011110
94,01011110,81,01010001,175,10101111
3,00000011,111,01101111,114,01110010
98,01100010,80,01010000,178,10110010
115,01110011,82,01010010,197,11000101
50,00110010,61,00111101,111,01101111
106,01101010,82,01010010,188,10111100
28,00011100,35,00100011,63,00111111
53,00110101,26,00011010,79,01001111
113,01110001,103,01100111,216,11011000
42,00101010,46,00101110,88,01011000
69,01000101,28,00011100,97,01100001
127,01111111,43,00101011,170,10101010
83,01010011,62,00111110,145,10010001
74,01001010,74,01001010,148,10010100
9,00001001,91,01011011,100,01100100
99,01100011,75,01001011,174,10101110
96,01100000,38,00100110,134,10000110
31,00011111,115,01110011,146,10010010
22,00010110,126,01111110,148,10010100
91,01011011,57,00111001,148,10010100
21,00010101,97,01100001,118,01110110
61,00111101,108,01101100,169,10101001
41,00101001,115,01110011,156,10011100
107,01101011,99,01100011,206,11001110
41,00101001,122,01111010,163,10100011
23,00010111,125,01111101,148,10010100
104,01101000,52,00110100,156,10011100
23,00010111,122,01111010,145,10010001
72,01001000,41,00101001,113,01110001
109,01101101,60,00111100,169,10101001
47,00101111,15,00001111,62,00111110
36,00100100,65,01000001,101,01100101
94,01011110,101,01100101,195,11000011
42,00101010,126,01111110,168,10101000
0,00000000,83,01010011,83,01010011
6,00000110,93,01011101,99,01100011
67,01000011,31,00011111,98,01100010
29,00011101,16,00010000,45,00101101
67,01000011,26,00011010,93,01011101
125,01111101,6,00000110,131,10000011
105,01101001,101,01100101,206,11001110
11,00001011,81,01010001,92,01011100
55,00110111,125,01111101,180,10110100
43,00101011,67,01000011,110,01101110
20,00010100,91,01011011,111,01101111
127,01111111,119,01110111,246,11110110
92,01011100,14,00001110,106,01101010
14,00001110,80,01010000,94,01011110
99,01100011,63,00111111,162,10100010
117,01110101,102,01100110,219,11011011
43,00101011,27,00011011,70,01000110
102,01100110,87,01010111,189,10111101
20,00010100,123,01111011,143,10001111
23,00010111,34,00100010,57,00111001
32,00100000,65,01000001,97,01100001
22,00010110,21,00010101,43,00101011
57,00111001,68,01000100,125,01111101
45,00101101,104,01101000,149,10010101
39,00100111,24,00011000,63,00111111
86,01010110,17,00010001,103,01100111
52,00110100,90,01011010,142,10001110
8,00001000,5,00000101,13,00001101
97,01100001,86,01010110,183,10110111
122,01111010,82,01010010,204,11001100
10,00001010,62,00111110,72,01001000
29,00011101,11,00001011,40,00101000
30,00011110,71,01000111,101,01100101
58,00111010,94,01011110,152,10011000
42,00101010,85,01010101,127,01111111
71,01000111,25,00011001,96,01100000
108,01101100,54,00110110,162,10100010
118,01110110,83,01010011,201,11001001
25,00011001,45,00101101,70,01000110
121,01111001,106,01101010,227,11100011
3,00000011,116,01110100,119,01110111
84,01010100,113,01110001,197,11000101
83,01010011,121,01111001,204,11001100
37,00100101,33,00100001,70,01000110
60,00111100,108,01101100,168,10101000
89,01011001,7,00000111,96,01100000
60,00111100,37,00100101,97,01100001
84,01010100,122,01111010,206,11001110
98,01100010,16,00010000,114,01110010
45,00101101,104,01101000,149,10010101
39,00100111,33,00100001,72,01001000
97,01100001,65,01000001,162,10100010
73,01001001,87,01010111,160,10100000
68,01000100,24,00011000,92,01011100
6,00000110,97,01100001,103,01100111
114,01110010,127,01111111,241,11110001
60,00111100,88,01011000,148,10010100
61,00111101,116,01110100,177,10110001
59,00111011,119,01110111,178,10110010
121,01111001,74,01001010,195,11000011
29,00011101,111,01101111,140,10001100
120,01111000,28,00011100,148,10010100
24,00011000,3,00000011,27,00011011
82,01010010,21,00010101,103,01100111
6,00000110,84,01010100,90,01011010
21,00010101,119,01110111,140,10001100
27,00011011,26,00011010,53,00110101
89,01011001,64,01000000,153,10011001
110,01101110,3,00000011,113,01110001
53,00110101,37,00100101,90,01011010
7,00000111,120,01111000,127,01111111
80,01010000,75,01001011,155,10011011
11,00001011,108,01101100,119,01110111
2,00000010,54,00110110,56,00111000
5,00000101,17,00010001,22,00010110
122,01111010,125,01111101,247,11110111
78,01001110,5,00000101,83,01010011
78,01001110,81,01010001,159,10011111
105,01101001,110,01101110,215,11010111
108,01101100,30,00011110,138,10001010
98,01100010,3,00000011,101,01100101
0,00000000,93,01011101,93,01011101
44,00101100,44,00101100,88,01011000
108,01101100,127,01111111,235,11101011
115,01110011,61,00111101,176,10110000
126,01111110,0,00000000,126,01111110
17,00010001,29,00011101,46,00101110
91,01011011,34,00100010,125,01111101
114,01110010,115,01110011,229,11100101
100,01100100,59,00111011,159,10011111
21,00010101,63,00111111,84,01010100
94,01011110,120,01111000,214,11010110
101,01100101,17,00010001,118,01110110
38,00100110,79,01001111,117,01110101
1,00000001,15,00001111,16,00010000
105,01101001,86,01010110,191,10111111
109,01101101,17,00010001,126,01111110
108,01101100,53,00110101,161,10100001
22,00010110,77,01001101,99,01100011
114,01110010,47,00101111,161,10100001
66,01000010,11,00001011,77,01001101
9,00001001,114,01110010,123,01111011
40,00101000,54,00110110,94,01011110
51,00110011,47,00101111,98,01100010
4,00000100,10,00001010,14,00001110
113,01110001,126,01111110,239,11101111
6,00000110,118,01110110,124,01111100
44,00101100,72,01001000,116,01110100
8,00001000,72,01001000,80,01010000
108,01101100,101,01100101,209,11010001
18,00010010,2,00000010,20,00010100
69,01000101,93,01011101,162,10100010
121,01111001,101,01100101,222,11011110
100,01100100,106,01101010,206,11001110
29,00011101,27,00011011,56,00111000
17,00010001,58,00111010,75,01001011
11,00001011,49,00110001,60,00111100
72,01001000,88,01011000,160,10100000
3,00000011,112,01110000,115,01110011
11,00001011,57,00111001,68,01000100
50,00110010,15,00001111,65,01000001
57,00111001,3,00000011,60,00111100
118,01110110,100,01100100,218,11011010
60,00111100,39,00100111,99,01100011
126,01111110,85,01010101,211,11010011
29,00011101,53,00110101,82,01010010
67,01000011,56,00111000,123,01111011
75,01001011,119,01110111,194,11000010
79,01001111,45,00101101,124,01111100
90,01011010,79,01001111,169,10101001
97,01100001,11,00001011,108,01101100
119,01110111,5,00000101,124,01111100
30,00011110,58,00111010,88,01011000
68,01000100,59,00111011,127,01111111
32,00100000,37,00100101,69,01000101
43,00101011,125,01111101,168,10101000
60,00111100,45,00101101,105,01101001
29,00011101,122,01111010,151,10010111
27,00011011,103,01100111,130,10000010
27,00011011,29,00011101,56,00111000
126,01111110,72,01001000,198,11000110
75,01001011,97,01100001,172,10101100
78,01001110,38,00100110,116,01110100
11,00001011,74,01001010,85,01010101
118,01110110,89,01011001,207,11001111
32,00100000,50,00110010,82,01010010
40,00101000,70,01000110,110,01101110
30,00011110,22,00010110,52,00110100
123,01111011,75,01001011,198,11000110
35,00100011,84,01010100,119,01110111
68,01000100,63,00111111,131,10000011
4,00000100,49,00110001,53,00110101
116,01110100,29,00011101,145,10010001
63,00111111,61,00111101,124,01111100
91,01011011,111,01101111,202,11001010
83,01010011,104,01101000,187,10111011
90,01011010,26,00011010,116,01110100
73,01001001,50,00110010,123,01111011
95,01011111,94,01011110,189,10111101
17,00010001,71,01000111,88,01011000
56,00111000,115,01110011,171,10101011
35,00100011,73,01001001,108,01101100
92,01011100,47,00101111,139,10001011
48,00110000,119,01110111,167,10100111
71,01000111,117,01110101,188,10111100
67,01000011,123,01111011,190,10111110
71,01000111,62,00111110,133,10000101
72,01001000,37,00100101,109,01101101
5,00000101,97,01100001,102,01100110
55,00110111,92,01011100,147,10010011
46,00101110,38,00100110,84,01010100
49,00110001,8,00001000,57,00111001
122,01111010,65,01000001,187,10111011
66,01000010,62,00111110,128,10000000
16,00010000,61,00111101,77,01001101
66,01000010,11,00001011,77,01001101
31,00011111,10,00001010,41,00101001
20,00010100,100,01100100,120,01111000
14,00001110,120,01111000,134,10000110
52,00110100,71,01000111,123,01111011
29,00011101,5,00000101,34,00100010
14,00001110,114,01110010,128,10000000
110,01101110,79,01001111,189,10111101
51,00110011,32,00100000,83,01010011
23,00010111,121,01111001,144,10010000
91,01011011,6,00000110,97,01100001
73,01001001,120,01111000,193,11000001
65,01000001,75,01001011,140,10001100
87,01010111,124,01111100,211,11010011
70,01000110,40,00101000,110,01101110
60,00111100,36,00100100,96,01100000
12,00001100,35,00100011,47,00101111
62,00111110,69,01000101,131,10000011
62,00111110,58,00111010,120,01111000
76,01001100,18,00010010,94,01011110
0,00000000,1,00000001,1,00000001
84,01010100,77,01001101,161,10100001
90,01011010,112,01110000,202,11001010
107,01101011,21,00010101,128,10000000
78,01001110,13,00001101,91,01011011
104,01101000,67,01000011,171,10101011
105,01101001,17,00010001,122,01111010
5,00000101,26,00011010,31,00011111
63,00111111,27,00011011,90,01011010
107,01101011,109,01101101,216,11011000
41,00101001,13,00001101,54,00110110
45,00101101,48,00110000,93,01011101
56,00111000,58,00111010,114,01110010
17,00010001,86,01010110,103,01100111
95,01011111,89,01011001,184,10111000
92,01011100,77,01001101,169,10101001
7,00000111,26,00011010,33,00100001
17,00010001,68,01000100,85,01010101
43,00101011,47,00101111,90,01011010
94,01011110,125,01111101,219,11011011
92,01011100,121,01111001,213,11010101
72,01001000,58,00111010,130,10000010
27,00011011,6,00000110,33,00100001
7,00000111,53,00110101,60,00111100
119,01110111,120,01111000,239,11101111
26,00011010,123,01111011,149,10010101
75,01001011,37,00100101,112,01110000
93,01011101,49,00110001,142,10001110
20,00010100,93,01011101,113,01110001
119,01110111,56,00111000,175,10101111
61,00111101,55,00110111,116,01110100
92,01011100,23,00010111,115,01110011
57,00111001,9,00001001,66,01000010
0,00000000,102,01100110,102,01100110
19,00010011,71,01000111,90,01011010
50,00110010,38,00100110,88,01011000
67,01000011,124,01111100,191,10111111
30,00011110,37,00100101,67,01000011
56,00111000,126,01111110,182,10110110
105,01101001,5,00000101,110,01101110
59,00111011,80,01010000,139,10001011
90,01011010,61,00111101,151,10010111
31,00011111,70,01000110,101,01100101
89,01011001,75,01001011,164,10100100
17,00010001,31,00011111,48,00110000
31,00011111,84,01010100,115,01110011
90,01011010,39,00100111,129,10000001
117,01110101,50,00110010,167,10100111
74,01001010,38,00100110,112,01110000
68,01000100,123,01111011,191,10111111
39,00100111,127,01111111,166,10100110
79,01001111,13,00001101,92,01011100
35,00100011,102,01100110,137,10001001
123,01111011,11,00001011,134,10000110
103,01100111,75,01001011,178,10110010
112,01110000,54,00110110,166,10100110
36,00100100,82,01010010,118,01110110
75,01001011,51,00110011,126,01111110
34,00100010,58,00111010,92,01011100
80,01010000,28,00011100,108,01101100
9,00001001,101,01100101,110,01101110
8,00001000,17,00010001,25,00011001
112,01110000,108,01101100,220,11011100
92,01011100,25,00011001,117,01110101
94,01011110,123,01111011,217,11011001
101,01100101,59,00111011,160,10100000
123,01111011,94,01011110,217,11011001
121,01111001,59,00111011,180,10110100
58,00111010,18,00010010,76,01001100
12,00001100,1,00000001,13,00001101
27,00011011,10,00001010,37,00100101
67,01000011,61,00111101,128,10000000
16,00010000,27,00011011,43,00101011
124,01111100,6,00000110,130,10000010
0,00000000,7,00000111,7,00000111
25,00011001,67,01000011,92,01011100
59,00111011,120,01111000,179,10110011
116,01110100,127,01111111,243,11110011
36,00100100,44,00101100,80,01010000
85,01010101,113,01110001,198,11000110
118,01110110,127,01111111,245,11110101
72,01001000,111,01101111,183,10110111
38,00100110,42,00101010,80,01010000
97,01100001,36,00100100,133,10000101
68,01000100,91,01011011,159,10011111
13,00001101,13,00001101,26,00011010
41,00101001,72,01001000,113,01110001
6,00000110,94,01011110,100,01100100
12,00001100,98,01100010,110,01101110
3,00000011,104,01101000,107,01101011
16,00010000,5,00000101,21,00010101
40,00101000,55,00110111,95,01011111
29,00011101,53,00110101,82,01010010
22,00010110,101,01100101,123,01111011
23,00010111,123,01111011,146,10010010
122,01111010,36,00100100,158,10011110
107,01101011,59,00111011,166,10100110
34,00100010,70,01000110,104,01101000
6,00000110,88,01011000,94,01011110
76,01001100,17,00010001,93,01011101
95,01011111,48,00110000,143,10001111
37,00100101,0,00000000,37,00100101
74,01001010,113,01110001,187,10111011
108,01101100,4,00000100,112,01110000
95,01011111,60,00111100,155,10011011
127,01111111,10,00001010,137,10001001
29,00011101,97,01100001,126,01111110
105,01101001,112,01110000,217,11011001
13,00001101,19,00010011,32,00100000
41,00101001,76,01001100,117,01110101
44,00101100,51,00110011,95,01011111
107,01101011,16,00010000,123,01111011
120,01111000,126,01111110,246,11110110
114,01110010,37,00100101,151,10010111
14,00001110,36,00100100,50,00110010
114,01110010,4,00000100,118,01110110
114,01110010,47,00101111,161,10100001
0,00000000,49,00110001,49,00110001
37,00100101,126,01111110,163,10100011
75,01001011,44,00101100,119,01110111
69,01000101,104,01101000,173,10101101
110,01101110,16,00010000,126,01111110
16,00010000,10,00001010,26,00011010
5,00000101,23,00010111,28,00011100
47,00101111,67,01000011,114,01110010
38,00100110,112,01110000,150,10010110
18,00010010,94,01011110,112,01110000
80,01010000,31,00011111,111,01101111
42,00101010,47,00101111,89,01011001
21,00010101,97,01100001,118,01110110
55,00110111,74,01001010,129,10000001
108,01101100,31,00011111,139,10001011
83,01010011,66,01000010,149,10010101
19,00010011,31,00011111,50,00110010
114,01110010,19,00010011,133,10000101
39,00100111,39,00100111,78,01001110
61,00111101,97,01100001,158,10011110
44,00101100,116,01110100,160,10100000
108,01101100,54,00110110,162,10100010
94,01011110,122,01111010,216,11011000
103,01100111,62,00111110,165,10100101
76,01001100,16,00010000,92,01011100
80,01010000,126,01111110,206,11001110
6,00000110,68,01000100,74,01001010
45,00101101,84,01010100,129,10000001
122,01111010,30,00011110,152,10011000
76,01001100,123,01111011,199,11000111
53,00110101,33,00100001,86,01010110
90,01011010,18,00010010,108,01101100
6,00000110,120,01111000,126,01111110
2,00000010,26,00011010,28,00011100
110,01101110,25,00011001,135,10000111
13,00001101,63,00111111,76,01001100
91,01011011,62,00111110,153,10011001
57,00111001,37,00100101,94,01011110
45,00101101,21,00010101,66,01000010
107,01101011,120,01111000,227,11100011
69,01000101,121,01111001,190,10111110
49,00110001,25,00011001,74,01001010
12,00001100,52,00110100,64,01000000
70,01000110,47,00101111,117,01110101
125,01111101,73,01001001,198,11000110
10,00001010,72,01001000,82,01010010
90,01011010,16,00010000,106,01101010
95,01011111,94,01011110,189,10111101
126,01111110,101,01100101,227,11100011
38,00100110,48,00110000,86,01010110
60,00111100,6,00000110,66,01000010
112,01110000,70,01000110,182,10110110
119,01110111,1,00000001,120,01111000
111,01101111,63,00111111,174,10101110
65,01000001,125,01111101,190,10111110
21,00010101,46,00101110,67,01000011
0,00000000,86,01010110,86,01010110
36,00100100,26,00011010,62,00111110
20,00010100,84,01010100,104,01101000
103,01100111,34,00100010,137,10001001
113,01110001,110,01101110,223,11011111
61,00111101,30,00011110,91,01011011
27,00011011,100,01100100,127,01111111
73,01001001,72,01001000,145,10010001
52,00110100,84,01010100,136,10001000
23,00010111,62,00111110,85,01010101
48,00110000,103,01100111,151,10010111
59,00111011,43,00101011,102,01100110
42,00101010,13,00001101,55,00110111
120,01111000,111,01101111,231,11100111
121,01111001,9,00001001,130,10000010
27,00011011,90,01011010,117,01110101
101,01100101,34,00100010,135,10000111
70,01000110,41,00101001,111,01101111
109,01101101,37,00100101,146,10010010
6,00000110,58,00111010,64,01000000
85,01010101,3,00000011,88,01011000
75,01001011,106,01101010,181,10110101
11,00001011,29,00011101,40,00101000
78,01001110,83,01010011,161,10100001
26,00011010,107,01101011,133,10000101
127,01111111,80,01010000,207,11001111
35,00100011,52,00110100,87,01010111
17,00010001,80,01010000,97,01100001
10,00001010,121,01111001,131,10000011
60,00111100,73,01001001,133,10000101
99,01100011,25,00011001,124,01111100
127,01111111,26,00011010,153,10011001
51,00110011,79,01001111,130,10000010
27,00011011,4,00000100,31,00011111
102,01100110,85,01010101,187,10111011
103,01100111,113,01110001,216,11011000
53,00110101,23,00010111,76,01001100
108,01101100,102,01100110,210,11010010
107,01101011,107,01101011,214,11010110
22,00010110,92,01011100,114,01110010
110,01101110,43,00101011,153,10011001
6,00000110,13,00001101,19,00010011
77,01001101,17,00010001,94,01011110
40,00101000,125,01111101,165,10100101
94,01011110,68,01000100,162,10100010
18,00010010,112,01110000,130,10000010
2,00000010,27,00011011,29,00011101
8,00001000,107,01101011,115,01110011
79,01001111,51,00110011,130,10000010
87,01010111,47,00101111,134,10000110
63,00111111,30,00011110,93,01011101
13,00001101,92,01011100,105,01101001
46,00101110,14,00001110,60,00111100
114,01110010,46,00101110,160,10100000
45,00101101,97,01100001,142,10001110
4,00000100,116,01110100,120,01111000
10,00001010,116,01110100,126,01111110
63,00111111,18,00010010,81,01010001
100,01100100,72,01001000,172,10101100
119,01110111,58,00111010,177,10110001
73,01001001,110,01101110,183,10110111
13,00001101,12,00001100,25,00011001
29,00011101,78,01001110,107,01101011
104,01101000,77,01001101,181,10110101
9,00001001,46,00101110,55,00110111
60,00111100,76,01001100,136,10001000
101,01100101,29,00011101,130,10000010
109,01101101,75,01001011,184,10111000
108,01101100,105,01101001,213,11010101
113,01110001,24,00011000,137,10001001
59,00111011,72,01001000,131,10000011
15,00001111,54,00110110,69,01000101
32,00100000,108,01101100,140,10001100
126,01111110,80,01010000,206,11001110
114,01110010,115,01110011,229,11100101
108,01101100,114,01110010,222,11011110
113,01110001,11,00001011,124,01111100
15,00001111,25,00011001,40,00101000
21,00010101,22,00010110,43,00101011
81,01010001,92,01011100,173,10101101
122,01111010,91,01011011,213,11010101
108,01101100,72,01001000,180,10110100
91,01011011,92,01011100,183,10110111
103,01100111,107,01101011,210,11010010
103,01100111,99,01100011,202,11001010
30,00011110,116,01110100,146,10010010
41,00101001,118,01110110,159,10011111
9,00001001,118,01110110,127,01111111
52,00110100,43,00101011,95,01011111
81,01010001,50,00110010,131,10000011
16,00010000,64,01000000,80,01010000
26,00011010,7,00000111,33,00100001
54,00110110,82,01010010,136,10001000
58,00111010,75,01001011,133,10000101
57,00111001,58,00111010,115,01110011
76,01001100,13,00001101,89,01011001
72,01001000,104,01101000,176,10110000
18,00010010,17,00010001,35,00100011
42,00101010,44,00101100,86,01010110
98,01100010,75,01001011,173,10101101
87,01010111,70,01000110,157,10011101
78,01001110,46,00101110,124,01111100
54,00110110,50,00110010,104,01101000
43,00101011,65,01000001,108,01101100
78,01001110,101,01100101,179,10110011
6,00000110,121,01111001,127,01111111
47,00101111,44,00101100,91,01011011
9,00001001,3,00000011,12,00001100
9,00001001,123,01111011,132,10000100
116,01110100,123,01111011,239,11101111
34,00100010,94,01011110,128,10000000
1,00000001,38,00100110,39,00100111
78,01001110,80,01010000,158,10011110
94,01011110,50,00110010,144,10010000
13,00001101,86,01010110,99,01100011
46,00101110,99,01100011,145,10010001
87,01010111,37,00100101,124,01111100
93,01011101,109,01101101,202,11001010
106,01101010,90,01011010,196,11000100
82,01010010,86,01010110,168,10101000
6,00000110,74,01001010,80,01010000
43,00101011,1,00000001,44,00101100
73,01001001,90,01011010,163,10100011
48,00110000,79,01001111,127,01111111
17,00010001,19,00010011,36,00100100
126,01111110,19,00010011,145,10010001
65,01000001,27,00011011,92,01011100
115,01110011,100,01100100,215,11010111
35,00100011,9,00001001,44,00101100
105,01101001,13,00001101,118,01110110
53,00110101,70,01000110,123,01111011
88,01011000,10,00001010,98,01100010
121,01111001,43,00101011,164,10100100
101,01100101,5,00000101,106,01101010
40,00101000,116,01110100,156,10011100
15,00001111,14,00001110,29,00011101
85,01010101,0,00000000,85,01010101
35,00100011,97,01100001,132,10000100
14,00001110,6,00000110,20,00010100
88,01011000,118,01110110,206,11001110
3,00000011,68,01000100,71,01000111
101,01100101,104,01101000,205,11001101
95,01011111,27,00011011,122,01111010
114,01110010,105,01101001,219,11011011
67,01000011,34,00100010,101,01100101
41,00101001,13,00001101,54,00110110
127,01111111,113,01110001,240,11110000
17,00010001,106,01101010,123,01111011
40,00101000,109,01101101,149,10010101
74,01001010,38,00100110,112,01110000
42,00101010,67,01000011,109,01101101
27,00011011,60,00111100,87,01010111
15,00001111,114,01110010,129,10000001
34,00100010,100,01100100,134,10000110
106,01101010,103,01100111,209,11010001
50,00110010,44,00101100,94,01011110
84,01010100,52,00110100,136,10001000
25,00011001,75,01001011,100,01100100
44,00101100,81,01010001,125,01111101
127,01111111,5,00000101,132,10000100
83,01010011,71,01000111,154,10011010
127,01111111,68,01000100,195,11000011
95,01011111,93,01011101,188,10111100
106,01101010,114,01110010,220,11011100
91,01011011,32,00100000,123,01111011
107,01101011,41,00101001,148,10010100
82,01010010,29,00011101,111,01101111
13,00001101,114,01110010,127,01111111
108,01101100,9,00001001,117,01110101
54,00110110,8,00001000,62,00111110
25,00011001,33,00100001,58,00111010
17,00010001,113,01110001,130,10000010
47,00101111,16,00010000,63,00111111
49,00110001,62,00111110,111,01101111
71,01000111,94,01011110,165,10100101
126,01111110,80,01010000,206,11001110
86,01010110,123,01111011,209,11010001
37,00100101,9,00001001,46,00101110
46,00101110,12,00001100,58,00111010
88,01011000,125,01111101,213,11010101
117,01110101,22,00010110,139,10001011
56,00111000,78,01001110,134,10000110
45,00101101,33,00100001,78,01001110
62,00111110,4,00000100,66,01000010
69,01000101,125,01111101,194,11000010
76,01001100,41,00101001,117,01110101
12,00001100,0,00000000,12,00001100
69,01000101,22,00010110,91,01011011
105,01101001,97,01100001,202,11001010
49,00110001,115,01110011,164,10100100
65,01000001,10,00001010,75,01001011
70,01000110,122,01111010,192,11000000
16,00010000,71,01000111,87,01010111
27,00011011,38,00100110,65,01000001
107,01101011,84,01010100,191,10111111
41,00101001,82,01010010,123,01111011
115,01110011,106,01101010,221,11011101
70,01000110,38,00100110,108,01101100
34,00100010,113,01110001,147,10010011
74,01001010,127,01111111,201,11001001
103,01100111,40,00101000,143,10001111
40,00101000,27,00011011,67,01000011
94,01011110,123,01111011,217,11011001
36,00100100,98,01100010,134,10000110
59,00111011,89,01011001,148,10010100
27,00011011,56,00111000,83,01010011
127,01111111,58,00111010,185,10111001
31,00011111,48,00110000,79,01001111
107,01101011,126,01111110,233,11101001
3,00000011,64,01000000,67,01000011
37,00100101,119,01110111,156,10011100
39,00100111,12,00001100,51,00110011
84,01010100,75,01001011,159,10011111
76,01001100,120,01111000,196,11000100
114,01110010,91,01011011,205,11001101
47,00101111,57,00111001,104,01101000
21,00010101,108,01101100,129,10000001
12,00001100,111,01101111,123,01111011
17,00010001,39,00100111,56,00111000
31,00011111,111,01101111,142,10001110
29,00011101,55,00110111,84,01010100
65,01000001,37,00100101,102,01100110
0,00000000,23,00010111,23,00010111
13,00001101,8,00001000,21,00010101
84,01010100,53,00110101,137,10001001
82,01010010,80,01010000,162,10100010
13,00001101,8,00001000,21,00010101
6,00000110,27,00011011,33,00100001
37,00100101,35,00100011,72,01001000
40,00101000,26,00011010,66,01000010
94,01011110,76,01001100,170,10101010
57,00111001,45,00101101,102,01100110
80,01010000,58,00111010,138,10001010
23,00010111,126,01111110,149,10010101
114,01110010,106,01101010,220,11011100
72,01001000,119,01110111,191,10111111
118,01110110,80,01010000,198,11000110
117,01110101,125,01111101,242,11110010
18,00010010,74,01001010,92,01011100
15,00001111,102,01100110,117,01110101
125,01111101,88,01011000,213,11010101
100,01100100,111,01101111,211,11010011
64,01000000,3,00000011,67,01000011
90,01011010,20,00010100,110,01101110
111,01101111,47,00101111,158,10011110
62,00111110,97,01100001,159,10011111
24,00011000,82,01010010,106,01101010
40,00101000,9,00001001,49,00110001
72,01001000,71,01000111,143,10001111
92,01011100,111,01101111,203,11001011
41,00101001,19,00010011,60,00111100
86,01010110,67,01000011,153,10011001
119,01110111,78,01001110,197,11000101
127,01111111,119,01110111,246,11110110
66,01000010,87,01010111,153,10011001
107,01101011,24,00011000,131,10000011
84,01010100,35,00100011,119,01110111
122,01111010,46,00101110,168,10101000
32,00100000,34,00100010,66,01000010
42,00101010,92,01011100,134,10000110
37,00100101,100,01100100,137,10001001
82,01010010,55,00110111,137,10001001
106,01101010,35,00100011,141,10001101
103,01100111,99,01100011,202,11001010
65,01000001,93,01011101,158,10011110
20,00010100,101,01100101,121,01111001
99,01100011,46,00101110,145,10010001
98,01100010,91,01011011,189,10111101
62,00111110,62,00111110,124,01111100
113,01110001,123,01111011,236,11101100
78,01001110,106,01101010,184,10111000
30,00011110,91,01011011,121,01111001
51,00110011,4,00000100,55,00110111
68,01000100,6,00000110,74,01001010
105,01101001,41,00101001,146,10010010
3,00000011,39,00100111,42,00101010
108,01101100,100,01100100,208,11010000
27,00011011,13,00001101,40,00101000
44,00101100,0,00000000,44,00101100
74,01001010,93,01011101,167,10100111
78,01001110,0,00000000,78,01001110
0,00000000,96,01100000,96,01100000
116,01110100,11,00001011,127,01111111
29,00011101,5,00000101,34,00100010
69,01000101,57,00111001,126,01111110
30,00011110,18,00010010,48,00110000
106,01101010,16,00010000,122,01111010
119,01110111,81,01010001,200,11001000
75,01001011,9,00001001,84,01010100
9,00001001,90,01011010,99,01100011
76,01001100,64,01000000,140,10001100
103,01100111,28,00011100,131,10000011
118,01110110,77,01001101,195,11000011
87,01010111,58,00111010,145,10010001
121,01111001,48,00110000,169,10101001
27,00011011,107,01101011,134,10000110
25,00011001,84,01010100,109,01101101
111,01101111,76,01001100,187,10111011
24,00011000,5,00000101,29,00011101
34,00100010,76,01001100,110,01101110
59,00111011,43,00101011,102,01100110
79,01001111,59,00111011,138,10001010
21,00010101,100,01100100,121,01111001
113,01110001,126,01111110,239,11101111
108,01101100,12,00001100,120,01111000
112,01110000,98,01100010,210,11010010
5,00000101,20,00010100,25,00011001
124,01111100,31,00011111,155,10011011
98,01100010,23,00010111,121,01111001
19,00010011,85,01010101,104,01101000
47,00101111,122,01111010,169,10101001
6,00000110,68,01000100,74,01001010
73,01001001,24,00011000,97,01100001
47,00101111,32,00100000,79,01001111
74,01001010,90,01011010,164,10100100
91,01011011,16,00010000,107,01101011
98,01100010,22,00010110,120,01111000
125,01111101,28,00011100,153,10011001
28,00011100,113,01110001,141,10001101
78,01001110,101,01100101,179,10110011
89,01011001,5,00000101,94,01011110
66,01000010,35,00100011,101,01100101
75,01001011,51,00110011,126,01111110
77,01001101,99,01100011,176,10110000
56,00111000,95,01011111,151,10010111
94,01011110,5,00000101,99,01100011
29,00011101,91,01011011,120,01111000
121,01111001,53,00110101,174,10101110
65,01000001,61,00111101,126,01111110
104,01101000,26,00011010,130,10000010
28,00011100,103,01100111,131,10000011
39,00100111,97,01100001,136,10001000
105,01101001,47,00101111,152,10011000
109,01101101,32,00100000,141,10001101
121,01111001,4,00000100,125,01111101
54,00110110,0,00000000,54,00110110
11,00001011,51,00110011,62,00111110
99,01100011,68,01000100,167,10100111
26,00011010,15,00001111,41,00101001
113,01110001,92,01011100,205,11001101
106,01101010,16,00010000,122,01111010
116,01110100,70,01000110,186,10111010
120,01111000,95,01011111,215,11010111
2,00000010,124,01111100,126,01111110
17,00010001,114,01110010,131,10000011
65,01000001,32,00100000,97,01100001
97,01100001,38,00100110,135,10000111
68,01000100,94,01011110,162,10100010
4,00000100,123,01111011,127,01111111
79,01001111,127,01111111,206,11001110
21,00010101,121,01111001,142,10001110
115,01110011,102,01100110,217,11011001
10,00001010,16,00010000,26,00011010
2,00000010,46,00101110,48,00110000
61,00111101,46,00101110,107,01101011
110,01101110,32,00100000,142,10001110
103,01100111,23,00010111,126,01111110
61,00111101,1,00000001,62,00111110
36,00100100,89,01011001,125,01111101
8,00001000,47,00101111,55,00110111
91,01011011,0,00000000,91,01011011
35,00100011,26,00011010,61,00111101
62,00111110,111,01101111,173,10101101
52,00110100,106,01101010,158,10011110
22,00010110,31,00011111,53,00110101
1,00000001,93,01011101,94,01011110
3,00000011,3,00000011,6,00000110
98,01100010,116,01110100,214,11010110
36,00100100,42,00101010,78,01001110
110,01101110,20,00010100,130,10000010
105,01101001,5,00000101,110,01101110
88,01011000,127,01111111,215,11010111
83,01010011,54,00110110,137,10001001
101,01100101,3,00000011,104,01101000
83,01010011,23,00010111,106,01101010
48,00110000,94,01011110,142,10001110
30,00011110,89,01011001,119,01110111
7,00000111,42,00101010,49,00110001
12,00001100,4,00000100,16,00010000
112,01110000,27,00011011,139,10001011
76,01001100,111,01101111,187,10111011
74,01001010,124,01111100,198,11000110
43,00101011,53,00110101,96,01100000
110,01101110,10,00001010,120,01111000
115,01110011,43,00101011,158,10011110
6,00000110,71,01000111,77,01001101
0,00000000,51,00110011,51,00110011
34,00100010,96,01100000,130,10000010
23,00010111,64,01000000,87,01010111
71,01000111,30,00011110,101,01100101
18,00010010,32,00100000,50,00110010
2,00000010,38,00100110,40,00101000
12,00001100,64,01000000,76,01001100
126,01111110,124,01111100,250,11111010
72,01001000,3,00000011,75,01001011
13,00001101,126,01111110,139,10001011
90,01011010,3,00000011,93,01011101
102,01100110,70,01000110,172,10101100
6,00000110,20,00010100,26,00011010
58,00111010,2,00000010,60,00111100
85,01010101,47,00101111,132,10000100
127,01111111,52,00110100,179,10110011
58,00111010,110,01101110,168,10101000
82,01010010,126,01111110,208,11010000
80,01010000,57,00111001,137,10001001
43,00101011,33,00100001,76,01001100
106,01101010,69,01000101,175,10101111
93,01011101,79,01001111,172,10101100
89,01011001,109,01101101,198,11000110
117,01110101,24,00011000,141,10001101
100,01100100,60,00111100,160,10100000
121,01111001,64,01000000,185,10111001
61,00111101,77,01001101,138,10001010
12,00001100,70,01000110,82,01010010
113,01110001,49,00110001,162,10100010
3,00000011,32,00100000,35,00100011
115,01110011,49,00110001,164,10100100
99,01100011,13,00001101,112,01110000
75,01001011,17,00010001,92,01011100
68,01000100,87,01010111,155,10011011
47,00101111,74,01001010,121,01111001
38,00100110,116,01110100,154,10011010
117,01110101,102,01100110,219,11011011
48,00110000,36,00100100,84,01010100
93,01011101,25,00011001,118,01110110
35,00100011,71,01000111,106,01101010
64,01000000,64,01000000,128,10000000
8,00001000,67,01000011,75,01001011
6,00000110,101,01100101,107,01101011
124,01111100,7,00000111,131,10000011
51,00110011,77,01001101,128,10000000
82,01010010,120,01111000,202,11001010
17,00010001,3,00000011,20,00010100
126,01111110,8,00001000,134,10000110
47,00101111,43,00101011,90,01011010
61,00111101,3,00000011,64,01000000
44,00101100,75,01001011,119,01110111
117,01110101,49,00110001,166,10100110
50,00110010,10,00001010,60,00111100
43,00101011,79,01001111,122,01111010
91,01011011,102,01100110,193,11000001
62,00111110,99,01100011,161,10100001
82,01010010,125,01111101,207,11001111
62,00111110,117,01110101,179,10110011
35,00100011,85,01010101,120,01111000
28,00011100,59,00111011,87,01010111
97,01100001,89,01011001,186,10111010
74,01001010,1,00000001,75,01001011
122,01111010,21,00010101,143,10001111
25,00011001,10,00001010,35,00100011
120,01111000,41,00101001,161,10100001
13,00001101,51,00110011,64,01000000
66,01000010,82,01010010,148,10010100
84,01010100,7,00000111,91,01011011
40,00101000,56,00111000,96,01100000
85,01010101,37,00100101,122,01111010
46,00101110,83,01010011,129,10000001
90,01011010,55,00110111,145,10010001
6,00000110,0,00000000,6,00000110
8,00001000,124,01111100,132,10000100
85,01010101,123,01111011,208,11010000
111,01101111,37,00100101,148,10010100
67,01000011,46,00101110,113,01110001
104,01101000,41,00101001,145,10010001
92,01011100,63,00111111,155,10011011
57,00111001,119,01110111,176,10110000
100,01100100,39,00100111,139,10001011
65,01000001,51,00110011,116,01110100
61,00111101,109,01101101,170,10101010
69,01000101,58,00111010,127,01111111
91,01011011,95,01011111,186,10111010
40,00101000,73,01001001,113,01110001
53,00110101,120,01111000,173,10101101
7,00000111,99,01100011,106,01101010
47,00101111,69,01000101,116,01110100
41,00101001,28,00011100,69,01000101
118,01110110,122,01111010,240,11110000
85,01010101,11,00001011,96,01100000
3,00000011,18,00010010,21,00010101
35,00100011,46,00101110,81,01010001
105,01101001,17,00010001,122,01111010
111,01101111,27,00011011,138,10001010
54,00110110,111,01101111,165,10100101
73,01001001,19,00010011,92,01011100
71,01000111,71,01000111,142,10001110
101,01100101,43,00101011,144,10010000
126,01111110,44,00101100,170,10101010
110,01101110,46,00101110,156,10011100
34,00100010,33,00100001,67,01000011
74,01001010,119,01110111,193,11000001
69,01000101,92,01011100,161,10100001
46,00101110,32,00100000,78,01001110
83,01010011,39,00100111,122,01111010
30,00011110,95,01011111,125,01111101
111,01101111,47,00101111,158,10011110
1,00000001,32,00100000,33,00100001
126,01111110,104,01101000,230,11100110
113,01110001,63,00111111,176,10110000
119,01110111,45,00101101,164,10100100
55,00110111,110,01101110,165,10100101
118,01110110,64,01000000,182,10110110
101,01100101,85,01010101,186,10111010
22,00010110,27,00011011,49,00110001
5,00000101,109,01101101,114,01110010
35,00100011,109,01101101,144,10010000
35,00100011,124,01111100,159,10011111
104,01101000,67,01000011,171,10101011
28,00011100,91,01011011,119,01110111
123,01111011,9,00001001,132,10000100
43,00101011,3,00000011,46,00101110
107,01101011,11,00001011,118,01110110
51,00110011,86,01010110,137,10001001
106,01101010,106,01101010,212,11010100
4,00000100,29,00011101,33,00100001
60,00111100,44,00101100,104,01101000
2,00000010,94,01011110,96,01100000
69,01000101,47,00101111,116,01110100
76,01001100,17,00010001,93,01011101
79,01001111,56,00111000,135,10000111
41,00101001,24,00011000,65,01000001
85,01010101,104,01101000,189,10111101
3,00000011,60,00111100,63,00111111
46,00101110,112,01110000,158,10011110
31,00011111,70,01000110,101,01100101
127,01111111,51,00110011,178,10110010
97,01100001,47,00101111,144,10010000
11,00001011,103,01100111,114,01110010
62,00111110,8,00001000,70,01000110
62,00111110,3,00000011,65,01000001
55,00110111,107,01101011,162,10100010
54,00110110,103,01100111,157,10011101
41,00101001,54,00110110,95,01011111
25,00011001,109,01101101,134,10000110
6,00000110,71,01000111,77,01001101
104,01101000,63,00111111,167,10100111
93,01011101,126,01111110,219,11011011
69,01000101,38,00100110,107,01101011
67,01000011,7,00000111,74,01001010
114,01110010,43,00101011,157,10011101
23,00010111,88,01011000,111,01101111
114,01110010,29,00011101,143,10001111
51,00110011,17,00010001,68,01000100
56,00111000,43,00101011,99,01100011
33,00100001,48,00110000,81,01010001
78,01001110,106,01101010,184,10111000
42,00101010,80,01010000,122,01111010
111,01101111,117,01110101,228,11100100
1,00000001,106,01101010,107,01101011
53,00110101,64,01000000,117,01110101
115,01110011,127,01111111,242,11110010
56,00111000,15,00001111,71,01000111
80,01010000,72,01001000,152,10011000
105,01101001,20,00010100,125,01111101
61,00111101,63,00111111,124,01111100
54,00110110,43,00101011,97,01100001
25,00011001,0,00000000,25,00011001
123,01111011,49,00110001,172,10101100
39,00100111,2,00000010,41,00101001
70,01000110,3,00000011,73,01001001
30,00011110,13,00001101,43,00101011
20,00010100,116,01110100,136,10001000
75,01001011,11,00001011,86,01010110
5,00000101,112,01110000,117,01110101
16,00010000,77,01001101,93,01011101
62,00111110,8,00001000,70,01000110
27,00011011,6,00000110,33,00100001
108,01101100,118,01110110,226,11100010
42,00101010,4,00000100,46,00101110
104,01101000,105,01101001,209,11010001
15,00001111,60,00111100,75,01001011
0,00000000,39,00100111,39,00100111
37,00100101,6,00000110,43,00101011
115,01110011,93,01011101,208,11010000
58,00111010,111,01101111,169,10101001
25,00011001,76,01001100,101,01100101
64,01000000,62,00111110,126,01111110
52,00110100,50,00110010,102,01100110
49,00110001,28,00011100,77,01001101
122,01111010,71,01000111,193,11000001
65,01000001,108,01101100,173,10101101
112,01110000,50,00110010,162,10100010
7,00000111,104,01101000,111,01101111
26,00011010,40,00101000,66,01000010
61,00111101,48,00110000,109,01101101
110,01101110,22,00010110,132,10000100
14,00001110,63,00111111,77,01001101
95,01011111,85,01010101,180,10110100
52,00110100,7,00000111,59,00111011
36,00100100,80,01010000,116,01110100
70,01000110,106,01101010,176,10110000
20,00010100,38,00100110,58,00111010
4,00000100,16,00010000,20,00010100
98,01100010,111,01101111,209,11010001
56,00111000,123,01111011,179,10110011
111,01101111,14,00001110,125,01111101
111,01101111,103,01100111,214,11010110
127,01111111,15,00001111,142,10001110
88,01011000,14,00001110,102,01100110
10,00001010,118,01110110,128,10000000
4,00000100,84,01010100,88,01011000
105,01101001,104,01101000,209,11010001
52,00110100,75,01001011,127,01111111
124,01111100,53,00110101,177,10110001
93,01011101,67,01000011,160,10100000
116,01110100,44,00101100,160,10100000
90,01011010,124,01111100,214,11010110
91,01011011,2,00000010,93,01011101
60,00111100,66,01000010,126,01111110
125,01111101,23,00010111,148,10010100
109,01101101,28,00011100,137,10001001
121,01111001,53,00110101,174,10101110
18,00010010,111,01101111,129,10000001
59,00111011,65,01000001,124,01111100
68,01000100,36,00100100,104,01101000
81,01010001,24,00011000,105,01101001
89,01011001,107,01101011,196,11000100
76,01001100,34,00100010,110,01101110
85,01010101,56,00111000,141,10001101
114,01110010,63,00111111,177,10110001
73,01001001,36,00100100,109,01101101
107,01101011,41,00101001,148,10010100
6,00000110,17,00010001,23,00010111
31,00011111,122,01111010,153,10011001
114,01110010,111,01101111,225,11100001
108,01101100,6,00000110,114,01110010
50,00110010,16,00010000,66,01000010
30,00011110,28,00011100,58,00111010
127,01111111,75,01001011,202,11001010
32,00100000,102,01100110,134,10000110
89,01011001,38,00100110,127,01111111
29,00011101,2,00000010,31,00011111
83,01010011,76,01001100,159,10011111
18,00010010,64,01000000,82,01010010
41,00101001,22,00010110,63,00111111
17,00010001,42,00101010,59,00111011
4,00000100,4,00000100,8,00001000
18,00010010,69,01000101,87,01010111
14,00001110,10,00001010,24,00011000
50,00110010,93,01011101,143,10001111
83,01010011,34,00100010,117,01110101
3,00000011,8,00001000,11,00001011
90,01011010,82,01010010,172,10101100
68,01000100,7,00000111,75,01001011
106,01101010,93,01011101,199,11000111
35,00100011,79,01001111,114,01110010
46,00101110,45,00101101,91,01011011
67,01000011,58,00111010,125,01111101
3,00000011,70,01000110,73,01001001
66,01000010,101,01100101,167,10100111
24,00011000,55,00110111,79,01001111
59,00111011,35,00100011,94,01011110
3,00000011,71,01000111,74,01001010
27,00011011,114,01110010,141,10001101
66,01000010,126,01111110,192,11000000
112,01110000,71,01000111,183,10110111
10,00001010,109,01101101,119,01110111
63,00111111,123,01111011,186,10111010
112,01110000,121,01111001,233,11101001
5,00000101,116,01110100,121,01111001
40,00101000,86,01010110,126,01111110
52,00110100,43,00101011,95,01011111
65,01000001,6,00000110,71,01000111
28,00011100,5,00000101,33,00100001
104,01101000,74,01001010,178,10110010
7,00000111,29,00011101,36,00100100
100,01100100,82,01010010,182,10110110
47,00101111,60,00111100,107,01101011
63,00111111,123,01111011,186,10111010
66,01000010,41,00101001,107,01101011
29,00011101,96,01100000,125,01111101
49,00110001,60,00111100,109,01101101
52,00110100,25,00011001,77,01001101
36,00100100,19,00010011,55,00110111
96,01100000,117,01110101,213,11010101
91,01011011,26,00011010,117,01110101
56,00111000,56,00111000,112,01110000
28,00011100,45,00101101,73,01001001
87,01010111,82,01010010,169,10101001
5,00000101,65,01000001,70,01000110
85,01010101,34,00100010,119,01110111
1,00000001,93,01011101,94,01011110
109,01101101,98,01100010,207,11001111
14,00001110,106,01101010,120,01111000
30,00011110,9,00001001,39,00100111
54,00110110,27,00011011,81,01010001
7,00000111,76,01001100,83,01010011
93,01011101,36,00100100,129,10000001
38,00100110,92,01011100,130,10000010
113,01110001,85,01010101,198,11000110
87,01010111,37,00100101,124,01111100
20,00010100,13,00001101,33,00100001
109,01101101,40,00101000,149,10010101
50,00110010,105,01101001,155,10011011
54,00110110,126,01111110,180,10110100
65,01000001,72,01001000,137,10001001
58,00111010,103,01100111,161,10100001
108,01101100,73,01001001,181,10110101
49,00110001,17,00010001,66,01000010
49,00110001,89,01011001,138,10001010
87,01010111,57,00111001,144,10010000
104,01101000,121,01111001,225,11100001
115,01110011,74,01001010,189,10111101
90,01011010,13,00001101,103,01100111
31,00011111,124,01111100,155,10011011
21,00010101,97,01100001,118,01110110
109,01101101,1,00000001,110,01101110
96,01100000,43,00101011,139,10001011
55,00110111,70,01000110,125,01111101
34,00100010,94,01011110,128,10000000
46,00101110,90,01011010,136,10001000
102,01100110,100,01100100,202,11001010
17,00010001,112,01110000,129,10000001
12,00001100,52,00110100,64,01000000
47,00101111,116,01110100,163,10100011
39,00100111,112,01110000,151,10010111
48,00110000,55,00110111,103,01100111
25,00011001,64,01000000,89,01011001
60,00111100,102,01100110,162,10100010
30,00011110,105,01101001,135,10000111
111,01101111,100,01100100,211,11010011
102,01100110,92,01011100,194,11000010
106,01101010,87,01010111,193,11000001
79,01001111,38,00100110,117,01110101
102,01100110,86,01010110,188,10111100
48,00110000,7,00000111,55,00110111
37,00100101,114,01110010,151,10010111
66,01000010,77,01001101,143,10001111
20,00010100,46,00101110,66,01000010
93,01011101,32,00100000,125,01111101
52,00110100,55,00110111,107,01101011
19,00010011,108,01101100,127,01111111
108,01101100,56,00111000,164,10100100
22,00010110,86,01010110,108,01101100
108,01101100,101,01100101,209,11010001
60,00111100,34,00100010,94,01011110
61,00111101,54,00110110,115,01110011
38,00100110,85,01010101,123,01111011
92,01011100,48,00110000,140,10001100
34,00100010,61,00111101,95,01011111
65,01000001,54,00110110,119,01110111
109,01101101,110,01101110,219,11011011
17,00010001,52,00110100,69,01000101
34,00100010,43,00101011,77,01001101
13,00001101,17,00010001,30,00011110
31,00011111,21,00010101,52,00110100
98,01100010,109,01101101,207,11001111
1,00000001,69,01000101,70,01000110
47,00101111,114,01110010,161,10100001
38,00100110,63,00111111,101,01100101
31,00011111,92,01011100,123,01111011
102,01100110,122,01111010,224,11100000
114,01110010,112,01110000,226,11100010
68,01000100,37,00100101,105,01101001
7,00000111,67,01000011,74,01001010
54,00110110,21,00010101,75,01001011
21,00010101,57,00111001,78,01001110
90,01011010,66,01000010,156,10011100
92,01011100,47,00101111,139,10001011
32,00100000,101,01100101,133,10000101
33,00100001,99,01100011,132,10000100
58,00111010,32,00100000,90,01011010
103,01100111,17,00010001,120,01111000
9,00001001,99,01100011,108,01101100
44,00101100,86,01010110,130,10000010
5,00000101,86,01010110,91,01011011
9,00001001,118,01110110,127,01111111
65,01000001,61,00111101,126,01111110
107,01101011,5,00000101,112,01110000
106,01101010,68,01000100,174,10101110
7,00000111,54,00110110,61,00111101
19,00010011,114,01110010,133,10000101
51,00110011,38,00100110,89,01011001
117,01110101,119,01110111,236,11101100
13,00001101,11,00001011,24,00011000
87,01010111,102,01100110,189,10111101
54,00110110,53,00110101,107,01101011
75,01001011,40,00101000,115,01110011
117,01110101,95,01011111,212,11010100
3,00000011,119,01110111,122,01111010
61,00111101,2,00000010,63,00111111
71,01000111,2,00000010,73,01001001
25,00011001,46,00101110,71,01000111
5,00000101,16,00010000,21,00010101
114,01110010,8,00001000,122,01111010
81,01010001,120,01111000,201,11001001
114,01110010,92,01011100,206,11001110
78,01001110,56,00111000,134,10000110
6,00000110,77,01001101,83,01010011
56,00111000,92,01011100,148,10010100
3,00000011,108,01101100,111,01101111
59,00111011,102,01100110,161,10100001
111,01101111,4,00000100,115,01110011
0,00000000,75,01001011,75,01001011
38,00100110,6,00000110,44,00101100
115,01110011,20,00010100,135,10000111
120,01111000,70,01000110,190,10111110
16,00010000,64,01000000,80,01010000
67,01000011,123,01111011,190,10111110
69,01000101,111,01101111,180,10110100
61,00111101,39,00100111,100,01100100
59,00111011,80,01010000,139,10001011
89,01011001,121,01111001,210,11010010
94,01011110,27,00011011,121,01111001
75,01001011,104,01101000,179,10110011
64,01000000,33,00100001,97,01100001
25,00011001,52,00110100,77,01001101
14,00001110,48,00110000,62,00111110
34,00100010,116,01110100,150,10010110
40,00101000,50,00110010,90,01011010
62,00111110,114,01110010,176,10110000
43,00101011,119,01110111,162,10100010
38,00100110,19,00010011,57,00111001
42,00101010,98,01100010,140,10001100
102,01100110,21,00010101,123,01111011
20,00010100,90,01011010,110,01101110
35,00100011,27,00011011,62,00111110
3,00000011,89,01011001,92,01011100
124,01111100,7,00000111,131,10000011
4,00000100,4,00000100,8,00001000
53,00110101,9,00001001,62,00111110
68,01000100,33,00100001,101,01100101
49,00110001,74,01001010,123,01111011
23,00010111,57,00111001,80,01010000
112,01110000,96,01100000,208,11010000
77,01001101,21,00010101,98,01100010
92,01011100,23,00010111,115,01110011
112,01110000,5,00000101,117,01110101
61,00111101,2,00000010,63,00111111
0,00000000,9,00001001,9,00001001
71,01000111,29,00011101,100,01100100
21,00010101,80,01010000,101,01100101
78,01001110,83,01010011,161,10100001
37,00100101,90,01011010,127,01111111
76,01001100,79,01001111,155,10011011
83,01010011,18,00010010,101,01100101
106,01101010,66,01000010,172,10101100
16,00010000,120,01111000,136,10001000
75,01001011,99,01100011,174,10101110
9,00001001,121,01111001,130,10000010
73,01001001,30,00011110,103,01100111
22,00010110,106,01101010,128,10000000
20,00010100,105,01101001,125,01111101
83,01010011,68,01000100,151,10010111
110,01101110,79,01001111,189,10111101
33,00100001,64,01000000,97,01100001
111,01101111,15,00001111,126,01111110
77,01001101,9,00001001,86,01010110
49,00110001,106,01101010,155,10011011
10,00001010,113,01110001,123,01111011
103,01100111,34,00100010,137,10001001
39,00100111,48,00110000,87,01010111
44,00101100,108,01101100,152,10011000
106,01101010,1,00000001,107,01101011
72,01001000,0,00000000,72,01001000
11,00001011,26,00011010,37,00100101
94,01011110,107,01101011,201,11001001
42,00101010,19,00010011,61,00111101
85,01010101,111,01101111,196,11000100
1,00000001,122,01111010,123,01111011
60,00111100,82,01010010,142,10001110
92,01011100,62,00111110,154,10011010
11,00001011,123,01111011,134,10000110
49,00110001,63,00111111,112,01110000
116,01110100,103,01100111,219,11011011
9,00001001,24,00011000,33,00100001
68,01000100,26,00011010,94,01011110
52,00110100,107,01101011,159,10011111
54,00110110,85,01010101,139,10001011
78,01001110,29,00011101,107,01101011
1,00000001,78,01001110,79,01001111
0,00000000,15,00001111,15,00001111
33,00100001,32,00100000,65,01000001
125,01111101,115,01110011,240,11110000
101,01100101,69,01000101,170,10101010
30,00011110,118,01110110,148,10010100
105,01101001,47,00101111,152,10011000
114,01110010,58,00111010,172,10101100
73,01001001,117,01110101,190,10111110
7,00000111,126,01111110,133,10000101
30,00011110,85,01010101,115,01110011
30,00011110,41,00101001,71,01000111
8,00001000,65,01000001,73,01001001
109,01101101,85,01010101,194,11000010
8,00001000,121,01111001,129,10000001
109,01101101,49,00110001,158,10011110
116,01110100,64,01000000,180,10110100
91,01011011,50,00110010,141,10001101
48,00110000,89,01011001,137,10001001
29,00011101,71,01000111,100,01100100
26,00011010,95,01011111,121,01111001
14,00001110,121,01111001,135,10000111
19,00010011,126,01111110,145,10010001
8,00001000,39,00100111,47,00101111
29,00011101,23,00010111,52,00110100
77,01001101,40,00101000,117,01110101
1,00000001,89,01011001,90,01011010
88,01011000,30,00011110,118,01110110
41,00101001,80,01010000,121,01111001
124,01111100,62,00111110,186,10111010
75,01001011,103,01100111,178,10110010
71,01000111,102,01100110,173,10101101
85,01010101,88,01011000,173,10101101
37,00100101,43,00101011,80,01010000
59,00111011,36,00100100,95,01011111
32,00100000,73,01001001,105,01101001
113,01110001,127,01111111,240,11110000
104,01101000,16,00010000,120,01111000
35,00100011,119,01110111,154,10011010
3,00000011,39,00100111,42,00101010
37,00100101,122,01111010,159,10011111
3,00000011,40,00101000,43,00101011
58,00111010,99,01100011,157,10011101
1,00000001,3,00000011,4,00000100
11,00001011,3,00000011,14,00001110
110,01101110,126,01111110,236,11101100
59,00111011,12,00001100,71,01000111
96,01100000,39,00100111,135,10000111
50,00110010,0,00000000,50,00110010
54,00110110,54,00110110,108,01101100
111,01101111,87,01010111,198,11000110
71,01000111,59,00111011,130,10000010
65,01000001,98,01100010,163,10100011
13,00001101,56,00111000,69,01000101
30,00011110,85,01010101,115,01110011
81,01010001,23,00010111,104,01101000
35,00100011,33,00100001,68,01000100
6,00000110,24,00011000,30,00011110
34,00100010,119,01110111,153,10011001
104,01101000,57,00111001,161,10100001
102,01100110,73,01001001,175,10101111
24,00011000,93,01011101,117,01110101
5,00000101,112,01110000,117,01110101
48,00110000,25,00011001,73,01001001
68,01000100,110,01101110,178,10110010
38,00100110,0,00000000,38,00100110
59,00111011,78,01001110,137,10001001
73,01001001,100,01100100,173,10101101
111,01101111,50,00110010,161,10100001
28,00011100,15,00001111,43,00101011
66,01000010,36,00100100,102,01100110
7,00000111,81,01010001,88,01011000
31,00011111,43,00101011,74,01001010
41,00101001,79,01001111,120,01111000
28,00011100,126,01111110,154,10011010
54,00110110,52,00110100,106,01101010
118,01110110,42,00101010,160,10100000
120,01111000,31,00011111,151,10010111
86,01010110,57,00111001,143,10001111
114,01110010,23,00010111,137,10001001
124,01111100,68,01000100,192,11000000
64,01000000,17,00010001,81,01010001
70,01000110,68,01000100,138,10001010
75,01001011,96,01100000,171,10101011
80,01010000,2,00000010,82,01010010
122,01111010,74,01001010,196,11000100
39,00100111,126,01111110,165,10100101
38,00100110,54,00110110,92,01011100
124,01111100,103,01100111,227,11100011
125,01111101,119,01110111,244,11110100
0,00000000,9,00001001,9,00001001
75,01001011,44,00101100,119,01110111
52,00110100,81,01010001,133,10000101
100,01100100,105,01101001,205,11001101
47,00101111,69,01000101,116,01110100
105,01101001,48,00110000,153,10011001
38,00100110,36,00100100,74,01001010
4,00000100,123,01111011,127,01111111
113,01110001,75,01001011,188,10111100
39,00100111,93,01011101,132,10000100
107,01101011,62,00111110,169,10101001
45,00101101,75,01001011,120,01111000
42,00101010,32,00100000,74,01001010
1,00000001,108,01101100,109,01101101
47,00101111,34,00100010,81,01010001
42,00101010,42,00101010,84,01010100
108,01101100,74,01001010,182,10110110
42,00101010,124,01111100,166,10100110
104,01101000,46,00101110,150,10010110
103,01100111,79,01001111,182,10110110
109,01101101,90,01011010,199,11000111
105,01101001,40,00101000,145,10010001
108,01101100,112,01110000,220,11011100
80,01010000,43,00101011,123,01111011
92,01011100,64,01000000,156,10011100
63,00111111,44,00101100,107,01101011
125,01111101,2,00000010,127,01111111
22,00010110,124,01111100,146,10010010
24,00011000,44,00101100,68,01000100
83,01010011,94,01011110,177,10110001
77,01001101,7,00000111,84,01010100
83,01010011,99,01100011,182,10110110
53,00110101,117,01110101,170,10101010
62,00111110,29,00011101,91,01011011
84,01010100,8,00001000,92,01011100
74,01001010,41,00101001,115,01110011
34,00100010,46,00101110,80,01010000
61,00111101,75,01001011,136,10001000
125,01111101,72,01001000,197,11000101
117,01110101,55,00110111,172,10101100
85,01010101,116,01110100,201,11001001
68,01000100,47,00101111,115,01110011
7,00000111,120,01111000,127,01111111
56,00111000,85,01010101,141,10001101
86,01010110,70,01000110,156,10011100
19,00010011,43,00101011,62,00111110
70,01000110,96,01100000,166,10100110
123,01111011,101,01100101,224,11100000
86,01010110,105,01101001,191,10111111
21,00010101,116,01110100,137,10001001
11,00001011,43,00101011,54,00110110
67,01000011,96,01100000,163,10100011
29,00011101,21,00010101,50,00110010
81,01010001,69,01000101,150,10010110
111,01101111,91,01011011,202,11001010
1,00000001,33,00100001,34,00100010
40,00101000,107,01101011,147,10010011
103,01100111,121,01111001,224,11100000
43,00101011,51,00110011,94,01011110
101,01100101,94,01011110,195,11000011
82,01010010,54,00110110,136,10001000
79,01001111,124,01111100,203,11001011
51,00110011,45,00101101,96,01100000
104,01101000,93,01011101,197,11000101
4,00000100,56,00111000,60,00111100
48,00110000,120,01111000,168,10101000
106,01101010,20,00010100,126,01111110
16,00010000,53,00110101,69,01000101
85,01010101,66,01000010,151,10010111
20,00010100,109,01101101,129,10000001
56,00111000,24,00011000,80,01010000
43,00101011,84,01010100,127,01111111
109,01101101,63,00111111,172,10101100
15,00001111,97,01100001,112,01110000
24,00011000,88,01011000,112,01110000
104,01101000,91,01011011,195,11000011
61,00111101,3,00000011,64,01000000
19,00010011,12,00001100,31,00011111
114,01110010,44,00101100,158,10011110
74,01001010,9,00001001,83,01010011
63,00111111,92,01011100,155,10011011
117,01110101,46,00101110,163,10100011
95,01011111,87,01010111,182,10110110
13,00001101,69,01000101,82,01010010
45,00101101,104,01101000,149,10010101
7,00000111,41,00101001,48,00110000
110,01101110,16,00010000,126,01111110
50,00110010,39,00100111,89,01011001
35,00100011,106,01101010,141,10001101
28,00011100,117,01110101,145,10010001
81,01010001,37,00100101,118,01110110
1,00000001,81,01010001,82,01010010
30,00011110,34,00100010,64,01000000
116,01110100,3,00000011,119,01110111
33,00100001,43,00101011,76,01001100
89,01011001,1,00000001,90,01011010
98,01100010,56,00111000,154,10011010
49,00110001,103,01100111,152,10011000
40,00101000,82,01010010,122,01111010
41,00101001,54,00110110,95,01011111
85,01010101,47,00101111,132,10000100
92,01011100,127,01111111,219,11011011
65,01000001,41,00101001,106,01101010
38,00100110,12,00001100,50,00110010
79,01001111,28,00011100,107,01101011
25,00011001,123,01111011,148,10010100
114,01110010,53,00110101,167,10100111
86,01010110,63,00111111,149,10010101
91,01011011,77,01001101,168,10101000
33,00100001,78,01001110,111,01101111
117,01110101,8,00001000,125,01111101
68,01000100,46,00101110,114,01110010
118,01110110,85,01010101,203,11001011
45,00101101,92,01011100,137,10001001
22,00010110,14,00001110,36,00100100
0,00000000,50,00110010,50,00110010
101,01100101,54,00110110,155,10011011
50,00110010,9,00001001,59,00111011
33,00100001,116,01110100,149,10010101
40,00101000,40,00101000,80,01010000
115,01110011,7,00000111,122,01111010
26,00011010,29,00011101,55,00110111
50,00110010,57,00111001,107,01101011
17,00010001,126,01111110,143,10001111
10,00001010,43,00101011,53,00110101
62,00111110,97,01100001,159,10011111
65,01000001,102,01100110,167,10100111
125,01111101,19,00010011,144,10010000
93,01011101,6,00000110,99,01100011
5,00000101,68,01000100,73,01001001
66,01000010,119,01110111,185,10111001
40,00101000,104,01101000,144,10010000
80,01010000,71,01000111,151,10010111
40,00101000,24,00011000,64,01000000
87,01010111,52,00110100,139,10001011
122,01111010,22,00010110,144,10010000
41,00101001,6,00000110,47,00101111
120,01111000,78,01001110,198,11000110
51,00110011,39,00100111,90,01011010
127,01111111,24,00011000,151,10010111
31,00011111,20,00010100,51,00110011
18,00010010,35,00100011,53,00110101
96,01100000,84,01010100,180,10110100
88,01011000,96,01100000,184,10111000
91,01011011,44,00101100,135,10000111
122,01111010,100,01100100,222,11011110
82,01010010,22,00010110,104,01101000
98,01100010,31,00011111,129,10000001
50,00110010,18,00010010,68,01000100
124,01111100,78,01001110,202,11001010
7,00000111,11,00001011,18,00010010
63,00111111,74,01001010,137,10001001
57,00111001,58,00111010,115,01110011
38,00100110,41,00101001,79,01001111
86,01010110,64,01000000,150,10010110
34,00100010,81,01010001,115,01110011
42,00101010,52,00110100,94,01011110
70,01000110,3,00000011,73,01001001
40,00101000,123,01111011,163,10100011
91,01011011,76,01001100,167,10100111
39,00100111,85,01010101,124,01111100
25,00011001,0,00000000,25,00011001
107,01101011,34,00100010,141,10001101
125,01111101,65,01000001,190,10111110
112,01110000,43,00101011,155,10011011
37,00100101,110,01101110,147,10010011
107,01101011,89,01011001,196,11000100
87,01010111,42,00101010,129,10000001
115,01110011,68,01000100,183,10110111
52,00110100,71,01000111,123,01111011
93,01011101,1,00000001,94,01011110
23,00010111,87,01010111,110,01101110
88,01011000,89,01011001,177,10110001
69,01000101,22,00010110,91,01011011
113,01110001,80,01010000,193,11000001
95,01011111,112,01110000,207,11001111
64,01000000,114,01110010,178,10110010
67,01000011,97,01100001,164,10100100
31,00011111,70,01000110,101,01100101
52,00110100,64,01000000,116,01110100
8,00001000,24,00011000,32,00100000
70,01000110,75,01001011,145,10010001
68,01000100,62,00111110,130,10000010
117,01110101,101,01100101,218,11011010
71,01000111,119,01110111,190,10111110
25,00011001,51,00110011,76,01001100
42,00101010,5,00000101,47,00101111
37,00100101,4,00000100,41,00101001
124,01111100,127,01111111,251,11111011
62,00111110,42,00101010,104,01101000
121,01111001,12,00001100,133,10000101
16,00010000,57,00111001,73,01001001
69,01000101,13,00001101,82,01010010
11,00001011,86,01010110,97,01100001
106,01101010,39,00100111,145,10010001
0,00000000,24,00011000,24,00011000
112,01110000,27,00011011,139,10001011
119,01110111,30,00011110,149,10010101
88,01011000,92,01011100,180,10110100
24,00011000,127,01111111,151,10010111
126,01111110,94,01011110,220,11011100
121,01111001,52,00110100,173,10101101
110,01101110,32,00100000,142,10001110
62,00111110,61,00111101,123,01111011
110,01101110,99,01100011,209,11010001
86,01010110,47,00101111,133,10000101
8,00001000,3,00000011,11,00001011
100,01100100,52,00110100,152,10011000
78,01001110,60,00111100,138,10001010
100,01100100,59,00111011,159,10011111
81,01010001,59,00111011,140,10001100
83,01010011,88,01011000,171,10101011
88,01011000,99,01100011,187,10111011
114,01110010,65,01000001,179,10110011
76,01001100,84,01010100,160,10100000
7,00000111,86,01010110,93,01011101
44,00101100,120,01111000,164,10100100
79,01001111,32,00100000,111,01101111
33,00100001,77,01001101,110,01101110
1,00000001,3,00000011,4,00000100
39,00100111,120,01111000,159,10011111
62,00111110,62,00111110,124,01111100
100,01100100,102,01100110,202,11001010
27,00011011,58,00111010,85,01010101
98,01100010,109,01101101,207,11001111
102,01100110,47,00101111,149,10010101
25,00011001,80,01010000,105,01101001
112,01110000,114,01110010,226,11100010
127,01111111,73,01001001,200,11001000
25,00011001,64,01000000,89,01011001
15,00001111,117,01110101,132,10000100
80,01010000,106,01101010,186,10111010
125,01111101,100,01100100,225,11100001
7,00000111,23,00010111,30,00011110
113,01110001,40,00101000,153,10011001
38,00100110,109,01101101,147,10010011
37,00100101,113,01110001,150,10010110
101,01100101,68,01000100,169,10101001
98,01100010,86,01010110,184,10111000
60,00111100,122,01111010,182,10110110
49,00110001,30,00011110,79,01001111
123,01111011,97,01100001,220,11011100
91,01011011,71,01000111,162,10100010
77,01001101,89,01011001,166,10100110
37,00100101,31,00011111,68,01000100
100,01100100,122,01111010,222,11011110
49,00110001,47,00101111,96,01100000
53,00110101,103,01100111,156,10011100
8,00001000,18,00010010,26,00011010
84,01010100,25,00011001,109,01101101
39,00100111,93,01011101,132,10000100
2,00000010,104,01101000,106,01101010
50,00110010,81,01010001,131,10000011
104,01101000,103,01100111,207,11001111
97,01100001,3,00000011,100,01100100
26,00011010,53,00110101,79,01001111
111,01101111,88,01011000,199,11000111
63,00111111,127,01111111,190,10111110
127,01111111,113,01110001,240,11110000
94,01011110,115,01110011,209,11010001
57,00111001,65,01000001,122,01111010
106,01101010,82,01010010,188,10111100
71,01000111,43,00101011,114,01110010
69,01000101,58,00111010,127,01111111
40,00101000,101,01100101,141,10001101
19,00010011,34,00100010,53,00110101
85,01010101,100,01100100,185,10111001
88,01011000,94,01011110,182,10110110
65,01000001,0,00000000,65,01000001
88,01011000,109,01101101,197,11000101
47,00101111,120,01111000,167,10100111
4,00000100,64,01000000,68,01000100
36,00100100,60,00111100,96,01100000
50,00110010,55,00110111,105,01101001
84,01010100,68,01000100,152,10011000
5,00000101,61,00111101,66,01000010
78,01001110,22,00010110,100,01100100
79,01001111,83,01010011,162,10100010
76,01001100,61,00111101,137,10001001
39,00100111,32,00100000,71,01000111
57,00111001,30,00011110,87,01010111
84,01010100,20,00010100,104,01101000
58,00111010,69,01000101,127,01111111
74,01001010,88,01011000,162,10100010
75,01001011,21,00010101,96,01100000
124,01111100,70,01000110,194,11000010
65,01000001,52,00110100,117,01110101
13,00001101,79,01001111,92,01011100
111,01101111,43,00101011,154,10011010
85,01010101,67,01000011,152,10011000
93,01011101,9,00001001,102,01100110
54,00110110,88,01011000,142,10001110
55,00110111,100,01100100,155,10011011
124,01111100,122,01111010,246,11110110
55,00110111,56,00111000,111,01101111
49,00110001,20,00010100,69,01000101
37,00100101,53,00110101,90,01011010
61,00111101,110,01101110,171,10101011
83,01010011,40,00101000,123,01111011
126,01111110,67,01000011,193,11000001
37,00100101,3,00000011,40,00101000
84,01010100,38,00100110,122,01111010
94,01011110,33,00100001,127,01111111
89,01011001,41,00101001,130,10000010
108,01101100,119,01110111,227,11100011
22,00010110,101,01100101,123,01111011
66,01000010,57,00111001,123,01111011
27,00011011,110,01101110,137,10001001
115,01110011,101,01100101,216,11011000
58,00111010,120,01111000,178,10110010
28,00011100,60,00111100,88,01011000
99,01100011,47,00101111,146,10010010
33,00100001,25,00011001,58,00111010
118,01110110,74,01001010,192,11000000
103,01100111,72,01001000,175,10101111
81,01010001,89,01011001,170,10101010
7,00000111,51,00110011,58,00111010
29,00011101,39,00100111,68,01000100
41,00101001,20,00010100,61,00111101
33,00100001,113,01110001,146,10010010
120,01111000,124,01111100,244,11110100
10,00001010,76,01001100,86,01010110
47,00101111,2,00000010,49,00110001
96,01100000,88,01011000,184,10111000
53,00110101,69,01000101,122,01111010
19,00010011,0,00000000,19,00010011
17,00010001,87,01010111,104,01101000
110,01101110,84,01010100,194,11000010
58,00111010,100,01100100,158,10011110
36,00100100,12,00001100,48,00110000
44,00101100,100,01100100,144,10010000
79,01001111,37,00100101,116,01110100
118,01110110,24,00011000,142,10001110
45,00101101,52,00110100,97,01100001
84,01010100,122,01111010,206,11001110
60,00111100,7,00000111,67,01000011
110,01101110,23,00010111,133,10000101
20,00010100,69,01000101,89,01011001
7,00000111,36,00100100,43,00101011
111,01101111,9,00001001,120,01111000
69,01000101,25,00011001,94,01011110
33,00100001,84,01010100,117,01110101
64,01000000,33,00100001,97,01100001
83,01010011,73,01001001,156,10011100
2,00000010,16,00010000,18,00010010
126,01111110,87,01010111,213,11010101
61,00111101,58,00111010,119,01110111
114,01110010,25,00011001,139,10001011
122,01111010,42,00101010,164,10100100
80,01010000,17,00010001,97,01100001
40,00101000,60,00111100,100,01100100
81,01010001,122,01111010,203,11001011
125,01111101,113,01110001,238,11101110
101,01100101,41,00101001,142,10001110
38,00100110,76,01001100,114,01110010
70,01000110,111,01101111,181,10110101
24,00011000,33,00100001,57,00111001
78,01001110,69,01000101,147,10010011
9,00001001,37,00100101,46,00101110
102,01100110,11,00001011,113,01110001
25,00011001,16,00010000,41,00101001
83,01010011,61,00111101,144,10010000
122,01111010,23,00010111,145,10010001
50,00110010,121,01111001,171,10101011
112,01110000,9,00001001,121,01111001
42,00101010,41,00101001,83,01010011
105,01101001,103,01100111,208,11010000
26,00011010,119,01110111,145,10010001
118,01110110,42,00101010,160,10100000
62,00111110,11,00001011,73,01001001
71,01000111,91,01011011,162,10100010
32,00100000,125,01111101,157,10011101
30,00011110,86,01010110,116,01110100
29,00011101,32,00100000,61,00111101
66,01000010,22,00010110,88,01011000
47,00101111,40,00101000,87,01010111
111,01101111,24,00011000,135,10000111
118,01110110,115,01110011,233,11101001
14,00001110,2,00000010,16,00010000
67,01000011,33,00100001,100,01100100
42,00101010,36,00100100,78,01001110
0,00000000,24,00011000,24,00011000
50,00110010,38,00100110,88,01011000
55,00110111,12,00001100,67,01000011
125,01111101,15,00001111,140,10001100
26,00011010,23,00010111,49,00110001
56,00111000,93,01011101,149,10010101
16,00010000,82,01010010,98,01100010
45,00101101,33,00100001,78,01001110
118,01110110,3,00000011,121,01111001
58,00111010,102,01100110,160,10100000
71,01000111,57,00111001,128,10000000
20,00010100,112,01110000,132,10000100
88,01011000,66,01000010,154,10011010
126,01111110,60,00111100,186,10111010
10,00001010,51,00110011,61,00111101
98,01100010,88,01011000,186,10111010
0,00000000,70,01000110,70,01000110
13,00001101,102,01100110,115,01110011
25,00011001,91,01011011,116,01110100
47,00101111,69,01000101,116,01110100
109,01101101,125,01111101,234,11101010
105,01101001,23,00010111,128,10000000
51,00110011,54,00110110,105,01101001
24,00011000,77,01001101,101,01100101
21,00010101,13,00001101,34,00100010
66,01000010,120,01111000,186,10111010
41,00101001,1,00000001,42,00101010
58,00111010,109,01101101,167,10100111
52,00110100,0,00000000,52,00110100
57,00111001,126,01111110,183,10110111
124,01111100,14,00001110,138,10001010
100,01100100,7,00000111,107,01101011
48,00110000,73,01001001,121,01111001
108,01101100,49,00110001,157,10011101
4,00000100,16,00010000,20,00010100
16,00010000,121,01111001,137,10001001
63,00111111,16,00010000,79,01001111
67,01000011,104,01101000,171,10101011
54,00110110,2,00000010,56,00111000
32,00100000,57,00111001,89,01011001
70,01000110,85,01010101,155,10011011
28,00011100,22,00010110,50,00110010
27,00011011,121,01111001,148,10010100
49,00110001,126,01111110,175,10101111
4,00000100,4,00000100,8,00001000
95,01011111,66,01000010,161,10100001
89,01011001,94,01011110,183,10110111
75,01001011,74,01001010,149,10010101
66,01000010,75,01001011,141,10001101
76,01001100,84,01010100,160,10100000
9,00001001,122,01111010,131,10000011
35,00100011,51,00110011,86,01010110
6,00000110,126,01111110,132,10000100
31,00011111,27,00011011,58,00111010
10,00001010,48,00110000,58,00111010
72,01001000,89,01011001,161,10100001
101,01100101,79,01001111,180,10110100
26,00011010,69,01000101,95,01011111
82,01010010,64,01000000,146,10010010
36,00100100,32,00100000,68,01000100
37,00100101,82,01010010,119,01110111
77,01001101,83,01010011,160,10100000
66,01000010,111,01101111,177,10110001
121,01111001,40,00101000,161,10100001
105,01101001,0,00000000,105,01101001
38,00100110,64,01000000,102,01100110
9,00001001,62,00111110,71,01000111
49,00110001,3,00000011,52,00110100
5,00000101,81,01010001,86,01010110
124,01111100,18,00010010,142,10001110
45,00101101,75,01001011,120,01111000
64,01000000,117,01110101,181,10110101
38,00100110,108,01101100,146,10010010
41,00101001,17,00010001,58,00111010
44,00101100,18,00010010,62,00111110
63,00111111,6,00000110,69,01000101
79,01001111,54,00110110,133,10000101
60,00111100,39,00100111,99,01100011
0,00000000,37,00100101,37,00100101
36,00100100,7,00000111,43,00101011
45,00101101,127,01111111,172,10101100
11,00001011,4,00000100,15,00001111
70,01000110,38,00100110,108,01101100
124,01111100,40,00101000,164,10100100
62,00111110,70,01000110,132,10000100
80,01010000,34,00100010,114,01110010
80,01010000,96,01100000,176,10110000
120,01111000,28,00011100,148,10010100
100,01100100,32,00100000,132,10000100
49,00110001,112,01110000,161,10100001
8,00001000,21,00010101,29,00011101
50,00110010,24,00011000,74,01001010
16,00010000,85,01010101,101,01100101
10,00001010,32,00100000,42,00101010
8,00001000,59,00111011,67,01000011
101,01100101,70,01000110,171,10101011
90,01011010,106,01101010,196,11000100
91,01011011,122,01111010,213,11010101
45,00101101,89,01011001,134,10000110
20,00010100,84,01010100,104,01101000
77,01001101,34,00100010,111,01101111
4,00000100,48,00110000,52,00110100
78,01001110,24,00011000,102,01100110
65,01000001,103,01100111,168,10101000
43,00101011,77,01001101,120,01111000
100,01100100,97,01100001,197,11000101
76,01001100,16,00010000,92,01011100
57,00111001,5,00000101,62,00111110
97,01100001,123,01111011,220,11011100
95,01011111,8,00001000,103,01100111
33,00100001,54,00110110,87,01010111
64,01000000,32,00100000,96,01100000
95,01011111,2,00000010,97,01100001
106,01101010,27,00011011,133,10000101
80,01010000,87,01010111,167,10100111
66,01000010,71,01000111,137,10001001
101,01100101,45,00101101,146,10010010
20,00010100,64,01000000,84,01010100
7,00000111,89,01011001,96,01100000
24,00011000,65,01000001,89,01011001
99,01100011,62,00111110,161,10100001
94,01011110,34,00100010,128,10000000
92,01011100,98,01100010,190,10111110
21,00010101,87,01010111,108,01101100
17,00010001,69,01000101,86,01010110
127,01111111,3,00000011,130,10000010
89,01011001,21,00010101,110,01101110
59,00111011,6,00000110,65,01000001
61,00111101,83,01010011,144,10010000
22,00010110,23,00010111,45,00101101
85,01010101,76,01001100,161,10100001
22,00010110,60,00111100,82,01010010
10,00001010,78,01001110,88,01011000
108,01101100,57,00111001,165,10100101
41,00101001,69,01000101,110,01101110
39,00100111,117,01110101,156,10011100
115,01110011,74,01001010,189,10111101
61,00111101,90,01011010,151,10010111
26,00011010,83,01010011,109,01101101
46,00101110,116,01110100,162,10100010
16,00010000,1,00000001,17,00010001
83,01010011,78,01001110,161,10100001
9,00001001,63,00111111,72,01001000
108,01101100,63,00111111,171,10101011
60,00111100,35,00100011,95,01011111
99,01100011,8,00001000,107,01101011
90,01011010,56,00111000,146,10010010
115,01110011,104,01101000,219,11011011
45,00101101,77,01001101,122,01111010
61,00111101,89,01011001,150,10010110
44,00101100,52,00110100,96,01100000
14,00001110,112,01110000,126,01111110
13,00001101,58,00111010,71,01000111
6,00000110,107,01101011,113,01110001
124,01111100,72,01001000,196,11000100
102,01100110,51,00110011,153,10011001
14,00001110,110,01101110,124,01111100
28,00011100,29,00011101,57,00111001
95,01011111,94,01011110,189,10111101
8,00001000,107,01101011,115,01110011
66,01000010,56,00111000,122,01111010
79,01001111,56,00111000,135,10000111
56,00111000,92,01011100,148,10010100
98,01100010,37,00100101,135,10000111
42,00101010,102,01100110,144,10010000
101,01100101,88,01011000,189,10111101
5,00000101,14,00001110,19,00010011
56,00111000,98,01100010,154,10011010
11,00001011,16,00010000,27,00011011
31,00011111,114,01110010,145,10010001
76,01001100,58,00111010,134,10000110
59,00111011,64,01000000,123,01111011
61,00111101,98,01100010,159,10011111
121,01111001,64,01000000,185,10111001
120,01111000,57,00111001,177,10110001
16,00010000,127,01111111,143,10001111
4,00000100,100,01100100,104,01101000
3,00000011,5,00000101,8,00001000
94,01011110,123,01111011,217,11011001
50,00110010,127,01111111,177,10110001
42,00101010,84,01010100,126,01111110
48,00110000,45,00101101,93,01011101
15,00001111,101,01100101,116,01110100
105,01101001,117,01110101,222,11011110
92,01011100,91,01011011,183,10110111
55,00110111,59,00111011,114,01110010
123,01111011,109,01101101,232,11101000
55,00110111,125,01111101,180,10110100
33,00100001,11,00001011,44,00101100
127,01111111,91,01011011,218,11011010
34,00100010,88,01011000,122,01111010
13,00001101,7,00000111,20,00010100
24,00011000,65,01000001,89,01011001
99,01100011,82,01010010,181,10110101
110,01101110,40,00101000,150,10010110
55,00110111,65,01000001,120,01111000
106,01101010,27,00011011,133,10000101
15,00001111,15,00001111,30,00011110
41,00101001,77,01001101,118,01110110
6,00000110,126,01111110,132,10000100
122,01111010,96,01100000,218,11011010
92,01011100,56,00111000,148,10010100
52,00110100,6,00000110,58,00111010
78,01001110,31,00011111,109,01101101
6,00000110,33,00100001,39,00100111
127,01111111,58,00111010,185,10111001
122,01111010,126,01111110,248,11111000
46,00101110,127,01111111,173,10101101
26,00011010,51,00110011,77,01001101
32,00100000,60,00111100,92,01011100
123,01111011,46,00101110,169,10101001
95,01011111,7,00000111,102,01100110
49,00110001,39,00100111,88,01011000
65,01000001,5,00000101,70,01000110
101,01100101,27,00011011,128,10000000
38,00100110,45,00101101,83,01010011
23,00010111,12,00001100,35,00100011
9,00001001,29,00011101,38,00100110
29,00011101,13,00001101,42,00101010
87,01010111,24,00011000,111,01101111
9,00001001,68,01000100,77,01001101
37,00100101,56,00111000,93,01011101
75,01001011,86,01010110,161,10100001
60,00111100,24,00011000,84,01010100
101,01100101,104,01101000,205,11001101
104,01101000,52,00110100,156,10011100
53,00110101,98,01100010,151,10010111
46,00101110,33,00100001,79,01001111
122,01111010,13,00001101,135,10000111
97,01100001,71,01000111,168,10101000
12,00001100,73,01001001,85,01010101
46,00101110,29,00011101,75,01001011
12,00001100,55,00110111,67,01000011
48,00110000,118,01110110,166,10100110
35,00100011,34,00100010,69,01000101
58,00111010,60,00111100,118,01110110
1,00000001,17,00010001,18,00010010
43,00101011,112,01110000,155,10011011
55,00110111,9,00001001,64,01000000
55,00110111,121,01111001,176,10110000
125,01111101,16,00010000,141,10001101
67,01000011,41,00101001,108,01101100
86,01010110,47,00101111,133,10000101
84,01010100,88,01011000,172,10101100
97,01100001,123,01111011,220,11011100
58,00111010,84,01010100,142,10001110
85,01010101,36,00100100,121,01111001
108,01101100,12,00001100,120,01111000
26,00011010,2,00000010,28,00011100
122,01111010,122,01111010,244,11110100
22,00010110,46,00101110,68,01000100
83,01010011,121,01111001,204,11001100
18,00010010,34,00100010,52,00110100
95,01011111,67,01000011,162,10100010
0,00000000,27,00011011,27,00011011
48,00110000,110,01101110,158,10011110
86,01010110,116,01110100,202,11001010
3,00000011,124,01111100,127,01111111
96,01100000,11,00001011,107,01101011
112,01110000,88,01011000,200,11001000
28,00011100,40,00101000,68,01000100
73,01001001,2,00000010,75,01001011
78,01001110,59,00111011,137,10001001
116,01110100,10,00001010,126,01111110
4,00000100,73,01001001,77,01001101
109,01101101,127,01111111,236,11101100
90,01011010,107,01101011,197,11000101
125,01111101,8,00001000,133,10000101
37,00100101,104,01101000,141,10001101
98,01100010,108,01101100,206,11001110
118,01110110,102,01100110,220,11011100
91,01011011,112,01110000,203,11001011
58,00111010,58,00111010,116,01110100
49,00110001,117,01110101,166,10100110
19,00010011,35,00100011,54,00110110
36,00100100,124,01111100,160,10100000
74,01001010,49,00110001,123,01111011
18,00010010,4,00000100,22,00010110
88,01011000,79,01001111,167,10100111
49,00110001,94,01011110,143,10001111
13,00001101,51,00110011,64,01000000
16,00010000,55,00110111,71,01000111
104,01101000,109,01101101,213,11010101
75,01001011,61,00111101,136,10001000
98,01100010,17,00010001,115,01110011
70,01000110,24,00011000,94,01011110
93,01011101,93,01011101,186,10111010
66,01000010,75,01001011,141,10001101
122,01111010,46,00101110,168,10101000
40,00101000,81,01010001,121,01111001
39,00100111,127,01111111,166,10100110
9,00001001,107,01101011,116,01110100
26,00011010,20,00010100,46,00101110
57,00111001,68,01000100,125,01111101
106,01101010,66,01000010,172,10101100
52,00110100,39,00100111,91,01011011
83,01010011,63,00111111,146,10010010
116,01110100,7,00000111,123,01111011
31,00011111,96,01100000,127,01111111
68,01000100,116,01110100,184,10111000
27,00011011,24,00011000,51,00110011
106,01101010,55,00110111,161,10100001
8,00001000,44,00101100,52,00110100
53,00110101,90,01011010,143,10001111
38,00100110,27,00011011,65,01000001
98,01100010,43,00101011,141,10001101
76,01001100,111,01101111,187,10111011
8,00001000,40,00101000,48,00110000
120,01111000,109,01101101,229,11100101
32,00100000,64,01000000,96,01100000
111,01101111,81,01010001,192,11000000
76,01001100,16,00010000,92,01011100
117,01110101,120,01111000,237,11101101
75,01001011,79,01001111,154,10011010
92,01011100,51,00110011,143,10001111
64,01000000,110,01101110,174,10101110
92,01011100,36,00100100,128,10000000
60,00111100,18,00010010,78,01001110
81,01010001,25,00011001,106,01101010
40,00101000,25,00011001,65,01000001
4,00000100,10,00001010,14,00001110
97,01100001,86,01010110,183,10110111
97,01100001,110,01101110,207,11001111
82,01010010,35,00100011,117,01110101
112,01110000,84,01010100,196,11000100
5,00000101,58,00111010,63,00111111
99,01100011,47,00101111,146,10010010
77,01001101,104,01101000,181,10110101
103,01100111,30,00011110,133,10000101
11,00001011,8,00001000,19,00010011
121,01111001,26,00011010,147,10010011
104,01101000,95,01011111,199,11000111
90,01011010,50,00110010,140,10001100
101,01100101,19,00010011,120,01111000
55,00110111,124,01111100,179,10110011
31,00011111,70,01000110,101,01100101
51,00110011,37,00100101,88,01011000
11,00001011,79,01001111,90,01011010
44,00101100,53,00110101,97,01100001
4,00000100,99,01100011,103,01100111
114,01110010,17,00010001,131,10000011
108,01101100,25,00011001,133,10000101
54,00110110,122,01111010,176,10110000
76,01001100,0,00000000,76,01001100
96,01100000,70,01000110,166,10100110
99,01100011,41,00101001,140,10001100
104,01101000,83,01010011,187,10111011
123,01111011,99,01100011,222,11011110
93,01011101,106,01101010,199,11000111
87,01010111,25,00011001,112,01110000
84,01010100,123,01111011,207,11001111
44,00101100,72,01001000,116,01110100
38,00100110,86,01010110,124,01111100
103,01100111,50,00110010,153,10011001
117,01110101,15,00001111,132,10000100
127,01111111,4,00000100,131,10000011
75,01001011,26,00011010,101,01100101
75,01001011,26,00011010,101,01100101
76,01001100,28,00011100,104,01101000
0,00000000,69,01000101,69,01000101
57,00111001,102,01100110,159,10011111
13,00001101,22,00010110,35,00100011
123,01111011,123,01111011,246,11110110
88,01011000,61,00111101,149,10010101
90,01011010,62,00111110,152,10011000
5,00000101,82,01010010,87,01010111
44,00101100,110,01101110,154,10011010
92,01011100,67,01000011,159,10011111
23,00010111,9,00001001,32,00100000
51,00110011,5,00000101,56,00111000
90,01011010,33,00100001,123,01111011
1,00000001,63,00111111,64,01000000
96,01100000,84,01010100,180,10110100
121,01111001,61,00111101,182,10110110
111,01101111,91,01011011,202,11001010
106,01101010,76,01001100,182,10110110
31,00011111,109,01101101,140,10001100
91,01011011,58,00111010,149,10010101
3,00000011,115,01110011,118,01110110
84,01010100,10,00001010,94,01011110
51,00110011,73,01001001,124,01111100
69,01000101,13,00001101,82,01010010
60,00111100,104,01101000,164,10100100
81,01010001,58,00111010,139,10001011
45,00101101,25,00011001,70,01000110
3,00000011,64,01000000,67,01000011
118,01110110,78,01001110,196,11000100
116,01110100,14,00001110,130,10000010
87,01010111,70,01000110,157,10011101
15,00001111,5,00000101,20,00010100
54,00110110,0,00000000,54,00110110
103,01100111,71,01000111,174,10101110
61,00111101,81,01010001,142,10001110
32,00100000,58,00111010,90,01011010
29,00011101,31,00011111,60,00111100
79,01001111,75,01001011,154,10011010
107,01101011,31,00011111,138,10001010
18,00010010,107,01101011,125,01111101
102,01100110,86,01010110,188,10111100
71,01000111,116,01110100,187,10111011
99,01100011,62,00111110,161,10100001
19,00010011,69,01000101,88,01011000
49,00110001,64,01000000,113,01110001
107,01101011,1,00000001,108,01101100
50,00110010,53,00110101,103,01100111
60,00111100,58,00111010,118,01110110
78,01001110,116,01110100,194,11000010
57,00111001,18,00010010,75,01001011
41,00101001,6,00000110,47,00101111
100,01100100,43,00101011,143,10001111
113,01110001,32,00100000,145,10010001
75,01001011,87,01010111,162,10100010
123,01111011,24,00011000,147,10010011
50,00110010,8,00001000,58,00111010
117,01110101,83,01010011,200,11001000
2,00000010,114,01110010,116,01110100
28,00011100,38,00100110,66,01000010
120,01111000,46,00101110,166,10100110
43,00101011,97,01100001,140,10001100
116,01110100,13,00001101,129,10000001
45,00101101,33,00100001,78,01001110
10,00001010,115,01110011,125,01111101
87,01010111,125,01111101,212,11010100
77,01001101,115,01110011,192,11000000
110,01101110,30,00011110,140,10001100
64,01000000,107,01101011,171,10101011
71,01000111,67,01000011,138,10001010
126,01111110,110,01101110,236,11101100
0,00000000,95,01011111,95,01011111
8,00001000,67,01000011,75,01001011
11,00001011,23,00010111,34,00100010
20,00010100,1,00000001,21,00010101
70,01000110,110,01101110,180,10110100
124,01111100,68,01000100,192,11000000
42,00101010,99,01100011,141,10001101
124,01111100,111,01101111,235,11101011
22,00010110,30,00011110,52,00110100
38,00100110,75,01001011,113,01110001
52,00110100,98,01100010,150,10010110
119,01110111,67,01000011,186,10111010
113,01110001,106,01101010,219,11011011
64,01000000,6,00000110,70,01000110
33,00100001,126,01111110,159,10011111
29,00011101,85,01010101,114,01110010
14,00001110,52,00110100,66,01000010
86,01010110,91,01011011,177,10110001
67,01000011,113,01110001,180,10110100
127,01111111,94,01011110,221,11011101
103,01100111,46,00101110,149,10010101
87,01010111,24,00011000,111,01101111
107,01101011,13,00001101,120,01111000
32,00100000,32,00100000,64,01000000
114,01110010,118,01110110,232,11101000
113,01110001,25,00011001,138,10001010
73,01001001,101,01100101,174,10101110
108,01101100,17,00010001,125,01111101
23,00010111,35,00100011,58,00111010
123,01111011,121,01111001,244,11110100
35,00100011,34,00100010,69,01000101
84,01010100,69,01000101,153,10011001
20,00010100,6,00000110,26,00011010
8,00001000,0,00000000,8,00001000
61,00111101,108,01101100,169,10101001
89,01011001,102,01100110,191,10111111
71,01000111,73,01001001,144,10010000
122,01111010,6,00000110,128,10000000
93,01011101,69,01000101,162,10100010
36,00100100,29,00011101,65,01000001
103,01100111,19,00010011,122,01111010
47,00101111,22,00010110,69,01000101
67,01000011,7,00000111,74,01001010
56,00111000,93,01011101,149,10010101
84,01010100,72,01001000,156,10011100
18,00010010,22,00010110,40,00101000
22,00010110,85,01010101,107,01101011
46,00101110,39,00100111,85,01010101
56,00111000,34,00100010,90,01011010
60,00111100,98,01100010,158,10011110
127,01111111,80,01010000,207,11001111
13,00001101,28,00011100,41,00101001
120,01111000,59,00111011,179,10110011
13,00001101,33,00100001,46,00101110
122,01111010,26,00011010,148,10010100
77,01001101,57,00111001,134,10000110
125,01111101,74,01001010,199,11000111
122,01111010,87,01010111,209,11010001
85,01010101,91,01011011,176,10110000
109,01101101,55,00110111,164,10100100
124,01111100,85,01010101,209,11010001
95,01011111,102,01100110,197,11000101
82,01010010,91,01011011,173,10101101
125,01111101,90,01011010,215,11010111
23,00010111,71,01000111,94,01011110
13,00001101,20,00010100,33,00100001
94,01011110,35,00100011,129,10000001
74,01001010,35,00100011,109,01101101
69,01000101,37,00100101,106,01101010
22,00010110,33,00100001,55,00110111
18,00010010,0,00000000,18,00010010
31,00011111,108,01101100,139,10001011
30,00011110,45,00101101,75,01001011
2,00000010,21,00010101,23,00010111
18,00010010,80,01010000,98,01100010
99,01100011,127,01111111,226,11100010
12,00001100,72,01001000,84,01010100
124,01111100,90,01011010,214,11010110
60,00111100,99,01100011,159,10011111
9,00001001,31,00011111,40,00101000
108,01101100,49,00110001,157,10011101
63,00111111,107,01101011,170,10101010
47,00101111,0,00000000,47,00101111
45,00101101,124,01111100,169,10101001
54,00110110,84,01010100,138,10001010
92,01011100,38,00100110,130,10000010
36,00100100,30,00011110,66,01000010
33,00100001,99,01100011,132,10000100
105,01101001,118,01110110,223,11011111
126,01111110,26,00011010,152,10011000
46,00101110,18,00010010,64,01000000
88,01011000,88,01011000,176,10110000
78,01001110,92,01011100,170,10101010
114,01110010,41,00101001,155,10011011
19,00010011,2,00000010,21,00010101
42,00101010,49,00110001,91,01011011
122,01111010,29,00011101,151,10010111
65,01000001,21,00010101,86,01010110
118,01110110,81,01010001,199,11000111
119,01110111,89,01011001,208,11010000
78,01001110,121,01111001,199,11000111
86,01010110,79,01001111,165,10100101
114,01110010,82,01010010,196,11000100
127,01111111,11,00001011,138,10001010
54,00110110,24,00011000,78,01001110
69,01000101,107,01101011,176,10110000
6,00000110,61,00111101,67,01000011
41,00101001,60,00111100,101,01100101
107,01101011,47,00101111,154,10011010
12,00001100,12,00001100,24,00011000
45,00101101,37,00100101,82,01010010
82,01010010,73,01001001,155,10011011
72,01001000,53,00110101,125,01111101
40,00101000,8,00001000,48,00110000
0,00000000,32,00100000,32,00100000
12,00001100,116,01110100,128,10000000
20,00010100,121,01111001,141,10001101
123,01111011,117,01110101,240,11110000
114,01110010,15,00001111,129,10000001
23,00010111,62,00111110,85,01010101
54,00110110,108,01101100,162,10100010
81,01010001,87,01010111,168,10101000
9,00001001,109,01101101,118,01110110
98,01100010,96,01100000,194,11000010
105,01101001,70,01000110,175,10101111
119,01110111,91,01011011,210,11010010
35,00100011,83,01010011,118,01110110
38,00100110,65,01000001,103,01100111
33,00100001,101,01100101,134,10000110
97,01100001,33,00100001,130,10000010
3,00000011,86,01010110,89,01011001
101,01100101,122,01111010,223,11011111
50,00110010,33,00100001,83,01010011
3,00000011,77,01001101,80,01010000
34,00100010,79,01001111,113,01110001
43,00101011,97,01100001,140,10001100
30,00011110,41,00101001,71,01000111
28,00011100,9,00001001,37,00100101
11,00001011,25,00011001,36,00100100
112,01110000,124,01111100,236,11101100
57,00111001,73,01001001,130,10000010
124,01111100,62,00111110,186,10111010
96,01100000,21,00010101,117,01110101
100,01100100,75,01001011,175,10101111
35,00100011,56,00111000,91,01011011
121,01111001,44,00101100,165,10100101
66,01000010,96,01100000,162,10100010
92,01011100,100,01100100,192,11000000
120,01111000,74,01001010,194,11000010
99,01100011,29,00011101,128,10000000
61,00111101,107,01101011,168,10101000
41,00101001,87,01010111,128,10000000
37,00100101,63,00111111,100,01100100
29,00011101,97,01100001,126,01111110
125,01111101,35,00100011,160,10100000
106,01101010,80,01010000,186,10111010
84,01010100,33,00100001,117,01110101
3,00000011,95,01011111,98,01100010
109,01101101,100,01100100,209,11010001
72,01001000,88,01011000,160,10100000
62,00111110,25,00011001,87,01010111
89,01011001,37,00100101,126,01111110
74,01001010,96,01100000,170,10101010
67,01000011,127,01111111,194,11000010
63,00111111,85,01010101,148,10010100
104,01101000,77,01001101,181,10110101
96,01100000,106,01101010,202,11001010
5,00000101,21,00010101,26,00011010
40,00101000,13,00001101,53,00110101
27,00011011,34,00100010,61,00111101
0,00000000,55,00110111,55,00110111
121,01111001,44,00101100,165,10100101
103,01100111,48,00110000,151,10010111
111,01101111,51,00110011,162,10100010
59,00111011,17,00010001,76,01001100
96,01100000,120,01111000,216,11011000
96,01100000,11,00001011,107,01101011
42,00101010,70,01000110,112,01110000
82,01010010,33,00100001,115,01110011
51,00110011,52,00110100,103,01100111
69,01000101,81,01010001,150,10010110
54,00110110,10,00001010,64,01000000
76,01001100,41,00101001,117,01110101
81,01010001,31,00011111,112,01110000
3,00000011,104,01101000,107,01101011
98,01100010,42,00101010,140,10001100
94,01011110,6,00000110,100,01100100
64,01000000,4,00000100,68,01000100
4,00000100,63,00111111,67,01000011
108,01101100,64,01000000,172,10101100
115,01110011,99,01100011,214,11010110
86,01010110,94,01011110,180,10110100
103,01100111,29,00011101,132,10000100
22,00010110,87,01010111,109,01101101
49,00110001,26,00011010,75,01001011
118,01110110,56,00111000,174,10101110
11,00001011,2,00000010,13,00001101
85,01010101,12,00001100,97,01100001
80,01010000,2,00000010,82,01010010
91,01011011,76,01001100,167,10100111
117,01110101,121,01111001,238,11101110
121,01111001,105,01101001,226,11100010
35,00100011,0,00000000,35,00100011
61,00111101,77,01001101,138,10001010
127,01111111,101,01100101,228,11100100
18,00010010,35,00100011,53,00110101
10,00001010,19,00010011,29,00011101
108,01101100,27,00011011,135,10000111
9,00001001,112,01110000,121,01111001
38,00100110,122,01111010,160,10100000
12,00001100,111,01101111,123,01111011
102,01100110,113,01110001,215,11010111
102,01100110,69,01000101,171,10101011
86,01010110,62,00111110,148,10010100
12,00001100,66,01000010,78,01001110
59,00111011,0,00000000,59,00111011
113,01110001,24,00011000,137,10001001
106,01101010,93,01011101,199,11000111
92,01011100,96,01100000,188,10111100
4,00000100,72,01001000,76,01001100
18,00010010,45,00101101,63,00111111
92,01011100,71,01000111,163,10100011
72,01001000,16,00010000,88,01011000
86,01010110,106,01101010,192,11000000
79,01001111,127,01111111,206,11001110
20,00010100,48,00110000,68,01000100
85,01010101,87,01010111,172,10101100
97,01100001,66,01000010,163,10100011
48,00110000,90,01011010,138,10001010
11,00001011,24,00011000,35,00100011
15,00001111,111,01101111,126,01111110
25,00011001,127,01111111,152,10011000
5,00000101,22,00010110,27,00011011
54,00110110,51,00110011,105,01101001
34,00100010,29,00011101,63,00111111
12,00001100,44,00101100,56,00111000
58,00111010,124,01111100,182,10110110
20,00010100,63,00111111,83,01010011
46,00101110,97,01100001,143,10001111
75,01001011,46,00101110,121,01111001
94,01011110,110,01101110,204,11001100
120,01111000,11,00001011,131,10000011
70,01000110,95,01011111,165,10100101
34,00100010,41,00101001,75,01001011
21,00010101,74,01001010,95,01011111
91,01011011,81,01010001,172,10101100
102,01100110,57,00111001,159,10011111
6,00000110,11,00001011,17,00010001
61,00111101,112,01110000,173,10101101
93,01011101,77,01001101,170,10101010
110,01101110,19,00010011,129,10000001
121,01111001,7,00000111,128,10000000
57,00111001,16,00010000,73,01001001
70,01000110,40,00101000,110,01101110
79,01001111,62,00111110,141,10001101
66,01000010,10,00001010,76,01001100
41,00101001,42,00101010,83,01010011
40,00101000,29,00011101,69,01000101
74,01001010,74,01001010,148,10010100
31,00011111,81,01010001,112,01110000
123,01111011,99,01100011,222,11011110
36,00100100,100,01100100,136,10001000
61,00111101,81,01010001,142,10001110
113,01110001,85,01010101,198,11000110
27,00011011,25,00011001,52,00110100
47,00101111,54,00110110,101,01100101
72,01001000,97,01100001,169,10101001
122,01111010,111,01101111,233,11101001
73,01001001,11,00001011,84,01010100
48,00110000,111,01101111,159,10011111
92,01011100,16,00010000,108,01101100
112,01110000,66,01000010,178,10110010
72,01001000,33,00100001,105,01101001
123,01111011,48,00110000,171,10101011
14,00001110,40,00101000,54,00110110
65,01000001,46,00101110,111,01101111
95,01011111,22,00010110,117,01110101
109,01101101,64,01000000,173,10101101
76,01001100,40,00101000,116,01110100
120,01111000,127,01111111,247,11110111
64,01000000,92,01011100,156,10011100
31,00011111,60,00111100,91,01011011
126,01111110,28,00011100,154,10011010
124,01111100,120,01111000,244,11110100
57,00111001,83,01010011,140,10001100
115,01110011,96,01100000,211,11010011
106,01101010,43,00101011,149,10010101
119,01110111,68,01000100,187,10111011
114,01110010,81,01010001,195,11000011
93,01011101,102,01100110,195,11000011
26,00011010,89,01011001,115,01110011
82,01010010,51,00110011,133,10000101
84,01010100,47,00101111,131,10000011
57,00111001,41,00101001,98,01100010
71,01000111,98,01100010,169,10101001
28,00011100,32,00100000,60,00111100
113,01110001,102,01100110,215,11010111
12,00001100,88,01011000,100,01100100
110,01101110,110,01101110,220,11011100
71,01000111,73,01001001,144,10010000
60,00111100,39,00100111,99,01100011
45,00101101,33,00100001,78,01001110
94,01011110,99,01100011,193,11000001
60,00111100,34,00100010,94,01011110
103,01100111,66,01000010,169,10101001
29,00011101,120,01111000,149,10010101
39,00100111,63,00111111,102,01100110
22,00010110,99,01100011,121,01111001
53,00110101,64,01000000,117,01110101
26,00011010,68,01000100,94,01011110
117,01110101,43,00101011,160,10100000
47,00101111,9,00001001,56,00111000
70,01000110,29,00011101,99,01100011
5,00000101,1,00000001,6,00000110
124,01111100,86,01010110,210,11010010
26,00011010,93,01011101,119,01110111
5,00000101,16,00010000,21,00010101
26,00011010,44,00101100,70,01000110
26,00011010,78,01001110,104,01101000
88,01011000,8,00001000,96,01100000
19,00010011,93,01011101,112,01110000
119,01110111,59,00111011,178,10110010
75,01001011,46,00101110,121,01111001
21,00010101,66,01000010,87,01010111
61,00111101,57,00111001,118,01110110
26,00011010,53,00110101,79,01001111
112,01110000,107,01101011,219,11011011
68,01000100,121,01111001,189,10111101
22,00010110,82,01010010,104,01101000
38,00100110,65,01000001,103,01100111
4,00000100,125,01111101,129,10000001
103,01100111,19,00010011,122,01111010
91,01011011,7,00000111,98,01100010
112,01110000,117,01110101,229,11100101
93,01011101,98,01100010,191,10111111
88,01011000,57,00111001,145,10010001
76,01001100,69,01000101,145,10010001
44,00101100,13,00001101,57,00111001
112,01110000,38,00100110,150,10010110
79,01001111,0,00000000,79,01001111
113,01110001,51,00110011,164,10100100
68,01000100,45,00101101,113,01110001
22,00010110,30,00011110,52,00110100
125,01111101,32,00100000,157,10011101
119,01110111,95,01011111,214,11010110
45,00101101,100,01100100,145,10010001
3,00000011,60,00111100,63,00111111
35,00100011,19,00010011,54,00110110
98,01100010,17,00010001,115,01110011
108,01101100,3,00000011,111,01101111
60,00111100,72,01001000,132,10000100
65,01000001,15,00001111,80,01010000
105,01101001,8,00001000,113,01110001
120,01111000,52,00110100,172,10101100
22,00010110,10,00001010,32,00100000
44,00101100,12,00001100,56,00111000
3,00000011,22,00010110,25,00011001
12,00001100,25,00011001,37,00100101
53,00110101,90,01011010,143,10001111
40,00101000,41,00101001,81,01010001
0,00000000,55,00110111,55,00110111
59,00111011,102,01100110,161,10100001
52,00110100,27,00011011,79,01001111
40,00101000,100,01100100,140,10001100
85,01010101,21,00010101,106,01101010
70,01000110,76,01001100,146,10010010
7,00000111,3,00000011,10,00001010
120,01111000,74,01001010,194,11000010
27,00011011,57,00111001,84,01010100
113,01110001,113,01110001,226,11100010
88,01011000,49,00110001,137,10001001
46,00101110,73,01001001,119,01110111
108,01101100,108,01101100,216,11011000
36,00100100,8,00001000,44,00101100
9,00001001,99,01100011,108,01101100
1,00000001,38,00100110,39,00100111
20,00010100,45,00101101,65,01000001
89,01011001,44,00101100,133,10000101
89,01011001,69,01000101,158,10011110
64,01000000,126,01111110,190,10111110
103,01100111,58,00111010,161,10100001
70,01000110,70,01000110,140,10001100
103,01100111,114,01110010,217,11011001
17,00010001,11,00001011,28,00011100
17,00010001,37,00100101,54,00110110
94,01011110,57,00111001,151,10010111
114,01110010,113,01110001,227,11100011
73,01001001,12,00001100,85,01010101
17,00010001,126,01111110,143,10001111
36,00100100,32,00100000,68,01000100
127,01111111,3,00000011,130,10000010
121,01111001,118,01110110,239,11101111
76,01001100,117,01110101,193,11000001
111,01101111,37,00100101,148,10010100
116,01110100,71,01000111,187,10111011
110,01101110,61,00111101,171,10101011
5,00000101,17,00010001,22,00010110
18,00010010,18,00010010,36,00100100
81,01010001,33,00100001,114,01110010
10,00001010,49,00110001,59,00111011
9,00001001,26,00011010,35,00100011
4,00000100,104,01101000,108,01101100
89,01011001,114,01110010,203,11001011
101,01100101,71,01000111,172,10101100
97,01100001,17,00010001,114,01110010
124,01111100,111,01101111,235,11101011
103,01100111,112,01110000,215,11010111
17,00010001,102,01100110,119,01110111
72,01001000,102,01100110,174,10101110
58,00111010,87,01010111,145,10010001
55,00110111,34,00100010,89,01011001
101,01100101,91,01011011,192,11000000
68,01000100,2,00000010,70,01000110
109,01101101,113,01110001,222,11011110
25,00011001,70,01000110,95,01011111
10,00001010,19,00010011,29,00011101
45,00101101,79,01001111,124,01111100
84,01010100,53,00110101,137,10001001
79,01001111,54,00110110,133,10000101
35,00100011,47,00101111,82,01010010
71,01000111,104,01101000,175,10101111
60,00111100,36,00100100,96,01100000
113,01110001,28,00011100,141,10001101
44,00101100,46,00101110,90,01011010
9,00001001,100,01100100,109,01101101
87,01010111,35,00100011,122,01111010
92,01011100,18,00010010,110,01101110
78,01001110,103,01100111,181,10110101
20,00010100,36,00100100,56,00111000
72,01001000,112,01110000,184,10111000
103,01100111,13,00001101,116,01110100
119,01110111,107,01101011,226,11100010
104,01101000,21,00010101,125,01111101
59,00111011,111,01101111,170,10101010
61,00111101,96,01100000,157,10011101
32,00100000,30,00011110,62,00111110
73,01001001,91,01011011,164,10100100
61,00111101,28,00011100,89,01011001
56,00111000,107,01101011,163,10100011
23,00010111,92,01011100,115,01110011
56,00111000,66,01000010,122,01111010
20,00010100,86,01010110,106,01101010
96,01100000,7,00000111,103,01100111
56,00111000,21,00010101,77,01001101
84,01010100,19,00010011,103,01100111
89,01011001,47,00101111,136,10001000
37,00100101,88,01011000,125,01111101
83,01010011,55,00110111,138,10001010
42,00101010,13,00001101,55,00110111
44,00101100,91,01011011,135,10000111
86,01010110,91,01011011,177,10110001
3,00000011,57,00111001,60,00111100
33,00100001,29,00011101,62,00111110
85,01010101,66,01000010,151,10010111
38,00100110,24,00011000,62,00111110
81,01010001,77,01001101,158,10011110
73,01001001,105,01101001,178,10110010
25,00011001,37,00100101,62,00111110
14,00001110,29,00011101,43,00101011
111,01101111,7,00000111,118,01110110
58,00111010,27,00011011,85,01010101
28,00011100,86,01010110,114,01110010
68,01000100,67,01000011,135,10000111
24,00011000,103,01100111,127,01111111
26,00011010,122,01111010,148,10010100
9,00001001,59,00111011,68,01000100
105,01101001,116,01110100,221,11011101
55,00110111,71,01000111,126,01111110
84,01010100,11,00001011,95,01011111
70,01000110,92,01011100,162,10100010
109,01101101,2,00000010,111,01101111
39,00100111,57,00111001,96,01100000
122,01111010,27,00011011,149,10010101
31,00011111,35,00100011,66,01000010
12,00001100,64,01000000,76,01001100
127,01111111,23,00010111,150,10010110
5,00000101,55,00110111,60,00111100
64,01000000,35,00100011,99,01100011
127,01111111,10,00001010,137,10001001
29,00011101,63,00111111,92,01011100
81,01010001,48,00110000,129,10000001
104,01101000,82,01010010,186,10111010
59,00111011,116,01110100,175,10101111
47,00101111,61,00111101,108,01101100
10,00001010,19,00010011,29,00011101
101,01100101,77,01001101,178,10110010
57,00111001,67,01000011,124,01111100
36,00100100,3,00000011,39,00100111
35,00100011,71,01000111,106,01101010
118,01110110,74,01001010,192,11000000
84,01010100,92,01011100,176,10110000
72,01001000,8,00001000,80,01010000
81,01010001,81,01010001,162,10100010
124,01111100,69,01000101,193,11000001
95,01011111,93,01011101,188,10111100
59,00111011,80,01010000,139,10001011
57,00111001,116,01110100,173,10101101
86,01010110,99,01100011,185,10111001
50,00110010,99,01100011,149,10010101
80,01010000,117,01110101,197,11000101
27,00011011,96,01100000,123,01111011
47,00101111,66,01000010,113,01110001
11,00001011,82,01010010,93,01011101
88,01011000,24,00011000,112,01110000
0,00000000,109,01101101,109,01101101
60,00111100,72,01001000,132,10000100
87,01010111,1,00000001,88,01011000
123,01111011,93,01011101,216,11011000
47,00101111,102,01100110,149,10010101
102,01100110,108,01101100,210,11010010
114,01110010,50,00110010,164,10100100
81,01010001,83,01010011,164,10100100
125,01111101,89,01011001,214,11010110
126,01111110,69,01000101,195,11000011
123,01111011,110,01101110,233,11101001
85,01010101,34,00100010,119,01110111
97,01100001,38,00100110,135,10000111
114,01110010,127,01111111,241,11110001
91,01011011,105,01101001,196,11000100
101,01100101,49,00110001,150,10010110
124,01111100,4,00000100,128,10000000
83,01010011,51,00110011,134,10000110
33,00100001,85,01010101,118,01110110
4,00000100,51,00110011,55,00110111
89,01011001,125,01111101,214,11010110
115,01110011,71,01000111,186,10111010
56,00111000,126,01111110,182,10110110
36,00100100,51,00110011,87,01010111
95,01011111,61,00111101,156,10011100
61,00111101,111,01101111,172,10101100
66,01000010,57,00111001,123,01111011
25,00011001,12,00001100,37,00100101
116,01110100,61,00111101,177,10110001
121,01111001,125,01111101,246,11110110
5,00000101,35,00100011,40,00101000
94,01011110,116,01110100,210,11010010
52,00110100,9,00001001,61,00111101
49,00110001,115,01110011,164,10100100
81,01010001,56,00111000,137,10001001
29,00011101,75,01001011,104,01101000
61,00111101,34,00100010,95,01011111
107,01101011,120,01111000,227,11100011
122,01111010,43,00101011,165,10100101
33,00100001,122,01111010,155,10011011
126,01111110,28,00011100,154,10011010
22,00010110,89,01011001,111,01101111
91,01011011,17,00010001,108,01101100
127,01111111,33,00100001,160,10100000
97,01100001,116,01110100,213,11010101
89,01011001,84,01010100,173,10101101
123,01111011,7,00000111,130,10000010
64,01000000,12,00001100,76,01001100
113,01110001,71,01000111,184,10111000
44,00101100,87,01010111,131,10000011
38,00100110,2,00000010,40,00101000
59,00111011,73,01001001,132,10000100
30,00011110,62,00111110,92,01011100
50,00110010,26,00011010,76,01001100
12,00001100,18,00010010,30,00011110
103,01100111,113,01110001,216,11011000
29,00011101,58,00111010,87,01010111
110,01101110,38,00100110,148,10010100
119,01110111,70,01000110,189,10111101
66,01000010,124,01111100,190,10111110
49,00110001,77,01001101,126,01111110
120,01111000,51,00110011,171,10101011
127,01111111,80,01010000,207,11001111
31,00011111,8,00001000,39,00100111
105,01101001,103,01100111,208,11010000
31,00011111,25,00011001,56,00111000
18,00010010,83,01010011,101,01100101
92,01011100,65,01000001,157,10011101
57,00111001,90,01011010,147,10010011
115,01110011,30,00011110,145,10010001
21,00010101,116,01110100,137,10001001
75,01001011,35,00100011,110,01101110
98,01100010,125,01111101,223,11011111
54,00110110,64,01000000,118,01110110
121,01111001,63,00111111,184,10111000
88,01011000,46,00101110,134,10000110
96,01100000,40,00101000,136,10001000
58,00111010,68,01000100,126,01111110
29,00011101,51,00110011,80,01010000
54,00110110,56,00111000,110,01101110
116,01110100,82,01010010,198,11000110
52,00110100,101,01100101,153,10011001
103,01100111,66,01000010,169,10101001
115,01110011,33,00100001,148,10010100
89,01011001,27,00011011,116,01110100
109,01101101,86,01010110,195,11000011
42,00101010,113,01110001,155,10011011
6,00000110,53,00110101,59,00111011
93,01011101,32,00100000,125,01111101
103,01100111,23,00010111,126,01111110
37,00100101,10,00001010,47,00101111
9,00001001,65,01000001,74,01001010
64,01000000,3,00000011,67,01000011
25,00011001,61,00111101,86,01010110
104,01101000,76,01001100,180,10110100
67,01000011,98,01100010,165,10100101
91,01011011,49,00110001,140,10001100
1,00000001,8,00001000,9,00001001
102,01100110,97,01100001,199,11000111
107,01101011,95,01011111,202,11001010
29,00011101,48,00110000,77,01001101
60,00111100,124,01111100,184,10111000
109,01101101,77,01001101,186,10111010
78,01001110,28,00011100,106,01101010
80,01010000,99,01100011,179,10110011
88,01011000,45,00101101,133,10000101
6,00000110,18,00010010,24,00011000
56,00111000,33,00100001,89,01011001
124,01111100,8,00001000,132,10000100
78,01001110,18,00010010,96,01100000
105,01101001,59,00111011,164,10100100
39,00100111,24,00011000,63,00111111
12,00001100,9,00001001,21,00010101
112,01110000,97,01100001,209,11010001
127,01111111,49,00110001,176,10110000
97,01100001,50,00110010,147,10010011
88,01011000,15,00001111,103,01100111
110,01101110,39,00100111,149,10010101
70,01000110,61,00111101,131,10000011
17,00010001,8,00001000,25,00011001
111,01101111,65,01000001,176,10110000
7,00000111,20,00010100,27,00011011
40,00101000,72,01001000,112,01110000
116,01110100,0,00000000,116,01110100
119,01110111,41,00101001,160,10100000
2,00000010,32,00100000,34,00100010
86,01010110,124,01111100,210,11010010
10,00001010,94,01011110,104,01101000
8,00001000,21,00010101,29,00011101
119,01110111,57,00111001,176,10110000
45,00101101,67,01000011,112,01110000
69,01000101,27,00011011,96,01100000
90,01011010,12,00001100,102,01100110
64,01000000,3,00000011,67,01000011
61,00111101,43,00101011,104,01101000
96,01100000,40,00101000,136,10001000
20,00010100,14,00001110,34,00100010
24,00011000,67,01000011,91,01011011
32,00100000,73,01001001,105,01101001
70,01000110,67,01000011,137,10001001
58,00111010,28,00011100,86,01010110
3,00000011,79,01001111,82,01010010
96,01100000,38,00100110,134,10000110
108,01101100,92,01011100,200,11001000
117,01110101,114,01110010,231,11100111
69,01000101,1,00000001,70,01000110
17,00010001,62,00111110,79,01001111
47,00101111,8,00001000,55,00110111
73,01001001,52,00110100,125,01111101
13,00001101,112,01110000,125,01111101
41,00101001,24,00011000,65,01000001
63,00111111,68,01000100,131,10000011
71,01000111,69,01000101,140,10001100
103,01100111,20,00010100,123,01111011
67,01000011,65,01000001,132,10000100
73,01001001,90,01011010,163,10100011
65,01000001,40,00101000,105,01101001
112,01110000,102,01100110,214,11010110
46,00101110,21,00010101,67,01000011
76,01001100,70,01000110,146,10010010
32,00100000,42,00101010,74,01001010
84,01010100,76,01001100,160,10100000
86,01010110,20,00010100,106,01101010
109,01101101,33,00100001,142,10001110
32,00100000,9,00001001,41,00101001
59,00111011,100,01100100,159,10011111
127,01111111,3,00000011,130,10000010
105,01101001,63,00111111,168,10101000
62,00111110,8,00001000,70,01000110
28,00011100,115,01110011,143,10001111
13,00001101,87,01010111,100,01100100
71,01000111,126,01111110,197,11000101
127,01111111,115,01110011,242,11110010
12,00001100,2,00000010,14,00001110
100,01100100,109,01101101,209,11010001
77,01001101,23,00010111,100,01100100
126,01111110,103,01100111,229,11100101
59,00111011,121,01111001,180,10110100
118,01110110,73,01001001,191,10111111
103,01100111,126,01111110,229,11100101
79,01001111,11,00001011,90,01011010
9,00001001,62,00111110,71,01000111
65,01000001,90,01011010,155,10011011
11,00001011,95,01011111,106,01101010
48,00110000,58,00111010,106,01101010
75,01001011,1,00000001,76,01001100
121,01111001,72,01001000,193,11000001
25,00011001,120,01111000,145,10010001
30,00011110,33,00100001,63,00111111
108,01101100,87,01010111,195,11000011
20,00010100,49,00110001,69,01000101
8,00001000,64,01000000,72,01001000
34,00100010,30,00011110,64,01000000
102,01100110,84,01010100,186,10111010
37,00100101,22,00010110,59,00111011
61,00111101,42,00101010,103,01100111
48,00110000,86,01010110,134,10000110
105,01101001,20,00010100,125,01111101
43,00101011,7,00000111,50,00110010
65,01000001,120,01111000,185,10111001
45,00101101,30,00011110,75,01001011
12,00001100,69,01000101,81,01010001
56,00111000,21,00010101,77,01001101
69,01000101,16,00010000,85,01010101
43,00101011,126,01111110,169,10101001
23,00010111,40,00101000,63,00111111
126,01111110,37,00100101,163,10100011
111,01101111,48,00110000,159,10011111
39,00100111,104,01101000,143,10001111
38,00100110,43,00101011,81,01010001
122,01111010,48,00110000,170,10101010
0,00000000,9,00001001,9,00001001
124,01111100,15,00001111,139,10001011
52,00110100,108,01101100,160,10100000
53,00110101,126,01111110,179,10110011
4,00000100,28,00011100,32,00100000
113,01110001,35,00100011,148,10010100
20,00010100,6,00000110,26,00011010
41,00101001,31,00011111,72,01001000
89,01011001,80,01010000,169,10101001
68,01000100,110,01101110,178,10110010
13,00001101,33,00100001,46,00101110
17,00010001,111,01101111,128,10000000
65,01000001,89,01011001,154,10011010
47,00101111,86,01010110,133,10000101
42,00101010,22,00010110,64,01000000
81,01010001,67,01000011,148,10010100
19,00010011,46,00101110,65,01000001
29,00011101,118,01110110,147,10010011
68,01000100,84,01010100,152,10011000
109,01101101,30,00011110,139,10001011
44,00101100,79,01001111,123,01111011
33,00100001,124,01111100,157,10011101
4,00000100,83,01010011,87,01010111
37,00100101,52,00110100,89,01011001
64,01000000,17,00010001,81,01010001
17,00010001,113,01110001,130,10000010
39,00100111,104,01101000,143,10001111
18,00010010,5,00000101,23,00010111
98,01100010,3,00000011,101,01100101
58,00111010,0,00000000,58,00111010
119,01110111,35,00100011,154,10011010
25,00011001,84,01010100,109,01101101
93,01011101,65,01000001,158,10011110
14,00001110,44,00101100,58,00111010
102,01100110,4,00000100,106,01101010
70,01000110,17,00010001,87,01010111
93,01011101,61,00111101,154,10011010
56,00111000,1,00000001,57,00111001
16,00010000,66,01000010,82,01010010
78,01001110,106,01101010,184,10111000
49,00110001,24,00011000,73,01001001
69,01000101,121,01111001,190,10111110
21,00010101,8,00001000,29,00011101
72,01001000,33,00100001,105,01101001
69,01000101,96,01100000,165,10100101
117,01110101,0,00000000,117,01110101
43,00101011,115,01110011,158,10011110
6,00000110,14,00001110,20,00010100
37,00100101,92,01011100,129,10000001
80,01010000,53,00110101,133,10000101
29,00011101,116,01110100,145,10010001
82,01010010,93,01011101,175,10101111
120,01111000,122,01111010,242,11110010
101,01100101,3,00000011,104,01101000
106,01101010,74,01001010,180,10110100
41,00101001,39,00100111,80,01010000
96,01100000,32,00100000,128,10000000
28,00011100,14,00001110,42,00101010
95,01011111,98,01100010,193,11000001
62,00111110,61,00111101,123,01111011
101,01100101,99,01100011,200,11001000
67,01000011,13,00001101,80,01010000
18,00010010,81,01010001,99,01100011
61,00111101,34,00100010,95,01011111
98,01100010,83,01010011,181,10110101
114,01110010,68,01000100,182,10110110
75,01001011,21,00010101,96,01100000
3,00000011,113,01110001,116,01110100
34,00100010,83,01010011,117,01110101
90,01011010,72,01001000,162,10100010
105,01101001,78,01001110,183,10110111
35,00100011,76,01001100,111,01101111
81,01010001,106,01101010,187,10111011
87,01010111,81,01010001,168,10101000
96,01100000,49,00110001,145,10010001
11,00001011,104,01101000,115,01110011
66,01000010,112,01110000,178,10110010
22,00010110,68,01000100,90,01011010
41,00101001,42,00101010,83,01010011
15,00001111,59,00111011,74,01001010
60,00111100,81,01010001,141,10001101
103,01100111,77,01001101,180,10110100
95,01011111,99,01100011,194,11000010
124,01111100,113,01110001,237,11101101
3,00000011,122,01111010,125,01111101
45,00101101,25,00011001,70,01000110
51,00110011,28,00011100,79,01001111
82,01010010,108,01101100,190,10111110
95,01011111,23,00010111,118,01110110
110,01101110,10,00001010,120,01111000
13,00001101,77,01001101,90,01011010
13,00001101,83,01010011,96,01100000
65,01000001,3,00000011,68,01000100
12,00001100,8,00001000,20,00010100
115,01110011,10,00001010,125,01111101
125,01111101,6,00000110,131,10000011
52,00110100,31,00011111,83,01010011
119,01110111,43,00101011,162,10100010
95,01011111,21,00010101,116,01110100
13,00001101,71,01000111,84,01010100
45,00101101,28,00011100,73,01001001
82,01010010,29,00011101,111,01101111
61,00111101,26,00011010,87,01010111
50,00110010,15,00001111,65,01000001
46,00101110,65,01000001,111,01101111
109,01101101,51,00110011,160,10100000
25,00011001,18,00010010,43,00101011
117,01110101,39,00100111,156,10011100
48,00110000,45,00101101,93,01011101
22,00010110,27,00011011,49,00110001
75,01001011,44,00101100,119,01110111
38,00100110,113,01110001,151,10010111
0,00000000,9,00001001,9,00001001
22,00010110,69,01000101,91,01011011
125,01111101,23,00010111,148,10010100
70,01000110,86,01010110,156,10011100
87,01010111,65,01000001,152,10011000
55,00110111,55,00110111,110,01101110
26,00011010,31,00011111,57,00111001
19,00010011,61,00111101,80,01010000
25,00011001,104,01101000,129,10000001
71,01000111,11,00001011,82,01010010
123,01111011,57,00111001,180,10110100
55,00110111,17,00010001,72,01001000
54,00110110,104,01101000,158,10011110
0,00000000,11,00001011,11,00001011
36,00100100,99,01100011,135,10000111
77,01001101,124,01111100,201,11001001
8,00001000,63,00111111,71,01000111
102,01100110,10,00001010,112,01110000
89,01011001,105,01101001,194,11000010
9,00001001,118,01110110,127,01111111
84,01010100,4,00000100,88,01011000
59,00111011,39,00100111,98,01100010
80,01010000,82,01010010,162,10100010
110,01101110,78,01001110,188,10111100
87,01010111,110,01101110,197,11000101
52,00110100,99,01100011,151,10010111
123,01111011,48,00110000,171,10101011
30,00011110,3,00000011,33,00100001
10,00001010,32,00100000,42,00101010
21,00010101,41,00101001,62,00111110
122,01111010,110,01101110,232,11101000
97,01100001,18,00010010,115,01110011
97,01100001,51,00110011,148,10010100
76,01001100,63,00111111,139,10001011
52,00110100,66,01000010,118,01110110
89,01011001,106,01101010,195,11000011
94,01011110,51,00110011,145,10010001
92,01011100,41,00101001,133,10000101
17,00010001,14,00001110,31,00011111
59,00111011,60,00111100,119,01110111
13,00001101,97,01100001,110,01101110
22,00010110,116,01110100,138,10001010
61,00111101,88,01011000,149,10010101
30,00011110,10,00001010,40,00101000
3,00000011,31,00011111,34,00100010
113,01110001,32,00100000,145,10010001
13,00001101,49,00110001,62,00111110
39,00100111,0,00000000,39,00100111
110,01101110,24,00011000,134,10000110
84,01010100,43,00101011,127,01111111
105,01101001,90,01011010,195,11000011
91,01011011,87,01010111,178,10110010
90,01011010,73,01001001,163,10100011
97,01100001,90,01011010,187,10111011
41,00101001,111,01101111,152,10011000
31,00011111,40,00101000,71,01000111
95,01011111,8,00001000,103,01100111
49,00110001,36,00100100,85,01010101
81,01010001,94,01011110,175,10101111
1,00000001,58,00111010,59,00111011
29,00011101,117,01110101,146,10010010
80,01010000,84,01010100,164,10100100
8,00001000,119,01110111,127,01111111
36,00100100,93,01011101,129,10000001
59,00111011,107,01101011,166,10100110
108,01101100,15,00001111,123,01111011
13,00001101,25,00011001,38,00100110
126,01111110,101,01100101,227,11100011
80,01010000,50,00110010,130,10000010
11,00001011,46,00101110,57,00111001
2,00000010,33,00100001,35,00100011
92,01011100,90,01011010,182,10110110
41,00101001,1,00000001,42,00101010
26,00011010,72,01001000,98,01100010
83,01010011,27,00011011,110,01101110
121,01111001,99,01100011,220,11011100
22,00010110,89,01011001,111,01101111
88,01011000,108,01101100,196,11000100
84,01010100,36,00100100,120,01111000
117,01110101,24,00011000,141,10001101
30,00011110,12,00001100,42,00101010
52,00110100,119,01110111,171,10101011
106,01101010,56,00111000,162,10100010
92,01011100,114,01110010,206,11001110
68,01000100,65,01000001,133,10000101
69,01000101,44,00101100,113,01110001
85,01010101,122,01111010,207,11001111
113,01110001,24,00011000,137,10001001
8,00001000,120,01111000,128,10000000
108,01101100,122,01111010,230,11100110
112,01110000,122,01111010,234,11101010
30,00011110,32,00100000,62,00111110
85,01010101,67,01000011,152,10011000
57,00111001,117,01110101,174,10101110
84,01010100,81,01010001,165,10100101
126,01111110,17,00010001,143,10001111
75,01001011,18,00010010,93,01011101
121,01111001,35,00100011,156,10011100
58,00111010,85,01010101,143,10001111
109,01101101,43,00101011,152,10011000
63,00111111,98,01100010,161,10100001
115,01110011,97,01100001,212,11010100
73,01001001,27,00011011,100,01100100
87,01010111,63,00111111,150,10010110
105,01101001,51,00110011,156,10011100
59,00111011,36,00100100,95,01011111
48,00110000,97,01100001,145,10010001
11,00001011,109,01101101,120,01111000
72,01001000,107,01101011,179,10110011
110,01101110,93,01011101,203,11001011
33,00100001,47,00101111,80,01010000
14,00001110,94,01011110,108,01101100
110,01101110,31,00011111,141,10001101
87,01010111,63,00111111,150,10010110
43,00101011,21,00010101,64,01000000
2,00000010,26,00011010,28,00011100
100,01100100,110,01101110,210,11010010
9,00001001,1,00000001,10,00001010
56,00111000,67,01000011,123,01111011
81,01010001,1,00000001,82,01010010
112,01110000,30,00011110,142,10001110
34,00100010,97,01100001,131,10000011
47,00101111,48,00110000,95,01011111
10,00001010,121,01111001,131,10000011
6,00000110,5,00000101,11,00001011
42,00101010,70,01000110,112,01110000
105,01101001,38,00100110,143,10001111
5,00000101,60,00111100,65,01000001
30,00011110,59,00111011,89,01011001
8,00001000,63,00111111,71,01000111
81,01010001,119,01110111,200,11001000
86,01010110,3,00000011,89,01011001
15,00001111,102,01100110,117,01110101
110,01101110,116,01110100,226,11100010
94,01011110,6,00000110,100,01100100
93,01011101,22,00010110,115,01110011
10,00001010,28,00011100,38,00100110
7,00000111,91,01011011,98,01100010
112,01110000,83,01010011,195,11000011
2,00000010,115,01110011,117,01110101
71,01000111,76,01001100,147,10010011
51,00110011,19,00010011,70,01000110
115,01110011,94,01011110,209,11010001
30,00011110,126,01111110,156,10011100
27,00011011,15,00001111,42,00101010
47,00101111,23,00010111,70,01000110
58,00111010,94,01011110,152,10011000
83,01010011,8,00001000,91,01011011
13,00001101,38,00100110,51,00110011
38,00100110,2,00000010,40,00101000
42,00101010,51,00110011,93,01011101
68,01000100,38,00100110,106,01101010
69,01000101,59,00111011,128,10000000
63,00111111,53,00110101,116,01110100
62,00111110,110,01101110,172,10101100
114,01110010,33,00100001,147,10010011
88,01011000,108,01101100,196,11000100
92,01011100,85,01010101,177,10110001
125,01111101,44,00101100,169,10101001
14,00001110,114,01110010,128,10000000
116,01110100,68,01000100,184,10111000
105,01101001,81,01010001,186,10111010
79,01001111,25,00011001,104,01101000
63,00111111,36,00100100,99,01100011
12,00001100,38,00100110,50,00110010
59,00111011,93,01011101,152,10011000
30,00011110,98,01100010,128,10000000
83,01010011,106,01101010,189,10111101
83,01010011,31,00011111,114,01110010
105,01101001,100,01100100,205,11001101
105,01101001,75,01001011,180,10110100
7,00000111,69,01000101,76,01001100
77,01001101,62,00111110,139,10001011
98,01100010,46,00101110,144,10010000
32,00100000,32,00100000,64,01000000
28,00011100,12,00001100,40,00101000
93,01011101,115,01110011,208,11010000
74,01001010,106,01101010,180,10110100
55,00110111,73,01001001,128,10000000
115,01110011,49,00110001,164,10100100
123,01111011,19,00010011,142,10001110
86,01010110,23,00010111,109,01101101
30,00011110,60,00111100,90,01011010
52,00110100,13,00001101,65,01000001
114,01110010,31,00011111,145,10010001
58,00111010,124,01111100,182,10110110
16,00010000,18,00010010,34,00100010
1,00000001,15,00001111,16,00010000
32,00100000,78,01001110,110,01101110
73,01001001,6,00000110,79,01001111
115,01110011,111,01101111,226,11100010
67,01000011,70,01000110,137,10001001
118,01110110,79,01001111,197,11000101
93,01011101,85,01010101,178,10110010
51,00110011,74,01001010,125,01111101
58,00111010,77,01001101,135,10000111
91,01011011,26,00011010,117,01110101
26,00011010,105,01101001,131,10000011
68,01000100,59,00111011,127,01111111
29,00011101,48,00110000,77,01001101
92,01011100,61,00111101,153,10011001
60,00111100,15,00001111,75,01001011
110,01101110,121,01111001,231,11100111
91,01011011,40,00101000,131,10000011
32,00100000,45,00101101,77,01001101
113,01110001,14,00001110,127,01111111
68,01000100,89,01011001,157,10011101
96,01100000,12,00001100,108,01101100
44,00101100,105,01101001,149,10010101
59,00111011,42,00101010,101,01100101
63,00111111,52,00110100,115,01110011
13,00001101,52,00110100,65,01000001
50,00110010,120,01111000,170,10101010
50,00110010,113,01110001,163,10100011
69,01000101,87,01010111,156,10011100
101,01100101,116,01110100,217,11011001
94,01011110,92,01011100,186,10111010
54,00110110,85,01010101,139,10001011
83,01010011,88,01011000,171,10101011
121,01111001,47,00101111,168,10101000
87,01010111,45,00101101,132,10000100
62,00111110,10,00001010,72,01001000
94,01011110,96,01100000,190,10111110
85,01010101,104,01101000,189,10111101
54,00110110,94,01011110,148,10010100
6,00000110,25,00011001,31,00011111
5,00000101,55,00110111,60,00111100
95,01011111,47,00101111,142,10001110
110,01101110,27,00011011,137,10001001
89,01011001,33,00100001,122,01111010
91,01011011,16,00010000,107,01101011
16,00010000,79,01001111,95,01011111
94,01011110,34,00100010,128,10000000
59,00111011,69,01000101,128,10000000
72,01001000,16,00010000,88,01011000
102,01100110,51,00110011,153,10011001
103,01100111,92,01011100,195,11000011
5,00000101,0,00000000,5,00000101
83,01010011,23,00010111,106,01101010
124,01111100,30,00011110,154,10011010
116,01110100,110,01101110,226,11100010
38,00100110,40,00101000,78,01001110
98,01100010,81,01010001,179,10110011
127,01111111,15,00001111,142,10001110
74,01001010,18,00010010,92,01011100
104,01101000,27,00011011,131,10000011
51,00110011,124,01111100,175,10101111
42,00101010,102,01100110,144,10010000
78,01001110,47,00101111,125,01111101
81,01010001,124,01111100,205,11001101
119,01110111,41,00101001,160,10100000
108,01101100,3,00000011,111,01101111
112,01110000,117,01110101,229,11100101
25,00011001,88,01011000,113,01110001
108,01101100,95,01011111,203,11001011
87,01010111,125,01111101,212,11010100
79,01001111,21,00010101,100,01100100
60,00111100,29,00011101,89,01011001
22,00010110,24,00011000,46,00101110
67,01000011,9,00001001,76,01001100
38,00100110,64,01000000,102,01100110
79,01001111,108,01101100,187,10111011
105,01101001,14,00001110,119,01110111
69,01000101,81,01010001,150,10010110
58,00111010,105,01101001,163,10100011
67,01000011,112,01110000,179,10110011
83,01010011,82,01010010,165,10100101
107,01101011,49,00110001,156,10011100
113,01110001,1,00000001,114,01110010
7,00000111,8,00001000,15,00001111
31,00011111,124,01111100,155,10011011
14,00001110,78,01001110,92,01011100
20,00010100,18,00010010,38,00100110
111,01101111,35,00100011,146,10010010
44,00101100,104,01101000,148,10010100
103,01100111,31,00011111,134,10000110
65,01000001,90,01011010,155,10011011
121,01111001,24,00011000,145,10010001
38,00100110,41,00101001,79,01001111
95,01011111,56,00111000,151,10010111
75,01001011,112,01110000,187,10111011
59,00111011,35,00100011,94,01011110
75,01001011,113,01110001,188,10111100
47,00101111,49,00110001,96,01100000
113,01110001,114,01110010,227,11100011
111,01101111,114,01110010,225,11100001
109,01101101,29,00011101,138,10001010
100,01100100,50,00110010,150,10010110
121,01111001,10,00001010,131,10000011
42,00101010,26,00011010,68,01000100
124,01111100,75,01001011,199,11000111
57,00111001,105,01101001,162,10100010
71,01000111,125,01111101,196,11000100
116,01110100,96,01100000,212,11010100
91,01011011,7,00000111,98,01100010
55,00110111,84,01010100,139,10001011
17,00010001,74,01001010,91,01011011
92,01011100,70,01000110,162,10100010
56,00111000,28,00011100,84,01010100
127,01111111,16,00010000,143,10001111
61,00111101,68,01000100,129,10000001
69,01000101,88,01011000,157,10011101
44,00101100,54,00110110,98,01100010
112,01110000,32,00100000,144,10010000
110,01101110,76,01001100,186,10111010
55,00110111,65,01000001,120,01111000
111,01101111,12,00001100,123,01111011
25,00011001,64,01000000,89,01011001
69,01000101,76,01001100,145,10010001
30,00011110,40,00101000,70,01000110
17,00010001,28,00011100,45,00101101
116,01110100,28,00011100,144,10010000
11,00001011,93,01011101,104,01101000
65,01000001,104,01101000,169,10101001
0,00000000,108,01101100,108,01101100
50,00110010,122,01111010,172,10101100
27,00011011,56,00111000,83,01010011
124,01111100,79,01001111,203,11001011
107,01101011,52,00110100,159,10011111
16,00010000,90,01011010,106,01101010
77,01001101,25,00011001,102,01100110
105,01101001,23,00010111,128,10000000
60,00111100,71,01000111,131,10000011
19,00010011,102,01100110,121,01111001
65,01000001,107,01101011,172,10101100
62,00111110,40,00101000,102,01100110
68,01000100,15,00001111,83,01010011
21,00010101,19,00010011,40,00101000
28,00011100,97,01100001,125,01111101
10,00001010,24,00011000,34,00100010
25,00011001,53,00110101,78,01001110
7,00000111,20,00010100,27,00011011
99,01100011,87,01010111,186,10111010
62,00111110,62,00111110,124,01111100
78,01001110,15,00001111,93,01011101
4,00000100,107,01101011,111,01101111
100,01100100,94,01011110,194,11000010
96,01100000,103,01100111,199,11000111
106,01101010,85,01010101,191,10111111
115,01110011,1,00000001,116,01110100
50,00110010,23,00010111,73,01001001
64,01000000,14,00001110,78,01001110
91,01011011,116,01110100,207,11001111
77,01001101,37,00100101,114,01110010
52,00110100,98,01100010,150,10010110
76,01001100,2,00000010,78,01001110
114,01110010,97,01100001,211,11010011
119,01110111,78,01001110,197,11000101
17,00010001,105,01101001,122,01111010
44,00101100,71,01000111,115,01110011
27,00011011,23,00010111,50,00110010
99,01100011,111,01101111,210,11010010
65,01000001,71,01000111,136,10001000
57,00111001,119,01110111,176,10110000
75,01001011,57,00111001,132,10000100
103,01100111,10,00001010,113,01110001
8,00001000,14,00001110,22,00010110
93,01011101,95,01011111,188,10111100
26,00011010,51,00110011,77,01001101
41,00101001,80,01010000,121,01111001
41,00101001,119,01110111,160,10100000
125,01111101,45,00101101,170,10101010
95,01011111,26,00011010,121,01111001
117,01110101,101,01100101,218,11011010
127,01111111,69,01000101,196,11000100
77,01001101,9,00001001,86,01010110
21,00010101,2,00000010,23,00010111
111,01101111,32,00100000,143,10001111
68,01000100,124,01111100,192,11000000
40,00101000,6,00000110,46,00101110
65,01000001,53,00110101,118,01110110
118,01110110,103,01100111,221,11011101
52,00110100,62,00111110,114,01110010
106,01101010,63,00111111,169,10101001
119,01110111,76,01001100,195,11000011
58,00111010,45,00101101,103,01100111
86,01010110,104,01101000,190,10111110
76,01001100,16,00010000,92,01011100
67,01000011,86,01010110,153,10011001
127,01111111,24,00011000,151,10010111
5,00000101,84,01010100,89,01011001
125,01111101,10,00001010,135,10000111
104,01101000,60,00111100,164,10100100
89,01011001,26,00011010,115,01110011
25,00011001,94,01011110,119,01110111
25,00011001,69,01000101,94,01011110
27,00011011,64,01000000,91,01011011
33,00100001,2,00000010,35,00100011
73,01001001,78,01001110,151,10010111
61,00111101,39,00100111,100,01100100
23,00010111,107,01101011,130,10000010
52,00110100,69,01000101,121,01111001
34,00100010,95,01011111,129,10000001
2,00000010,100,01100100,102,01100110
78,01001110,27,00011011,105,01101001
27,00011011,64,01000000,91,01011011
85,01010101,106,01101010,191,10111111
120,01111000,101,01100101,221,11011101
17,00010001,72,01001000,89,01011001
8,00001000,45,00101101,53,00110101
13,00001101,20,00010100,33,00100001
112,01110000,21,00010101,133,10000101
87,01010111,1,00000001,88,01011000
38,00100110,110,01101110,148,10010100
56,00111000,75,01001011,131,10000011
24,00011000,119,01110111,143,10001111
93,01011101,31,00011111,124,01111100
21,00010101,92,01011100,113,01110001
76,01001100,92,01011100,168,10101000
104,01101000,65,01000001,169,10101001
95,01011111,54,00110110,149,10010101
10,00001010,92,01011100,102,01100110
48,00110000,106,01101010,154,10011010
101,01100101,21,00010101,122,01111010
75,01001011,115,01110011,190,10111110
4,00000100,124,01111100,128,10000000
102,01100110,123,01111011,225,11100001
108,01101100,78,01001110,186,10111010
53,00110101,99,01100011,152,10011000
120,01111000,55,00110111,175,10101111
103,01100111,42,00101010,145,10010001
120,01111000,95,01011111,215,11010111
43,00101011,72,01001000,115,01110011
123,01111011,22,00010110,145,10010001
39,00100111,40,00101000,79,01001111
34,00100010,35,00100011,69,01000101
116,01110100,100,01100100,216,11011000
52,00110100,95,01011111,147,10010011
126,01111110,59,00111011,185,10111001
36,00100100,49,00110001,85,01010101
18,00010010,53,00110101,71,01000111
13,00001101,54,00110110,67,01000011
118,01110110,63,00111111,181,10110101
57,00111001,47,00101111,104,01101000
11,00001011,107,01101011,118,01110110
114,01110010,85,01010101,199,11000111
64,01000000,126,01111110,190,10111110
122,01111010,41,00101001,163,10100011
17,00010001,17,00010001,34,00100010
125,01111101,33,00100001,158,10011110
40,00101000,99,01100011,139,10001011
35,00100011,34,00100010,69,01000101
91,01011011,99,01100011,190,10111110
115,01110011,32,00100000,147,10010011
24,00011000,123,01111011,147,10010011
9,00001001,91,01011011,100,01100100
45,00101101,26,00011010,71,01000111
13,00001101,36,00100100,49,00110001
42,00101010,124,01111100,166,10100110
24,00011000,48,00110000,72,01001000
51,00110011,92,01011100,143,10001111
112,01110000,120,01111000,232,11101000
99,01100011,31,00011111,130,10000010
32,00100000,44,00101100,76,01001100
90,01011010,8,00001000,98,01100010
17,00010001,111,01101111,128,10000000
22,00010110,29,00011101,51,00110011
0,00000000,110,01101110,110,01101110
6,00000110,79,01001111,85,01010101
21,00010101,82,01010010,103,01100111
67,01000011,117,01110101,184,10111000
115,01110011,23,00010111,138,10001010
58,00111010,11,00001011,69,01000101
54,00110110,64,01000000,118,01110110
100,01100100,24,00011000,124,01111100
68,01000100,41,00101001,109,01101101
34,00100010,66,01000010,100,01100100
8,00001000,35,00100011,43,00101011
106,01101010,4,00000100,110,01101110
67,01000011,36,00100100,103,01100111
66,01000010,12,00001100,78,01001110
63,00111111,89,01011001,152,10011000
124,01111100,24,00011000,148,10010100
33,00100001,47,00101111,80,01010000
48,00110000,44,00101100,92,01011100
99,01100011,56,00111000,155,10011011
99,01100011,9,00001001,108,01101100
47,00101111,4,00000100,51,00110011
75,01001011,104,01101000,179,10110011
26,00011010,9,00001001,35,00100011
89,01011001,123,01111011,212,11010100
73,01001001,28,00011100,101,01100101
89,01011001,109,01101101,198,11000110
68,01000100,30,00011110,98,01100010
47,00101111,33,00100001,80,01010000
117,01110101,93,01011101,210,11010010
93,01011101,84,01010100,177,10110001
53,00110101,120,01111000,173,10101101
119,01110111,80,01010000,199,11000111
95,01011111,38,00100110,133,10000101
65,01000001,65,01000001,130,10000010
109,01101101,30,00011110,139,10001011
41,00101001,127,01111111,168,10101000
116,01110100,37,00100101,153,10011001
42,00101010,1,00000001,43,00101011
62,00111110,5,00000101,67,01000011
14,00001110,9,00001001,23,00010111
85,01010101,67,01000011,152,10011000
30,00011110,23,00010111,53,00110101
81,01010001,10,00001010,91,01011011
47,00101111,125,01111101,172,10101100
55,00110111,48,00110000,103,01100111
6,00000110,70,01000110,76,01001100
21,00010101,35,00100011,56,00111000
107,01101011,27,00011011,134,10000110
16,00010000,38,00100110,54,00110110
36,00100100,7,00000111,43,00101011
14,00001110,37,00100101,51,00110011
68,01000100,31,00011111,99,01100011
72,01001000,35,00100011,107,01101011
71,01000111,87,01010111,158,10011110
58,00111010,56,00111000,114,01110010
67,01000011,107,01101011,174,10101110
81,01010001,104,01101000,185,10111001
124,01111100,53,00110101,177,10110001
27,00011011,36,00100100,63,00111111
100,01100100,81,01010001,181,10110101
33,00100001,40,00101000,73,01001001
109,01101101,40,00101000,149,10010101
83,01010011,31,00011111,114,01110010
114,01110010,86,01010110,200,11001000
3,00000011,108,01101100,111,01101111
0,00000000,32,00100000,32,00100000
5,00000101,104,01101000,109,01101101
7,00000111,69,01000101,76,01001100
15,00001111,109,01101101,124,01111100
88,01011000,106,01101010,194,11000010
75,01001011,64,01000000,139,10001011
122,01111010,33,00100001,155,10011011
34,00100010,32,00100000,66,01000010
62,00111110,46,00101110,108,01101100
56,00111000,66,01000010,122,01111010
56,00111000,31,00011111,87,01010111
80,01010000,70,01000110,150,10010110
10,00001010,22,00010110,32,00100000
54,00110110,14,00001110,68,01000100
35,00100011,52,00110100,87,01010111
67,01000011,106,01101010,173,10101101
48,00110000,51,00110011,99,01100011
102,01100110,106,01101010,208,11010000
58,00111010,86,01010110,144,10010000
45,00101101,45,00101101,90,01011010
118,01110110,101,01100101,219,11011011
121,01111001,80,01010000,201,11001001
97,01100001,20,00010100,117,01110101
126,01111110,39,00100111,165,10100101
98,01100010,42,00101010,140,10001100
61,00111101,54,00110110,115,01110011
96,01100000,97,01100001,193,11000001
113,01110001,48,00110000,161,10100001
49,00110001,95,01011111,144,10010000
85,01010101,0,00000000,85,01010101
22,00010110,63,00111111,85,01010101
81,01010001,64,01000000,145,10010001
37,00100101,124,01111100,161,10100001
45,00101101,118,01110110,163,10100011
47,00101111,8,00001000,55,00110111
118,01110110,48,00110000,166,10100110
41,00101001,33,00100001,74,01001010
119,01110111,85,01010101,204,11001100
101,01100101,96,01100000,197,11000101
80,01010000,17,00010001,97,01100001
26,00011010,5,00000101,31,00011111
43,00101011,22,00010110,65,01000001
68,01000100,56,00111000,124,01111100
73,01001001,85,01010101,158,10011110
43,00101011,21,00010101,64,01000000
63,00111111,56,00111000,119,01110111
25,00011001,15,00001111,40,00101000
33,00100001,114,01110010,147,10010011
88,01011000,69,01000101,157,10011101
62,00111110,70,01000110,132,10000100
55,00110111,13,00001101,68,01000100
91,01011011,12,00001100,103,01100111
2,00000010,84,01010100,86,01010110
62,00111110,118,01110110,180,10110100
0,00000000,19,00010011,19,00010011
35,00100011,86,01010110,121,01111001
19,00010011,121,01111001,140,10001100
123,01111011,1,00000001,124,01111100
30,00011110,119,01110111,149,10010101
109,01101101,99,01100011,208,11010000
60,00111100,76,01001100,136,10001000
115,01110011,115,01110011,230,11100110
63,00111111,25,00011001,88,01011000
49,00110001,17,00010001,66,01000010
80,01010000,15,00001111,95,01011111
118,01110110,25,00011001,143,10001111
79,01001111,57,00111001,136,10001000
127,01111111,40,00101000,167,10100111
27,00011011,10,00001010,37,00100101
8,00001000,113,01110001,121,01111001
88,01011000,126,01111110,214,11010110
20,00010100,108,01101100,128,10000000
79,01001111,94,01011110,173,10101101
51,00110011,89,01011001,140,10001100
100,01100100,56,00111000,156,10011100
126,01111110,9,00001001,135,10000111
110,01101110,95,01011111,205,11001101
35,00100011,73,01001001,108,01101100
9,00001001,16,00010000,25,00011001
103,01100111,13,00001101,116,01110100
97,01100001,112,01110000,209,11010001
40,00101000,97,01100001,137,10001001
111,01101111,53,00110101,164,10100100
107,01101011,45,00101101,152,10011000
19,00010011,122,01111010,141,10001101
12,00001100,9,00001001,21,00010101
41,00101001,16,00010000,57,00111001
35,00100011,69,01000101,104,01101000
101,01100101,33,00100001,134,10000110
35,00100011,69,01000101,104,01101000
90,01011010,93,01011101,183,10110111
49,00110001,32,00100000,81,01010001
123,01111011,46,00101110,169,10101001
76,01001100,35,00100011,111,01101111
107,01101011,45,00101101,152,10011000
4,00000100,123,01111011,127,01111111
106,01101010,5,00000101,111,01101111
41,00101001,89,01011001,130,10000010
89,01011001,54,00110110,143,10001111
53,00110101,3,00000011,56,00111000
44,00101100,27,00011011,71,01000111
89,01011001,44,00101100,133,10000101
49,00110001,41,00101001,90,01011010
82,01010010,74,01001010,156,10011100
59,00111011,90,01011010,149,10010101
84,01010100,96,01100000,180,10110100
12,00001100,81,01010001,93,01011101
93,01011101,73,01001001,166,10100110
69,01000101,66,01000010,135,10000111
65,01000001,56,00111000,121,01111001
99,01100011,19,00010011,118,01110110
103,01100111,20,00010100,123,01111011
127,01111111,37,00100101,164,10100100
118,01110110,11,00001011,129,10000001
18,00010010,119,01110111,137,10001001
34,00100010,54,00110110,88,01011000
25,00011001,82,01010010,107,01101011
106,01101010,43,00101011,149,10010101
45,00101101,48,00110000,93,01011101
9,00001001,116,01110100,125,01111101
27,00011011,23,00010111,50,00110010
1,00000001,54,00110110,55,00110111
19,00010011,122,01111010,141,10001101
6,00000110,28,00011100,34,00100010
92,01011100,93,01011101,185,10111001
95,01011111,80,01010000,175,10101111
49,00110001,101,01100101,150,10010110
111,01101111,103,01100111,214,11010110
100,01100100,43,00101011,143,10001111
31,00011111,65,01000001,96,01100000
122,01111010,24,00011000,146,10010010
34,00100010,125,01111101,159,10011111
100,01100100,42,00101010,142,10001110
75,01001011,91,01011011,166,10100110
113,01110001,95,01011111,208,11010000
40,00101000,0,00000000,40,00101000
67,01000011,66,01000010,133,10000101
66,01000010,45,00101101,111,01101111
81,01010001,12,00001100,93,01011101
116,01110100,103,01100111,219,11011011
105,01101001,87,01010111,192,11000000
6,00000110,86,01010110,92,01011100
60,00111100,127,01111111,187,10111011
51,00110011,56,00111000,107,01101011
78,01001110,45,00101101,123,01111011
64,01000000,124,01111100,188,10111100
20,00010100,36,00100100,56,00111000
96,01100000,100,01100100,196,11000100
18,00010010,50,00110010,68,01000100
35,00100011,25,00011001,60,00111100
94,01011110,95,01011111,189,10111101
126,01111110,59,00111011,185,10111001
125,01111101,15,00001111,140,10001100
88,01011000,22,00010110,110,01101110
66,01000010,23,00010111,89,01011001
33,00100001,117,01110101,150,10010110
106,01101010,116,01110100,222,11011110
72,01001000,105,01101001,177,10110001
47,00101111,59,00111011,106,01101010
109,01101101,56,00111000,165,10100101
79,01001111,19,00010011,98,01100010
78,01001110,38,00100110,116,01110100
37,00100101,35,00100011,72,01001000
11,00001011,102,01100110,113,01110001
28,00011100,99,01100011,127,01111111
42,00101010,95,01011111,137,10001001
45,00101101,81,01010001,126,01111110
41,00101001,78,01001110,119,01110111
40,00101000,114,01110010,154,10011010
35,00100011,62,00111110,97,01100001
37,00100101,95,01011111,132,10000100
55,00110111,34,00100010,89,01011001
110,01101110,31,00011111,141,10001101
83,01010011,19,00010011,102,01100110
57,00111001,101,01100101,158,10011110
23,00010111,76,01001100,99,01100011
110,01101110,80,01010000,190,10111110
97,01100001,55,00110111,152,10011000
30,00011110,91,01011011,121,01111001
120,01111000,102,01100110,222,11011110
3,00000011,86,01010110,89,01011001
1,00000001,14,00001110,15,00001111
27,00011011,0,00000000,27,00011011
107,01101011,9,00001001,116,01110100
35,00100011,78,01001110,113,01110001
32,00100000,58,00111010,90,01011010
26,00011010,12,00001100,38,00100110
52,00110100,57,00111001,109,01101101
45,00101101,78,01001110,123,01111011
19,00010011,93,01011101,112,01110000
115,01110011,118,01110110,233,11101001
123,01111011,81,01010001,204,11001100
70,01000110,111,01101111,181,10110101
33,00100001,77,01001101,110,01101110
86,01010110,43,00101011,129,10000001
0,00000000,57,00111001,57,00111001
22,00010110,110,01101110,132,10000100
14,00001110,100,01100100,114,01110010
120,01111000,69,01000101,189,10111101
10,00001010,67,01000011,77,01001101
4,00000100,52,00110100,56,00111000
60,00111100,52,00110100,112,01110000
63,00111111,94,01011110,157,10011101
5,00000101,11,00001011,16,00010000
60,00111100,13,00001101,73,01001001
12,00001100,7,00000111,19,00010011
56,00111000,5,00000101,61,00111101
57,00111001,10,00001010,67,01000011
30,00011110,3,00000011,33,00100001
98,01100010,122,01111010,220,11011100
61,00111101,1,00000001,62,00111110
43,00101011,16,00010000,59,00111011
39,00100111,17,00010001,56,00111000
52,00110100,110,01101110,162,10100010
52,00110100,122,01111010,174,10101110
112,01110000,7,00000111,119,01110111
18,00010010,21,00010101,39,00100111
22,00010110,30,00011110,52,00110100
68,01000100,95,01011111,163,10100011
3,00000011,49,00110001,52,00110100
112,01110000,9,00001001,121,01111001
9,00001001,34,00100010,43,00101011
102,01100110,119,01110111,221,11011101
94,01011110,76,01001100,170,10101010
48,00110000,49,00110001,97,01100001
8,00001000,127,01111111,135,10000111
119,01110111,110,01101110,229,11100101
24,00011000,36,00100100,60,00111100
119,01110111,9,00001001,128,10000000
6,00000110,8,00001000,14,00001110
120,01111000,81,01010001,201,11001001
73,01001001,57,00111001,130,10000010
122,01111010,1,00000001,123,01111011
36,00100100,0,00000000,36,00100100
58,00111010,41,00101001,99,01100011
78,01001110,54,00110110,132,10000100
91,01011011,26,00011010,117,01110101
34,00100010,69,01000101,103,01100111
126,01111110,7,00000111,133,10000101
114,01110010,82,01010010,196,11000100
120,01111000,15,00001111,135,10000111
29,00011101,127,01111111,156,10011100
102,01100110,80,01010000,182,10110110
61,00111101,50,00110010,111,01101111
3,00000011,49,00110001,52,00110100
69,01000101,101,01100101,170,10101010
90,01011010,34,00100010,124,01111100
97,01100001,88,01011000,185,10111001
53,00110101,42,00101010,95,01011111
34,00100010,74,01001010,108,01101100
66,01000010,65,01000001,131,10000011
64,01000000,43,00101011,107,01101011
121,01111001,11,00001011,132,10000100
118,01110110,71,01000111,189,10111101
35,00100011,17,00010001,52,00110100
104,01101000,72,01001000,176,10110000
37,00100101,32,00100000,69,01000101
65,01000001,105,01101001,170,10101010
4,00000100,110,01101110,114,01110010
81,01010001,92,01011100,173,10101101
59,00111011,95,01011111,154,10011010
81,01010001,36,00100100,117,01110101
64,01000000,109,01101101,173,10101101
83,01010011,25,00011001,108,01101100
29,00011101,127,01111111,156,10011100
7,00000111,90,01011010,97,01100001
6,00000110,31,00011111,37,00100101
59,00111011,109,01101101,168,10101000
67,01000011,4,00000100,71,01000111
1,00000001,76,01001100,77,01001101
115,01110011,8,00001000,123,01111011
63,00111111,33,00100001,96,01100000
33,00100001,119,01110111,152,10011000
29,00011101,29,00011101,58,00111010
86,01010110,63,00111111,149,10010101
25,00011001,93,01011101,118,01110110
56,00111000,67,01000011,123,01111011
106,01101010,91,01011011,197,11000101
40,00101000,116,01110100,156,10011100
108,01101100,13,00001101,121,01111001
90,01011010,44,00101100,134,10000110
24,00011000,98,01100010,122,01111010
48,00110000,25,00011001,73,01001001
60,00111100,37,00100101,97,01100001
119,01110111,31,00011111,150,10010110
15,00001111,86,01010110,101,01100101
97,01100001,11,00001011,108,01101100
102,01100110,102,01100110,204,11001100
17,00010001,28,00011100,45,00101101
43,00101011,127,01111111,170,10101010
20,00010100,108,01101100,128,10000000
36,00100100,8,00001000,44,00101100
47,00101111,5,00000101,52,00110100
30,00011110,60,00111100,90,01011010
51,00110011,47,00101111,98,01100010
51,00110011,2,00000010,53,00110101
84,01010100,88,01011000,172,10101100
108,01101100,13,00001101,121,01111001
62,00111110,83,01010011,145,10010001
33,00100001,38,00100110,71,01000111
92,01011100,80,01010000,172,10101100
19,00010011,36,00100100,55,00110111
15,00001111,37,00100101,52,00110100
118,01110110,102,01100110,220,11011100
10,00001010,105,01101001,115,01110011
118,01110110,51,00110011,169,10101001
122,01111010,19,00010011,141,10001101
53,00110101,41,00101001,94,01011110
122,01111010,106,01101010,228,11100100
9,00001001,77,01001101,86,01010110
73,01001001,29,00011101,102,01100110
65,01000001,123,01111011,188,10111100
117,01110101,55,00110111,172,10101100
83,01010011,96,01100000,179,10110011
34,00100010,58,00111010,92,01011100
30,00011110,53,00110101,83,01010011
36,00100100,26,00011010,62,00111110
40,00101000,0,00000000,40,00101000
17,00010001,58,00111010,75,01001011
95,01011111,87,01010111,182,10110110
32,00100000,17,00010001,49,00110001
71,01000111,7,00000111,78,01001110
118,01110110,53,00110101,171,10101011
16,00010000,127,01111111,143,10001111
106,01101010,30,00011110,136,10001000
30,00011110,118,01110110,148,10010100
34,00100010,25,00011001,59,00111011
82,01010010,73,01001001,155,10011011
82,01010010,20,00010100,102,01100110
57,00111001,76,01001100,133,10000101
15,00001111,85,01010101,100,01100100
42,00101010,38,00100110,80,01010000
21,00010101,11,00001011,32,00100000
114,01110010,69,01000101,183,10110111
85,01010101,118,01110110,203,11001011
86,01010110,107,01101011,193,11000001
90,01011010,17,00010001,107,01101011
72,01001000,17,00010001,89,01011001
21,00010101,51,00110011,72,01001000
2,00000010,58,00111010,60,00111100
111,01101111,58,00111010,169,10101001
48,00110000,112,01110000,160,10100000
41,00101001,29,00011101,70,01000110
89,01011001,83,01010011,172,10101100
96,01100000,76,01001100,172,10101100
49,00110001,47,00101111,96,01100000
117,01110101,38,00100110,155,10011011
44,00101100,81,01010001,125,01111101
127,01111111,29,00011101,156,10011100
68,01000100,22,00010110,90,01011010
78,01001110,36,00100100,114,01110010
49,00110001,80,01010000,129,10000001
79,01001111,31,00011111,110,01101110
17,00010001,64,01000000,81,01010001
15,00001111,66,01000010,81,01010001
93,01011101,103,01100111,196,11000100
45,00101101,58,00111010,103,01100111
34,00100010,126,01111110,160,10100000
77,01001101,50,00110010,127,01111111
123,01111011,94,01011110,217,11011001
67,01000011,97,01100001,164,10100100
54,00110110,116,01110100,170,10101010
99,01100011,59,00111011,158,10011110
124,01111100,19,00010011,143,10001111
4,00000100,75,01001011,79,01001111
50,00110010,37,00100101,87,01010111
78,01001110,47,00101111,125,01111101
76,01001100,102,01100110,178,10110010
42,00101010,49,00110001,91,01011011
28,00011100,84,01010100,112,01110000
96,01100000,107,01101011,203,11001011
6,00000110,124,01111100,130,10000010
78,01001110,112,01110000,190,10111110
101,01100101,56,00111000,157,10011101
56,00111000,45,00101101,101,01100101
2,00000010,120,01111000,122,01111010
52,00110100,73,01001001,125,01111101
27,00011011,111,01101111,138,10001010
93,01011101,34,00100010,127,01111111
5,00000101,56,00111000,61,00111101
24,00011000,42,00101010,66,01000010
45,00101101,74,01001010,119,01110111
109,01101101,12,00001100,121,01111001
4,00000100,118,01110110,122,01111010
97,01100001,100,01100100,197,11000101
36,00100100,93,01011101,129,10000001
38,00100110,74,01001010,112,01110000
42,00101010,35,00100011,77,01001101
98,01100010,58,00111010,156,10011100
76,01001100,21,00010101,97,01100001
70,01000110,95,01011111,165,10100101
12,00001100,42,00101010,54,00110110
66,01000010,51,00110011,117,01110101
23,00010111,24,00011000,47,00101111
127,01111111,74,01001010,201,11001001
113,01110001,75,01001011,188,10111100
54,00110110,104,01101000,158,10011110
53,00110101,68,01000100,121,01111001
98,01100010,81,01010001,179,10110011
68,01000100,26,00011010,94,01011110
40,00101000,7,00000111,47,00101111
2,00000010,117,01110101,119,01110111
98,01100010,97,01100001,195,11000011
43,00101011,84,01010100,127,01111111
29,00011101,108,01101100,137,10001001
66,01000010,78,01001110,144,10010000
113,01110001,115,01110011,228,11100100
74,01001010,76,01001100,150,10010110
90,01011010,46,00101110,136,10001000
39,00100111,112,01110000,151,10010111
53,00110101,118,01110110,171,10101011
14,00001110,30,00011110,44,00101100
67,01000011,78,01001110,145,10010001
106,01101010,113,01110001,219,11011011
21,00010101,36,00100100,57,00111001
69,01000101,40,00101000,109,01101101
113,01110001,108,01101100,221,11011101
16,00010000,126,01111110,142,10001110
7,00000111,84,01010100,91,01011011
19,00010011,2,00000010,21,00010101
60,00111100,32,00100000,92,01011100
99,01100011,18,00010010,117,01110101
51,00110011,47,00101111,98,01100010
121,01111001,61,00111101,182,10110110
17,00010001,66,01000010,83,01010011
54,00110110,9,00001001,63,00111111
42,00101010,70,01000110,112,01110000
21,00010101,49,00110001,70,01000110
45,00101101,7,00000111,52,00110100
85,01010101,73,01001001,158,10011110
111,01101111,89,01011001,200,11001000
18,00010010,118,01110110,136,10001000
60,00111100,71,01000111,131,10000011
78,01001110,4,00000100,82,01010010
113,01110001,92,01011100,205,11001101
83,01010011,73,01001001,156,10011100
91,01011011,20,00010100,111,01101111
66,01000010,13,00001101,79,01001111
61,00111101,118,01110110,179,10110011
96,01100000,15,00001111,111,01101111
122,01111010,50,00110010,172,10101100
53,00110101,69,01000101,122,01111010
76,01001100,42,00101010,118,01110110
37,00100101,5,00000101,42,00101010
52,00110100,112,01110000,164,10100100
60,00111100,59,00111011,119,01110111
30,00011110,7,00000111,37,00100101
84,01010100,83,01010011,167,10100111
34,00100010,26,00011010,60,00111100
39,00100111,75,01001011,114,01110010
82,01010010,17,00010001,99,01100011
127,01111111,64,01000000,191,10111111
110,01101110,61,00111101,171,10101011
54,00110110,4,00000100,58,00111010
80,01010000,106,01101010,186,10111010
56,00111000,89,01011001,145,10010001
97,01100001,28,00011100,125,01111101
122,01111010,110,01101110,232,11101000
98,01100010,17,00010001,115,01110011
7,00000111,43,00101011,50,00110010
64,01000000,49,00110001,113,01110001
72,01001000,84,01010100,156,10011100
1,00000001,101,01100101,102,01100110
124,01111100,27,00011011,151,10010111
43,00101011,58,00111010,101,01100101
15,00001111,52,00110100,67,01000011
9,00001001,24,00011000,33,00100001
72,01001000,108,01101100,180,10110100
89,01011001,114,01110010,203,11001011
99,01100011,46,00101110,145,10010001
91,01011011,98,01100010,189,10111101
45,00101101,65,01000001,110,01101110
54,00110110,72,01001000,126,01111110
79,01001111,24,00011000,103,01100111
125,01111101,117,01110101,242,11110010
8,00001000,17,00010001,25,00011001
121,01111001,39,00100111,160,10100000
84,01010100,6,00000110,90,01011010
100,01100100,46,00101110,146,10010010
82,01010010,26,00011010,108,01101100
112,01110000,79,01001111,191,10111111
7,00000111,1,00000001,8,00001000
28,00011100,16,00010000,44,00101100
29,00011101,76,01001100,105,01101001
97,01100001,1,00000001,98,01100010
114,01110010,29,00011101,143,10001111
46,00101110,94,01011110,140,10001100
81,01010001,113,01110001,194,11000010
5,00000101,21,00010101,26,00011010
5,00000101,119,01110111,124,01111100
88,01011000,105,01101001,193,11000001
15,00001111,54,00110110,69,01000101
103,01100111,107,01101011,210,11010010
104,01101000,45,00101101,149,10010101
87,01010111,47,00101111,134,10000110
85,01010101,42,00101010,127,01111111
22,00010110,104,01101000,126,01111110
32,00100000,73,01001001,105,01101001
104,01101000,92,01011100,196,11000100
59,00111011,47,00101111,106,01101010
109,01101101,28,00011100,137,10001001
10,00001010,21,00010101,31,00011111
75,01001011,121,01111001,196,11000100
19,00010011,79,01001111,98,01100010
9,00001001,24,00011000,33,00100001
49,00110001,50,00110010,99,01100011
52,00110100,83,01010011,135,10000111
14,00001110,100,01100100,114,01110010
31,00011111,70,01000110,101,01100101
101,01100101,29,00011101,130,10000010
100,01100100,37,00100101,137,10001001
124,01111100,45,00101101,169,10101001
92,01011100,80,01010000,172,10101100
58,00111010,5,00000101,63,00111111
82,01010010,49,00110001,131,10000011
81,01010001,33,00100001,114,01110010
90,01011010,87,01010111,177,10110001
106,01101010,50,00110010,156,10011100
121,01111001,16,00010000,137,10001001
85,01010101,45,00101101,130,10000010
44,00101100,21,00010101,65,01000001
47,00101111,26,00011010,73,01001001
46,00101110,114,01110010,160,10100000
107,01101011,90,01011010,197,11000101
4,00000100,38,00100110,42,00101010
77,01001101,73,01001001,150,10010110
70,01000110,35,00100011,105,01101001
12,00001100,5,00000101,17,00010001
95,01011111,56,00111000,151,10010111
28,00011100,82,01010010,110,01101110
62,00111110,89,01011001,151,10010111
92,01011100,99,01100011,191,10111111
108,01101100,15,00001111,123,01111011
95,01011111,47,00101111,142,10001110
35,00100011,123,01111011,158,10011110
126,01111110,92,01011100,218,11011010
95,01011111,11,00001011,106,01101010
25,00011001,18,00010010,43,00101011
96,01100000,60,00111100,156,10011100
99,01100011,90,01011010,189,10111101
51,00110011,122,01111010,173,10101101
94,01011110,68,01000100,162,10100010
43,00101011,14,00001110,57,00111001
5,00000101,96,01100000,101,01100101
0,00000000,46,00101110,46,00101110
4,00000100,61,00111101,65,01000001
21,00010101,123,01111011,144,10010000
84,01010100,50,00110010,134,10000110
127,01111111,111,01101111,238,11101110
103,01100111,14,00001110,117,01110101
55,00110111,69,01000101,124,01111100
12,00001100,112,01110000,124,01111100
57,00111001,3,00000011,60,00111100
29,00011101,33,00100001,62,00111110
48,00110000,121,01111001,169,10101001
37,00100101,18,00010010,55,00110111
73,01001001,36,00100100,109,01101101
112,01110000,67,01000011,179,10110011
112,01110000,5,00000101,117,01110101
60,00111100,63,00111111,123,01111011
72,01001000,73,01001001,145,10010001
17,00010001,106,01101010,123,01111011
102,01100110,111,01101111,213,11010101
87,01010111,108,01101100,195,11000011
116,01110100,67,01000011,183,10110111
103,01100111,3,00000011,106,01101010
107,01101011,69,01000101,176,10110000
44,00101100,122,01111010,166,10100110
75,01001011,41,00101001,116,01110100
62,00111110,43,00101011,105,01101001
123,01111011,100,01100100,223,11011111
79,01001111,94,01011110,173,10101101
0,00000000,16,00010000,16,00010000
118,01110110,33,00100001,151,10010111
45,00101101,43,00101011,88,01011000
71,01000111,81,01010001,152,10011000
37,00100101,41,00101001,78,01001110
38,00100110,35,00100011,73,01001001
49,00110001,81,01010001,130,10000010
15,00001111,54,00110110,69,01000101
42,00101010,89,01011001,131,10000011
72,01001000,45,00101101,117,01110101
45,00101101,15,00001111,60,00111100
62,00111110,111,01101111,173,10101101
122,01111010,52,00110100,174,10101110
107,01101011,100,01100100,207,11001111
35,00100011,98,01100010,133,10000101
108,01101100,56,00111000,164,10100100
1,00000001,118,01110110,119,01110111
99,01100011,55,00110111,154,10011010
92,01011100,27,00011011,119,01110111
125,01111101,127,01111111,252,11111100
41,00101001,114,01110010,155,10011011
2,00000010,14,00001110,16,00010000
24,00011000,88,01011000,112,01110000
106,01101010,127,01111111,233,11101001
19,00010011,5,00000101,24,00011000
99,01100011,123,01111011,222,11011110
35,00100011,33,00100001,68,01000100
90,01011010,76,01001100,166,10100110
26,00011010,110,01101110,136,10001000
15,00001111,40,00101000,55,00110111
101,01100101,15,00001111,116,01110100
35,00100011,85,01010101,120,01111000
29,00011101,22,00010110,51,00110011
58,00111010,123,01111011,181,10110101
45,00101101,102,01100110,147,10010011
3,00000011,89,01011001,92,01011100
79,01001111,89,01011001,168,10101000
67,01000011,58,00111010,125,01111101
109,01101101,20,00010100,129,10000001
57,00111001,60,00111100,117,01110101
108,01101100,23,00010111,131,10000011
3,00000011,87,01010111,90,01011010
97,01100001,67,01000011,164,10100100
9,00001001,30,00011110,39,00100111
15,00001111,0,00000000,15,00001111
79,01001111,39,00100111,118,01110110
26,00011010,61,00111101,87,01010111
88,01011000,47,00101111,135,10000111
61,00111101,90,01011010,151,10010111
114,01110010,2,00000010,116,01110100
73,01001001,121,01111001,194,11000010
34,00100010,32,00100000,66,01000010
76,01001100,85,01010101,161,10100001
66,01000010,60,00111100,126,01111110
29,00011101,8,00001000,37,00100101
84,01010100,121,01111001,205,11001101
96,01100000,57,00111001,153,10011001
28,00011100,35,00100011,63,00111111
0,00000000,53,00110101,53,00110101
110,01101110,115,01110011,225,11100001
74,01001010,3,00000011,77,01001101
110,01101110,65,01000001,175,10101111
25,00011001,12,00001100,37,00100101
60,00111100,74,01001010,134,10000110
57,00111001,112,01110000,169,10101001
22,00010110,109,01101101,131,10000011
93,01011101,74,01001010,167,10100111
59,00111011,56,00111000,115,01110011
50,00110010,111,01101111,161,10100001
67,01000011,119,01110111,186,10111010
32,00100000,36,00100100,68,01000100
73,01001001,115,01110011,188,10111100
97,01100001,35,00100011,132,10000100
105,01101001,5,00000101,110,01101110
94,01011110,43,00101011,137,10001001
97,01100001,69,01000101,166,10100110
28,00011100,9,00001001,37,00100101
101,01100101,126,01111110,227,11100011
107,01101011,61,00111101,168,10101000
109,01101101,94,01011110,203,11001011
95,01011111,57,00111001,152,10011000
65,01000001,18,00010010,83,01010011
126,01111110,55,00110111,181,10110101
67,01000011,5,00000101,72,01001000
81,01010001,38,00100110,119,01110111
27,00011011,106,01101010,133,10000101
7,00000111,119,01110111,126,01111110
107,01101011,107,01101011,214,11010110
118,01110110,59,00111011,177,10110001
104,01101000,95,01011111,199,11000111
121,01111001,118,01110110,239,11101111
96,01100000,97,01100001,193,11000001
105,01101001,90,01011010,195,11000011
48,00110000,30,00011110,78,01001110
88,01011000,103,01100111,191,10111111
44,00101100,58,00111010,102,01100110
53,00110101,81,01010001,134,10000110
81,01010001,44,00101100,125,01111101
33,00100001,56,00111000,89,01011001
5,00000101,46,00101110,51,00110011
6,00000110,103,01100111,109,01101101
92,01011100,20,00010100,112,01110000
1,00000001,81,01010001,82,01010010
71,01000111,36,00100100,107,01101011
21,00010101,104,01101000,125,01111101
41,00101001,41,00101001,82,01010010
20,00010100,62,00111110,82,01010010
74,01001010,7,00000111,81,01010001
55,00110111,61,00111101,116,01110100
72,01001000,113,01110001,185,10111001
85,01010101,54,00110110,139,10001011
55,00110111,22,00010110,77,01001101
15,00001111,89,01011001,104,01101000
42,00101010,33,00100001,75,01001011
99,01100011,38,00100110,137,10001001
117,01110101,30,00011110,147,10010011
108,01101100,41,00101001,149,10010101
77,01001101,86,01010110,163,10100011
35,00100011,73,01001001,108,01101100
108,01101100,91,01011011,199,11000111
123,01111011,30,00011110,153,10011001
12,00001100,62,00111110,74,01001010
14,00001110,98,01100010,112,01110000
127,01111111,98,01100010,225,11100001
76,01001100,105,01101001,181,10110101
112,01110000,97,01100001,209,11010001
75,01001011,120,01111000,195,11000011
59,00111011,91,01011011,150,10010110
54,00110110,86,01010110,140,10001100
100,01100100,53,00110101,153,10011001
106,01101010,55,00110111,161,10100001
66,01000010,90,01011010,156,10011100
66,01000010,64,01000000,130,10000010
79,01001111,58,00111010,137,10001001
20,00010100,113,01110001,133,10000101
43,00101011,89,01011001,132,10000100
15,00001111,24,00011000,39,00100111
60,00111100,3,00000011,63,00111111
8,00001000,109,01101101,117,01110101
20,00010100,67,01000011,87,01010111
47,00101111,46,00101110,93,01011101
122,01111010,62,00111110,184,10111000
19,00010011,96,01100000,115,01110011
112,01110000,45,00101101,157,10011101
59,00111011,60,00111100,119,01110111
116,01110100,58,00111010,174,10101110
6,00000110,80,01010000,86,01010110
114,01110010,63,00111111,177,10110001
114,01110010,71,01000111,185,10111001
87,01010111,20,00010100,107,01101011
125,01111101,66,01000010,191,10111111
57,00111001,95,01011111,152,10011000
26,00011010,46,00101110,72,01001000
70,01000110,106,01101010,176,10110000
77,01001101,48,00110000,125,01111101
59,00111011,58,00111010,117,01110101
50,00110010,94,01011110,144,10010000
102,01100110,107,01101011,209,11010001
56,00111000,125,01111101,181,10110101
101,01100101,45,00101101,146,10010010
48,00110000,125,01111101,173,10101101
97,01100001,23,00010111,120,01111000
68,01000100,72,01001000,140,10001100
16,00010000,118,01110110,134,10000110
1,00000001,51,00110011,52,00110100
45,00101101,80,01010000,125,01111101
38,00100110,112,01110000,150,10010110
122,01111010,4,00000100,126,01111110
115,01110011,26,00011010,141,10001101
108,01101100,75,01001011,183,10110111
5,00000101,116,01110100,121,01111001
38,00100110,107,01101011,145,10010001
30,00011110,24,00011000,54,00110110
75,01001011,45,00101101,120,01111000
17,00010001,101,01100101,118,01110110
69,01000101,55,00110111,124,01111100
62,00111110,90,01011010,152,10011000
25,00011001,13,00001101,38,00100110
20,00010100,125,01111101,145,10010001
4,00000100,79,01001111,83,01010011
121,01111001,35,00100011,156,10011100
58,00111010,61,00111101,119,01110111
40,00101000,2,00000010,42,00101010
71,01000111,74,01001010,145,10010001
91,01011011,13,00001101,104,01101000
12,00001100,99,01100011,111,01101111
75,01001011,64,01000000,139,10001011
36,00100100,30,00011110,66,01000010
6,00000110,125,01111101,131,10000011
95,01011111,124,01111100,219,11011011
112,01110000,106,01101010,218,11011010
127,01111111,118,01110110,245,11110101
116,01110100,103,01100111,219,11011011
1,00000001,17,00010001,18,00010010
41,00101001,98,01100010,139,10001011
1,00000001,38,00100110,39,00100111
80,01010000,12,00001100,92,01011100
64,01000000,52,00110100,116,01110100
86,01010110,32,00100000,118,01110110
80,01010000,27,00011011,107,01101011
117,01110101,34,00100010,151,10010111
24,00011000,98,01100010,122,01111010
2,00000010,30,00011110,32,00100000
127,01111111,30,00011110,157,10011101
69,01000101,63,00111111,132,10000100
123,01111011,112,01110000,235,11101011
88,01011000,6,00000110,94,01011110
77,01001101,17,00010001,94,01011110
37,00100101,82,01010010,119,01110111
19,00010011,66,01000010,85,01010101
56,00111000,23,00010111,79,01001111
17,00010001,96,01100000,113,01110001
60,00111100,33,00100001,93,01011101
107,01101011,51,00110011,158,10011110
18,00010010,42,00101010,60,00111100
97,01100001,72,01001000,169,10101001
41,00101001,76,01001100,117,01110101
109,01101101,1,00000001,110,01101110
93,01011101,57,00111001,150,10010110
110,01101110,125,01111101,235,11101011
76,01001100,64,01000000,140,10001100
60,00111100,33,00100001,93,01011101
90,01011010,43,00101011,133,10000101
39,00100111,56,00111000,95,01011111
94,01011110,23,00010111,117,01110101
104,01101000,22,00010110,126,01111110
76,01001100,66,01000010,142,10001110
89,01011001,58,00111010,147,10010011
124,01111100,16,00010000,140,10001100
97,01100001,84,01010100,181,10110101
51,00110011,59,00111011,110,01101110
115,01110011,78,01001110,193,11000001
5,00000101,95,01011111,100,01100100
47,00101111,16,00010000,63,00111111
0,00000000,47,00101111,47,00101111
122,01111010,110,01101110,232,11101000
22,00010110,82,01010010,104,01101000
99,01100011,28,00011100,127,01111111
75,01001011,38,00100110,113,01110001
73,01001001,1,00000001,74,01001010
15,00001111,99,01100011,114,01110010
20,00010100,90,01011010,110,01101110
123,01111011,44,00101100,167,10100111
12,00001100,111,01101111,123,01111011
105,01101001,42,00101010,147,10010011
79,01001111,52,00110100,131,10000011
123,01111011,69,01000101,192,11000000
85,01010101,28,00011100,113,01110001
38,00100110,7,00000111,45,00101101
19,00010011,6,00000110,25,00011001
76,01001100,9,00001001,85,01010101
26,00011010,20,00010100,46,00101110
102,01100110,36,00100100,138,10001010
118,01110110,31,00011111,149,10010101
41,00101001,84,01010100,125,01111101
16,00010000,32,00100000,48,00110000
91,01011011,76,01001100,167,10100111
31,00011111,47,00101111,78,01001110
115,01110011,102,01100110,217,11011001
36,00100100,113,01110001,149,10010101
23,00010111,18,00010010,41,00101001
26,00011010,51,00110011,77,01001101
48,00110000,127,01111111,175,10101111
77,01001101,117,01110101,194,11000010
30,00011110,119,01110111,149,10010101
116,01110100,79,01001111,195,11000011
66,01000010,75,01001011,141,10001101
4,00000100,71,01000111,75,01001011
81,01010001,83,01010011,164,10100100
64,01000000,28,00011100,92,01011100
100,01100100,55,00110111,155,10011011
103,01100111,62,00111110,165,10100101
110,01101110,58,00111010,168,10101000
79,01001111,98,01100010,177,10110001
70,01000110,45,00101101,115,01110011
35,00100011,53,00110101,88,01011000
8,00001000,77,01001101,85,01010101
15,00001111,79,01001111,94,01011110
114,01110010,108,01101100,222,11011110
125,01111101,91,01011011,216,11011000
19,00010011,64,01000000,83,01010011
74,01001010,10,00001010,84,01010100
53,00110101,110,01101110,163,10100011
96,01100000,4,00000100,100,01100100
67,01000011,40,00101000,107,01101011
9,00001001,55,00110111,64,01000000
0,00000000,35,00100011,35,00100011
28,00011100,94,01011110,122,01111010
57,00111001,81,01010001,138,10001010
69,01000101,97,01100001,166,10100110
118,01110110,107,01101011,225,11100001
45,00101101,5,00000101,50,00110010
24,00011000,111,01101111,135,10000111
85,01010101,13,00001101,98,01100010
127,01111111,23,00010111,150,10010110
34,00100010,93,01011101,127,01111111
75,01001011,75,01001011,150,10010110
85,01010101,91,01011011,176,10110000
58,00111010,126,01111110,184,10111000
45,00101101,107,01101011,152,10011000
66,01000010,41,00101001,107,01101011
7,00000111,15,00001111,22,00010110
0,00000000,94,01011110,94,01011110
47,00101111,123,01111011,170,10101010
42,00101010,102,01100110,144,10010000
113,01110001,76,01001100,189,10111101
80,01010000,29,00011101,109,01101101
87,01010111,71,01000111,158,10011110
110,01101110,68,01000100,178,10110010
31,00011111,32,00100000,63,00111111
3,00000011,101,01100101,104,01101000
14,00001110,66,01000010,80,01010000
16,00010000,31,00011111,47,00101111
126,01111110,115,01110011,241,11110001
23,00010111,89,01011001,112,01110000
27,00011011,93,01011101,120,01111000
23,00010111,76,01001100,99,01100011
101,01100101,40,00101000,141,10001101
103,01100111,50,00110010,153,10011001
12,00001100,57,00111001,69,01000101
35,00100011,64,01000000,99,01100011
94,01011110,17,00010001,111,01101111
114,01110010,55,00110111,169,10101001
28,00011100,48,00110000,76,01001100
73,01001001,2,00000010,75,01001011
35,00100011,10,00001010,45,00101101
28,00011100,41,00101001,69,01000101
2,00000010,72,01001000,74,01001010
108,01101100,80,01010000,188,10111100
26,00011010,82,01010010,108,01101100
100,01100100,20,00010100,120,01111000
59,00111011,106,01101010,165,10100101
77,01001101,13,00001101,90,01011010
14,00001110,122,01111010,136,10001000
96,01100000,53,00110101,149,10010101
11,00001011,111,01101111,122,01111010
48,00110000,58,00111010,106,01101010
8,00001000,113,01110001,121,01111001
108,01101100,40,00101000,148,10010100
48,00110000,34,00100010,82,01010010
37,00100101,99,01100011,136,10001000
109,01101101,40,00101000,149,10010101
121,01111001,10,00001010,131,10000011
47,00101111,123,01111011,170,10101010
23,00010111,56,00111000,79,01001111
38,00100110,4,00000100,42,00101010
52,00110100,62,00111110,114,01110010
124,01111100,119,01110111,243,11110011
47,00101111,26,00011010,73,01001001
71,01000111,116,01110100,187,10111011
115,01110011,90,01011010,205,11001101
25,00011001,41,00101001,66,01000010
20,00010100,125,01111101,145,10010001
31,00011111,110,01101110,141,10001101
119,01110111,54,00110110,173,10101101
2,00000010,62,00111110,64,01000000
55,00110111,4,00000100,59,00111011
94,01011110,28,00011100,122,01111010
13,00001101,25,00011001,38,00100110
93,01011101,113,01110001,206,11001110
82,01010010,22,00010110,104,01101000
4,00000100,50,00110010,54,00110110
119,01110111,123,01111011,242,11110010
115,01110011,109,01101101,224,11100000
96,01100000,39,00100111,135,10000111
17,00010001,66,01000010,83,01010011
92,01011100,56,00111000,148,10010100
27,00011011,78,01001110,105,01101001
84,01010100,32,00100000,116,01110100
119,01110111,24,00011000,143,10001111
75,01001011,78,01001110,153,10011001
14,00001110,109,01101101,123,01111011
108,01101100,36,00100100,144,10010000
8,00001000,45,00101101,53,00110101
117,01110101,89,01011001,206,11001110
113,01110001,49,00110001,162,10100010
87,01010111,40,00101000,127,01111111
9,00001001,51,00110011,60,00111100
104,01101000,45,00101101,149,10010101
89,01011001,62,00111110,151,10010111
10,00001010,116,01110100,126,01111110
79,01001111,104,01101000,183,10110111
39,00100111,38,00100110,77,01001101
124,01111100,4,00000100,128,10000000
127,01111111,33,00100001,160,10100000
74,01001010,121,01111001,195,11000011
53,00110101,34,00100010,87,01010111
66,01000010,47,00101111,113,01110001
61,00111101,68,01000100,129,10000001
100,01100100,34,00100010,134,10000110
117,01110101,34,00100010,151,10010111
18,00010010,108,01101100,126,01111110
5,00000101,117,01110101,122,01111010
27,00011011,19,00010011,46,00101110
117,01110101,80,01010000,197,11000101
99,01100011,41,00101001,140,10001100
38,00100110,92,01011100,130,10000010
11,00001011,122,01111010,133,10000101
111,01101111,122,01111010,233,11101001
57,00111001,64,01000000,121,01111001
18,00010010,37,00100101,55,00110111
38,00100110,14,00001110,52,00110100
75,01001011,37,00100101,112,01110000
10,00001010,87,01010111,97,01100001
7,00000111,87,01010111,94,01011110
88,01011000,17,00010001,105,01101001
16,00010000,120,01111000,136,10001000
28,00011100,114,01110010,142,10001110
55,00110111,21,00010101,76,01001100
82,01010010,11,00001011,93,01011101
88,01011000,89,01011001,177,10110001
90,01011010,102,01100110,192,11000000
110,01101110,15,00001111,125,01111101
122,01111010,119,01110111,241,11110001
37,00100101,97,01100001,134,10000110
21,00010101,77,01001101,98,01100010
94,01011110,84,01010100,178,10110010
94,01011110,27,00011011,121,01111001
98,01100010,93,01011101,191,10111111
2,00000010,11,00001011,13,00001101
91,01011011,34,00100010,125,01111101
118,01110110,123,01111011,241,11110001
123,01111011,65,01000001,188,10111100
115,01110011,73,01001001,188,10111100
86,01010110,23,00010111,109,01101101
88,01011000,67,01000011,155,10011011
61,00111101,97,01100001,158,10011110
88,01011000,127,01111111,215,11010111
27,00011011,115,01110011,142,10001110
76,01001100,126,01111110,202,11001010
103,01100111,90,01011010,193,11000001
101,01100101,116,01110100,217,11011001
31,00011111,38,00100110,69,01000101
59,00111011,28,00011100,87,01010111
36,00100100,83,01010011,119,01110111
69,01000101,47,00101111,116,01110100
7,00000111,15,00001111,22,00010110
34,00100010,13,00001101,47,00101111
88,01011000,53,00110101,141,10001101
119,01110111,111,01101111,230,11100110
43,00101011,83,01010011,126,01111110
57,00111001,48,00110000,105,01101001
11,00001011,98,01100010,109,01101101
88,01011000,21,00010101,109,01101101
113,01110001,86,01010110,199,11000111
56,00111000,97,01100001,153,10011001
115,01110011,39,00100111,154,10011010
43,00101011,96,01100000,139,10001011
18,00010010,124,01111100,142,10001110
16,00010000,5,00000101,21,00010101
31,00011111,20,00010100,51,00110011
27,00011011,106,01101010,133,10000101
85,01010101,70,01000110,155,10011011
23,00010111,112,01110000,135,10000111
103,01100111,55,00110111,158,10011110
31,00011111,52,00110100,83,01010011
125,01111101,8,00001000,133,10000101
56,00111000,42,00101010,98,01100010
116,01110100,127,01111111,243,11110011
99,01100011,91,01011011,190,10111110
99,01100011,1,00000001,100,01100100
121,01111001,38,00100110,159,10011111
98,01100010,92,01011100,190,10111110
100,01100100,22,00010110,122,01111010
9,00001001,31,00011111,40,00101000
110,01101110,121,01111001,231,11100111
89,01011001,2,00000010,91,01011011
5,00000101,95,01011111,100,01100100
29,00011101,104,01101000,133,10000101
88,01011000,117,01110101,205,11001101
48,00110000,94,01011110,142,10001110
84,01010100,77,01001101,161,10100001
56,00111000,98,01100010,154,10011010
25,00011001,44,00101100,69,01000101
5,00000101,96,01100000,101,01100101
105,01101001,4,00000100,109,01101101
35,00100011,87,01010111,122,01111010
106,01101010,122,01111010,228,11100100
2,00000010,82,01010010,84,01010100
10,00001010,48,00110000,58,00111010
48,00110000,27,00011011,75,01001011
28,00011100,120,01111000,148,10010100
86,01010110,114,01110010,200,11001000
101,01100101,97,01100001,198,11000110
119,01110111,9,00001001,128,10000000
110,01101110,20,00010100,130,10000010
107,01101011,27,00011011,134,10000110
112,01110000,99,01100011,211,11010011
5,00000101,91,01011011,96,01100000
54,00110110,74,01001010,128,10000000
101,01100101,37,00100101,138,10001010
33,00100001,112,01110000,145,10010001
23,00010111,115,01110011,138,10001010
99,01100011,49,00110001,148,10010100
100,01100100,62,00111110,162,10100010
72,01001000,117,01110101,189,10111101
11,00001011,120,01111000,131,10000011
118,01110110,77,01001101,195,11000011
119,01110111,13,00001101,132,10000100
110,01101110,21,00010101,131,10000011
95,01011111,16,00010000,111,01101111
52,00110100,126,01111110,178,10110010
67,01000011,45,00101101,112,01110000
88,01011000,107,01101011,195,11000011
37,00100101,118,01110110,155,10011011
85,01010101,85,01010101,170,10101010
11,00001011,42,00101010,53,00110101
124,01111100,47,00101111,171,10101011
48,00110000,13,00001101,61,00111101
32,00100000,71,01000111,103,01100111
75,01001011,103,01100111,178,10110010
104,01101000,66,01000010,170,10101010
46,00101110,74,01001010,120,01111000
49,00110001,87,01010111,136,10001000
95,01011111,38,00100110,133,10000101
32,00100000,47,00101111,79,01001111
94,01011110,64,01000000,158,10011110
118,01110110,53,00110101,171,10101011
76,01001100,21,00010101,97,01100001
11,00001011,28,00011100,39,00100111
74,01001010,23,00010111,97,01100001
13,00001101,0,00000000,13,00001101
13,00001101,16,00010000,29,00011101
28,00011100,21,00010101,49,00110001
76,01001100,37,00100101,113,01110001
81,01010001,101,01100101,182,10110110
33,00100001,46,00101110,79,01001111
69,01000101,73,01001001,142,10001110
87,01010111,84,01010100,171,10101011
91,01011011,93,01011101,184,10111000
87,01010111,28,00011100,115,01110011
125,01111101,34,00100010,159,10011111
0,00000000,19,00010011,19,00010011
40,00101000,27,00011011,67,01000011
43,00101011,98,01100010,141,10001101
45,00101101,78,01001110,123,01111011
26,00011010,114,01110010,140,10001100
16,00010000,26,00011010,42,00101010
3,00000011,32,00100000,35,00100011
71,01000111,35,00100011,106,01101010
55,00110111,97,01100001,152,10011000
117,01110101,117,01110101,234,11101010
87,01010111,48,00110000,135,10000111
99,01100011,67,01000011,166,10100110
38,00100110,64,01000000,102,01100110
49,00110001,55,00110111,104,01101000
102,01100110,40,00101000,142,10001110
122,01111010,71,01000111,193,11000001
26,00011010,18,00010010,44,00101100
12,00001100,6,00000110,18,00010010
97,01100001,8,00001000,105,01101001
36,00100100,89,01011001,125,01111101
5,00000101,91,01011011,96,01100000
24,00011000,82,01010010,106,01101010
57,00111001,123,01111011,180,10110100
31,00011111,97,01100001,128,10000000
51,00110011,97,01100001,148,10010100
26,00011010,95,01011111,121,01111001
14,00001110,12,00001100,26,00011010
126,01111110,35,00100011,161,10100001
24,00011000,72,01001000,96,01100000
119,01110111,9,00001001,128,10000000
52,00110100,103,01100111,155,10011011
75,01001011,76,01001100,151,10010111
17,00010001,99,01100011,116,01110100
96,01100000,0,00000000,96,01100000
110,01101110,11,00001011,121,01111001
83,01010011,59,00111011,142,10001110
88,01011000,11,00001011,99,01100011
126,01111110,115,01110011,241,11110001
92,01011100,81,01010001,173,10101101
4,00000100,57,00111001,61,00111101
22,00010110,86,01010110,108,01101100
54,00110110,1,00000001,55,00110111
109,01101101,1,00000001,110,01101110
8,00001000,23,00010111,31,00011111
111,01101111,80,01010000,191,10111111
102,01100110,86,01010110,188,10111100
75,01001011,63,00111111,138,10001010
108,01101100,92,01011100,200,11001000
35,00100011,76,01001100,111,01101111
67,01000011,106,01101010,173,10101101
76,01001100,56,00111000,132,10000100
2,00000010,11,00001011,13,00001101
72,01001000,124,01111100,196,11000100
65,01000001,19,00010011,84,01010100
100,01100100,116,01110100,216,11011000
30,00011110,83,01010011,113,01110001
19,00010011,99,01100011,118,01110110
116,01110100,71,01000111,187,10111011
10,00001010,109,01101101,119,01110111
121,01111001,28,00011100,149,10010101
35,00100011,50,00110010,85,01010101
111,01101111,49,00110001,160,10100000
50,00110010,3,00000011,53,00110101
73,01001001,106,01101010,179,10110011
82,01010010,127,01111111,209,11010001
54,00110110,69,01000101,123,01111011
26,00011010,61,00111101,87,01010111
55,00110111,79,01001111,134,10000110
125,01111101,22,00010110,147,10010011
119,01110111,13,00001101,132,10000100
126,01111110,81,01010001,207,11001111
43,00101011,57,00111001,100,01100100
34,00100010,14,00001110,48,00110000
10,00001010,67,01000011,77,01001101
72,01001000,91,01011011,163,10100011
65,01000001,103,01100111,168,10101000
50,00110010,108,01101100,158,10011110
18,00010010,55,00110111,73,01001001
126,01111110,72,01001000,198,11000110
0,00000000,115,01110011,115,01110011
76,01001100,125,01111101,201,11001001
127,01111111,41,00101001,168,10101000
75,01001011,10,00001010,85,01010101
44,00101100,106,01101010,150,10010110
6,00000110,86,01010110,92,01011100
108,01101100,71,01000111,179,10110011
12,00001100,84,01010100,96,01100000
41,00101001,93,01011101,134,10000110
100,01100100,3,00000011,103,01100111
120,01111000,108,01101100,228,11100100
7,00000111,77,01001101,84,01010100
57,00111001,18,00010010,75,01001011
60,00111100,88,01011000,148,10010100
121,01111001,97,01100001,218,11011010
98,01100010,108,01101100,206,11001110
85,01010101,35,00100011,120,01111000
92,01011100,113,01110001,205,11001101
127,01111111,102,01100110,229,11100101
108,01101100,27,00011011,135,10000111
94,01011110,91,01011011,185,10111001
65,01000001,8,00001000,73,01001001
117,01110101,89,01011001,206,11001110
29,00011101,15,00001111,44,00101100
3,00000011,51,00110011,54,00110110
23,00010111,95,01011111,118,01110110
118,01110110,100,01100100,218,11011010
21,00010101,85,01010101,106,01101010
66,01000010,115,01110011,181,10110101
95,01011111,72,01001000,167,10100111
69,01000101,57,00111001,126,01111110
51,00110011,12,00001100,63,00111111
100,01100100,10,00001010,110,01101110
57,00111001,102,01100110,159,10011111
59,00111011,50,00110010,109,01101101
104,01101000,75,01001011,179,10110011
42,00101010,127,01111111,169,10101001
29,00011101,101,01100101,130,10000010
53,00110101,40,00101000,93,01011101
44,00101100,73,01001001,117,01110101
41,00101001,88,01011000,129,10000001
43,00101011,39,00100111,82,01010010
97,01100001,73,01001001,170,10101010
6,00000110,88,01011000,94,01011110
23,00010111,40,00101000,63,00111111
5,00000101,14,00001110,19,00010011
124,01111100,87,01010111,211,11010011
16,00010000,40,00101000,56,00111000
26,00011010,14,00001110,40,00101000
75,01001011,58,00111010,133,10000101
79,01001111,104,01101000,183,10110111
15,00001111,60,00111100,75,01001011
19,00010011,122,01111010,141,10001101
82,01010010,62,00111110,144,10010000
63,00111111,123,01111011,186,10111010
79,01001111,5,00000101,84,01010100
71,01000111,71,01000111,142,10001110
22,00010110,48,00110000,70,01000110
83,01010011,14,00001110,97,01100001
2,00000010,121,01111001,123,01111011
107,01101011,79,01001111,186,10111010
20,00010100,10,00001010,30,00011110
85,01010101,106,01101010,191,10111111
41,00101001,49,00110001,90,01011010
57,00111001,49,00110001,106,01101010
112,01110000,29,00011101,141,10001101
107,01101011,68,01000100,175,10101111
36,00100100,74,01001010,110,01101110
64,01000000,18,00010010,82,01010010
44,00101100,3,00000011,47,00101111
48,00110000,88,01011000,136,10001000
28,00011100,34,00100010,62,00111110
107,01101011,72,01001000,179,10110011
122,01111010,56,00111000,178,10110010
37,00100101,106,01101010,143,10001111
95,01011111,105,01101001,200,11001000
114,01110010,12,00001100,126,01111110
43,00101011,38,00100110,81,01010001
48,00110000,90,01011010,138,10001010
4,00000100,38,00100110,42,00101010
79,01001111,27,00011011,106,01101010
117,01110101,10,00001010,127,01111111
106,01101010,7,00000111,113,01110001
54,00110110,88,01011000,142,10001110
33,00100001,96,01100000,129,10000001
57,00111001,62,00111110,119,01110111
123,01111011,88,01011000,211,11010011
84,01010100,94,01011110,178,10110010
4,00000100,53,00110101,57,00111001
12,00001100,30,00011110,42,00101010
46,00101110,20,00010100,66,01000010
97,01100001,58,00111010,155,10011011
51,00110011,5,00000101,56,00111000
60,00111100,83,01010011,143,10001111
7,00000111,46,00101110,53,00110101
88,01011000,9,00001001,97,01100001
49,00110001,17,00010001,66,01000010
98,01100010,14,00001110,112,01110000
66,01000010,103,01100111,169,10101001
9,00001001,58,00111010,67,01000011
27,00011011,75,01001011,102,01100110
59,00111011,107,01101011,166,10100110
47,00101111,117,01110101,164,10100100
47,00101111,86,01010110,133,10000101
32,00100000,104,01101000,136,10001000
105,01101001,53,00110101,158,10011110
4,00000100,29,00011101,33,00100001
37,00100101,42,00101010,79,01001111
98,01100010,111,01101111,209,11010001
102,01100110,21,00010101,123,01111011
22,00010110,54,00110110,76,01001100
62,00111110,17,00010001,79,01001111
114,01110010,3,00000011,117,01110101
18,00010010,69,01000101,87,01010111
41,00101001,34,00100010,75,01001011
9,00001001,114,01110010,123,01111011
115,01110011,92,01011100,207,11001111
32,00100000,29,00011101,61,00111101
96,01100000,95,01011111,191,10111111
123,01111011,74,01001010,197,11000101
9,00001001,21,00010101,30,00011110
61,00111101,58,00111010,119,01110111
55,00110111,99,01100011,154,10011010
121,01111001,126,01111110,247,11110111
92,01011100,9,00001001,101,01100101
48,00110000,42,00101010,90,01011010
92,01011100,69,01000101,161,10100001
68,01000100,17,00010001,85,01010101
48,00110000,112,01110000,160,10100000
64,01000000,52,00110100,116,01110100
121,01111001,4,00000100,125,01111101
48,00110000,127,01111111,175,10101111
8,00001000,103,01100111,111,01101111
49,00110001,88,01011000,137,10001001
28,00011100,57,00111001,85,01010101
44,00101100,91,01011011,135,10000111
107,01101011,38,00100110,145,10010001
68,01000100,90,01011010,158,10011110
24,00011000,75,01001011,99,01100011
44,00101100,25,00011001,69,01000101
54,00110110,52,00110100,106,01101010
87,01010111,91,01011011,178,10110010
48,00110000,63,00111111,111,01101111
20,00010100,19,00010011,39,00100111
60,00111100,116,01110100,176,10110000
11,00001011,90,01011010,101,01100101
41,00101001,41,00101001,82,01010010
6,00000110,97,01100001,103,01100111
13,00001101,115,01110011,128,10000000
2,00000010,45,00101101,47,00101111
72,01001000,29,00011101,101,01100101
85,01010101,112,01110000,197,11000101
95,01011111,54,00110110,149,10010101
55,00110111,72,01001000,127,01111111
50,00110010,47,00101111,97,01100001
56,00111000,102,01100110,158,10011110
123,01111011,84,01010100,207,11001111
24,00011000,92,01011100,116,01110100
46,00101110,111,01101111,157,10011101
106,01101010,14,00001110,120,01111000
21,00010101,89,01011001,110,01101110
84,01010100,55,00110111,139,10001011
124,01111100,96,01100000,220,11011100
84,01010100,104,01101000,188,10111100
33,00100001,12,00001100,45,00101101
97,01100001,71,01000111,168,10101000
9,00001001,88,01011000,97,01100001
14,00001110,87,01010111,101,01100101
101,01100101,5,00000101,106,01101010
46,00101110,105,01101001,151,10010111
110,01101110,4,00000100,114,01110010
12,00001100,88,01011000,100,01100100
81,01010001,78,01001110,159,10011111
55,00110111,78,01001110,133,10000101
81,01010001,94,01011110,175,10101111
9,00001001,37,00100101,46,00101110
1,00000001,51,00110011,52,00110100
64,01000000,111,01101111,175,10101111
114,01110010,26,00011010,140,10001100
11,00001011,39,00100111,50,00110010
41,00101001,84,01010100,125,01111101
25,00011001,109,01101101,134,10000110
33,00100001,114,01110010,147,10010011
51,00110011,118,01110110,169,10101001
120,01111000,21,00010101,141,10001101
125,01111101,54,00110110,179,10110011
79,01001111,97,01100001,176,10110000
112,01110000,0,00000000,112,01110000
11,00001011,92,01011100,103,01100111
33,00100001,122,01111010,155,10011011
10,00001010,13,00001101,23,00010111
85,01010101,10,00001010,95,01011111
103,01100111,39,00100111,142,10001110
32,00100000,100,01100100,132,10000100
68,01000100,35,00100011,103,01100111
72,01001000,87,01010111,159,10011111
87,01010111,77,01001101,164,10100100
100,01100100,82,01010010,182,10110110
63,00111111,46,00101110,109,01101101
98,01100010,82,01010010,180,10110100
20,00010100,26,00011010,46,00101110
28,00011100,12,00001100,40,00101000
17,00010001,2,00000010,19,00010011
116,01110100,36,00100100,152,10011000
74,01001010,34,00100010,108,01101100
39,00100111,10,00001010,49,00110001
51,00110011,2,00000010,53,00110101
65,01000001,23,00010111,88,01011000
0,00000000,124,01111100,124,01111100
74,01001010,123,01111011,197,11000101
68,01000100,20,00010100,88,01011000
57,00111001,5,00000101,62,00111110
107,01101011,100,01100100,207,11001111
121,01111001,110,01101110,231,11100111
3,00000011,109,01101101,112,01110000
13,00001101,94,01011110,107,01101011
43,00101011,2,00000010,45,00101101
123,01111011,33,00100001,156,10011100
123,01111011,27,00011011,150,10010110
5,00000101,51,00110011,56,00111000
77,01001101,37,00100101,114,01110010
23,00010111,15,00001111,38,00100110
74,01001010,92,01011100,166,10100110
35,00100011,24,00011000,59,00111011
94,01011110,61,00111101,155,10011011
53,00110101,127,01111111,180,10110100
108,01101100,87,01010111,195,11000011
8,00001000,29,00011101,37,00100101
94,01011110,99,01100011,193,11000001
74,01001010,110,01101110,184,10111000
25,00011001,5,00000101,30,00011110
109,01101101,5,00000101,114,01110010
100,01100100,30,00011110,130,10000010
3,00000011,120,01111000,123,01111011
11,00001011,57,00111001,68,01000100
27,00011011,104,01101000,131,10000011
0,00000000,91,01011011,91,01011011
11,00001011,36,00100100,47,00101111
66,01000010,21,00010101,87,01010111
73,01001001,94,01011110,167,10100111
58,00111010,126,01111110,184,10111000
27,00011011,18,00010010,45,00101101
117,01110101,110,01101110,227,11100011
49,00110001,122,01111010,171,10101011
57,00111001,88,01011000,145,10010001
40,00101000,51,00110011,91,01011011
22,00010110,114,01110010,136,10001000
29,00011101,53,00110101,82,01010010
40,00101000,45,00101101,85,01010101
50,00110010,53,00110101,103,01100111
80,01010000,103,01100111,183,10110111
11,00001011,32,00100000,43,00101011
104,01101000,57,00111001,161,10100001
127,01111111,27,00011011,154,10011010
12,00001100,78,01001110,90,01011010
50,00110010,60,00111100,110,01101110
77,01001101,62,00111110,139,10001011
52,00110100,65,01000001,117,01110101
60,00111100,31,00011111,91,01011011
112,01110000,49,00110001,161,10100001
73,01001001,125,01111101,198,11000110
105,01101001,14,00001110,119,01110111
79,01001111,11,00001011,90,01011010
68,01000100,33,00100001,101,01100101
109,01101101,56,00111000,165,10100101
120,01111000,41,00101001,161,10100001
27,00011011,50,00110010,77,01001101
95,01011111,17,00010001,112,01110000
15,00001111,38,00100110,53,00110101
2,00000010,85,01010101,87,01010111
35,00100011,17,00010001,52,00110100
39,00100111,94,01011110,133,10000101
63,00111111,121,01111001,184,10111000
120,01111000,49,00110001,169,10101001
9,00001001,25,00011001,34,00100010
29,00011101,112,01110000,141,10001101
66,01000010,112,01110000,178,10110010
0,00000000,49,00110001,49,00110001
89,01011001,111,01101111,200,11001000
5,00000101,84,01010100,89,01011001
13,00001101,37,00100101,50,00110010
84,01010100,107,01101011,191,10111111
30,00011110,60,00111100,90,01011010
57,00111001,123,01111011,180,10110100
2,00000010,37,00100101,39,00100111
52,00110100,22,00010110,74,01001010
93,01011101,84,01010100,177,10110001
65,01000001,41,00101001,106,01101010
120,01111000,86,01010110,206,11001110
54,00110110,71,01000111,125,01111101
38,00100110,16,00010000,54,00110110
52,00110100,92,01011100,144,10010000
51,00110011,109,01101101,160,10100000
87,01010111,28,00011100,115,01110011
46,00101110,9,00001001,55,00110111
41,00101001,27,00011011,68,01000100
15,00001111,26,00011010,41,00101001
79,01001111,114,01110010,193,11000001
110,01101110,121,01111001,231,11100111
14,00001110,102,01100110,116,01110100
16,00010000,29,00011101,45,00101101
61,00111101,82,01010010,143,10001111
6,00000110,120,01111000,126,01111110
55,00110111,65,01000001,120,01111000
81,01010001,0,00000000,81,01010001
30,00011110,49,00110001,79,01001111
116,01110100,62,00111110,178,10110010
1,00000001,124,01111100,125,01111101
75,01001011,31,00011111,106,01101010
32,00100000,74,01001010,106,01101010
3,00000011,61,00111101,64,01000000
88,01011000,122,01111010,210,11010010
12,00001100,26,00011010,38,00100110
4,00000100,41,00101001,45,00101101
49,00110001,78,01001110,127,01111111
20,00010100,59,00111011,79,01001111
42,00101010,14,00001110,56,00111000
54,00110110,4,00000100,58,00111010
59,00111011,50,00110010,109,01101101
87,01010111,123,01111011,210,11010010
116,01110100,10,00001010,126,01111110
114,01110010,11,00001011,125,01111101
85,01010101,57,00111001,142,10001110
66,01000010,125,01111101,191,10111111
62,00111110,11,00001011,73,01001001
127,01111111,73,01001001,200,11001000
54,00110110,53,00110101,107,01101011
56,00111000,30,00011110,86,01010110
107,01101011,58,00111010,165,10100101
40,00101000,55,00110111,95,01011111
108,01101100,95,01011111,203,11001011
88,01011000,8,00001000,96,01100000
80,01010000,81,01010001,161,10100001
93,01011101,93,01011101,186,10111010
15,00001111,57,00111001,72,01001000
121,01111001,7,00000111,128,10000000
24,00011000,74,01001010,98,01100010
53,00110101,50,00110010,103,01100111
72,01001000,126,01111110,198,11000110
40,00101000,74,01001010,114,01110010
39,00100111,99,01100011,138,10001010
22,00010110,127,01111111,149,10010101
44,00101100,48,00110000,92,01011100
53,00110101,0,00000000,53,00110101
105,01101001,81,01010001,186,10111010
72,01001000,115,01110011,187,10111011
22,00010110,75,01001011,97,01100001
93,01011101,125,01111101,218,11011010
105,01101001,52,00110100,157,10011101
32,00100000,46,00101110,78,01001110
19,00010011,115,01110011,134,10000110
117,01110101,38,00100110,155,10011011
96,01100000,101,01100101,197,11000101
47,00101111,116,01110100,163,10100011
47,00101111,73,01001001,120,01111000
48,00110000,28,00011100,76,01001100
82,01010010,106,01101010,188,10111100
116,01110100,21,00010101,137,10001001
30,00011110,97,01100001,127,01111111
32,00100000,71,01000111,103,01100111
102,01100110,99,01100011,201,11001001
24,00011000,65,01000001,89,01011001
82,01010010,54,00110110,136,10001000
61,00111101,0,00000000,61,00111101
53,00110101,84,01010100,137,10001001
64,01000000,53,00110101,117,01110101
8,00001000,78,01001110,86,01010110
38,00100110,82,01010010,120,01111000
2,00000010,3,00000011,5,00000101
54,00110110,18,00010010,72,01001000
46,00101110,114,01110010,160,10100000
7,00000111,120,01111000,127,01111111
122,01111010,6,00000110,128,10000000
0,00000000,72,01001000,72,01001000
28,00011100,16,00010000,44,00101100
43,00101011,95,01011111,138,10001010
56,00111000,112,01110000,168,10101000
105,01101001,91,01011011,196,11000100
73,01001001,36,00100100,109,01101101
103,01100111,39,00100111,142,10001110
7,00000111,32,00100000,39,00100111
14,00001110,14,00001110,28,00011100
127,01111111,99,01100011,226,11100010
95,01011111,123,01111011,218,11011010
12,00001100,114,01110010,126,01111110
123,01111011,10,00001010,133,10000101
36,00100100,78,01001110,114,01110010
5,00000101,15,00001111,20,00010100
117,01110101,114,01110010,231,11100111
77,01001101,84,01010100,161,10100001
104,01101000,16,00010000,120,01111000
80,01010000,49,00110001,129,10000001
91,01011011,108,01101100,199,11000111
26,00011010,20,00010100,46,00101110
41,00101001,42,00101010,83,01010011
46,00101110,30,00011110,76,01001100
33,00100001,127,01111111,160,10100000
58,00111010,51,00110011,109,01101101
72,01001000,8,00001000,80,01010000
27,00011011,93,01011101,120,01111000
67,01000011,37,00100101,104,01101000
56,00111000,76,01001100,132,10000100
2,00000010,76,01001100,78,01001110
28,00011100,115,01110011,143,10001111
79,01001111,8,00001000,87,01010111
30,00011110,90,01011010,120,01111000
125,01111101,30,00011110,155,10011011
48,00110000,101,01100101,149,10010101
40,00101000,0,00000000,40,00101000
107,01101011,16,00010000,123,01111011
16,00010000,85,01010101,101,01100101
69,01000101,106,01101010,175,10101111
14,00001110,75,01001011,89,01011001
108,01101100,121,01111001,229,11100101
7,00000111,29,00011101,36,00100100
39,00100111,72,01001000,111,01101111
48,00110000,39,00100111,87,01010111
15,00001111,98,01100010,113,01110001
52,00110100,81,01010001,133,10000101
74,01001010,70,01000110,144,10010000
103,01100111,41,00101001,144,10010000
10,00001010,79,01001111,89,01011001
79,01001111,114,01110010,193,11000001
109,01101101,118,01110110,227,11100011
19,00010011,42,00101010,61,00111101
45,00101101,92,01011100,137,10001001
67,01000011,105,01101001,172,10101100
46,00101110,86,01010110,132,10000100
45,00101101,27,00011011,72,01001000
45,00101101,73,01001001,118,01110110
25,00011001,17,00010001,42,00101010
58,00111010,37,00100101,95,01011111
68,01000100,19,00010011,87,01010111
57,00111001,4,00000100,61,00111101
62,00111110,113,01110001,175,10101111
105,01101001,16,00010000,121,01111001
81,01010001,0,00000000,81,01010001
48,00110000,31,00011111,79,01001111
117,01110101,41,00101001,158,10011110
31,00011111,68,01000100,99,01100011
101,01100101,28,00011100,129,10000001
18,00010010,95,01011111,113,01110001
127,01111111,16,00010000,143,10001111
70,01000110,116,01110100,186,10111010
110,01101110,84,01010100,194,11000010
34,00100010,40,00101000,74,01001010
78,01001110,89,01011001,167,10100111
102,01100110,55,00110111,157,10011101
23,00010111,86,01010110,109,01101101
86,01010110,63,00111111,149,10010101
47,00101111,32,00100000,79,01001111
119,01110111,45,00101101,164,10100100
85,01010101,123,01111011,208,11010000
108,01101100,10,00001010,118,01110110
88,01011000,74,01001010,162,10100010
43,00101011,105,01101001,148,10010100
63,00111111,57,00111001,120,01111000
108,01101100,72,01001000,180,10110100
27,00011011,48,00110000,75,01001011
56,00111000,39,00100111,95,01011111
106,01101010,28,00011100,134,10000110
14,00001110,116,01110100,130,10000010
30,00011110,31,00011111,61,00111101
126,01111110,64,01000000,190,10111110
64,01000000,11,00001011,75,01001011
119,01110111,37,00100101,156,10011100
0,00000000,119,01110111,119,01110111
108,01101100,34,00100010,142,10001110
123,01111011,18,00010010,141,10001101
32,00100000,38,00100110,70,01000110
31,00011111,11,00001011,42,00101010
125,01111101,118,01110110,243,11110011
87,01010111,82,01010010,169,10101001
27,00011011,33,00100001,60,00111100
9,00001001,5,00000101,14,00001110
68,01000100,126,01111110,194,11000010
3,00000011,109,01101101,112,01110000
75,01001011,12,00001100,87,01010111
73,01001001,11,00001011,84,01010100
13,00001101,119,01110111,132,10000100
127,01111111,37,00100101,164,10100100
101,01100101,116,01110100,217,11011001
20,00010100,51,00110011,71,01000111
73,01001001,37,00100101,110,01101110
101,01100101,122,01111010,223,11011111
25,00011001,45,00101101,70,01000110
3,00000011,19,00010011,22,00010110
14,00001110,51,00110011,65,01000001
118,01110110,89,01011001,207,11001111
2,00000010,74,01001010,76,01001100
54,00110110,7,00000111,61,00111101
68,01000100,6,00000110,74,01001010
68,01000100,40,00101000,108,01101100
96,01100000,24,00011000,120,01111000
15,00001111,120,01111000,135,10000111
50,00110010,22,00010110,72,01001000
99,01100011,79,01001111,178,10110010
86,01010110,110,01101110,196,11000100
74,01001010,50,00110010,124,01111100
36,00100100,18,00010010,54,00110110
110,01101110,53,00110101,163,10100011
0,00000000,69,01000101,69,01000101
125,01111101,68,01000100,193,11000001
40,00101000,44,00101100,84,01010100
12,00001100,5,00000101,17,00010001
9,00001001,28,00011100,37,00100101
1,00000001,123,01111011,124,01111100
94,01011110,23,00010111,117,01110101
80,01010000,15,00001111,95,01011111
38,00100110,66,01000010,104,01101000
95,01011111,91,01011011,186,10111010
98,01100010,54,00110110,152,10011000
62,00111110,96,01100000,158,10011110
18,00010010,76,01001100,94,01011110
27,00011011,47,00101111,74,01001010
85,01010101,89,01011001,174,10101110
42,00101010,91,01011011,133,10000101
49,00110001,127,01111111,176,10110000
40,00101000,112,01110000,152,10011000
59,00111011,6,00000110,65,01000001
41,00101001,6,00000110,47,00101111
101,01100101,3,00000011,104,01101000
83,01010011,86,01010110,169,10101001
1,00000001,52,00110100,53,00110101
86,01010110,98,01100010,184,10111000
61,00111101,54,00110110,115,01110011
61,00111101,34,00100010,95,01011111
82,01010010,67,01000011,149,10010101
2,00000010,107,01101011,109,01101101
107,01101011,33,00100001,140,10001100
0,00000000,119,01110111,119,01110111
81,01010001,100,01100100,181,10110101
23,00010111,122,01111010,145,10010001
65,01000001,65,01000001,130,10000010
1,00000001,119,01110111,120,01111000
20,00010100,76,01001100,96,01100000
74,01001010,95,01011111,169,10101001
38,00100110,69,01000101,107,01101011
56,00111000,21,00010101,77,01001101
90,01011010,61,00111101,151,10010111
101,01100101,72,01001000,173,10101101
8,00001000,124,01111100,132,10000100
28,00011100,127,01111111,155,10011011
101,01100101,14,00001110,115,01110011
127,01111111,81,01010001,208,11010000
50,00110010,32,00100000,82,01010010
120,01111000,55,00110111,175,10101111
88,01011000,6,00000110,94,01011110
117,01110101,127,01111111,244,11110100
15,00001111,105,01101001,120,01111000
100,01100100,15,00001111,115,01110011
92,01011100,89,01011001,181,10110101
14,00001110,22,00010110,36,00100100
66,01000010,90,01011010,156,10011100
17,00010001,108,01101100,125,01111101
47,00101111,18,00010010,65,01000001
88,01011000,8,00001000,96,01100000
116,01110100,22,00010110,138,10001010
89,01011001,73,01001001,162,10100010
15,00001111,95,01011111,110,01101110
114,01110010,108,01101100,222,11011110
60,00111100,45,00101101,105,01101001
26,00011010,15,00001111,41,00101001
68,01000100,127,01111111,195,11000011
108,01101100,125,01111101,233,11101001
10,00001010,84,01010100,94,01011110
47,00101111,46,00101110,93,01011101
117,01110101,47,00101111,164,10100100
69,01000101,46,00101110,115,01110011
26,00011010,93,01011101,119,01110111
117,01110101,45,00101101,162,10100010
7,00000111,3,00000011,10,00001010
25,00011001,65,01000001,90,01011010
28,00011100,79,01001111,107,01101011
112,01110000,71,01000111,183,10110111
48,00110000,127,01111111,175,10101111
102,01100110,71,01000111,173,10101101
97,01100001,6,00000110,103,01100111
120,01111000,82,01010010,202,11001010
34,00100010,37,00100101,71,01000111
101,01100101,99,01100011,200,11001000
104,01101000,17,00010001,121,01111001
107,01101011,63,00111111,170,10101010
22,00010110,36,00100100,58,00111010
18,00010010,73,01001001,91,01011011
5,00000101,7,00000111,12,00001100
22,00010110,17,00010001,39,00100111
40,00101000,81,01010001,121,01111001
92,01011100,62,00111110,154,10011010
88,01011000,32,00100000,120,01111000
123,01111011,48,00110000,171,10101011
99,01100011,28,00011100,127,01111111
25,00011001,29,00011101,54,00110110
28,00011100,87,01010111,115,01110011
120,01111000,62,00111110,182,10110110
73,01001001,109,01101101,182,10110110
73,01001001,74,01001010,147,10010011
21,00010101,22,00010110,43,00101011
124,01111100,91,01011011,215,11010111
4,00000100,54,00110110,58,00111010
103,01100111,12,00001100,115,01110011
65,01000001,12,00001100,77,01001101
20,00010100,13,00001101,33,00100001
116,01110100,26,00011010,142,10001110
65,01000001,115,01110011,180,10110100
112,01110000,97,01100001,209,11010001
5,00000101,46,00101110,51,00110011
74,01001010,35,00100011,109,01101101
104,01101000,25,00011001,129,10000001
47,00101111,0,00000000,47,00101111
21,00010101,7,00000111,28,00011100
2,00000010,4,00000100,6,00000110
56,00111000,113,01110001,169,10101001
122,01111010,34,00100010,156,10011100
126,01111110,54,00110110,180,10110100
22,00010110,79,01001111,101,01100101
21,00010101,109,01101101,130,10000010
2,00000010,79,01001111,81,01010001
52,00110100,23,00010111,75,01001011
94,01011110,45,00101101,139,10001011
124,01111100,61,00111101,185,10111001
118,01110110,113,01110001,231,11100111
18,00010010,27,00011011,45,00101101
82,01010010,9,00001001,91,01011011
69,01000101,98,01100010,167,10100111
122,01111010,23,00010111,145,10010001
71,01000111,30,00011110,101,01100101
103,01100111,107,01101011,210,11010010
9,00001001,82,01010010,91,01011011
20,00010100,80,01010000,100,01100100
115,01110011,109,01101101,224,11100000
107,01101011,86,01010110,193,11000001
17,00010001,92,01011100,109,01101101
92,01011100,44,00101100,136,10001000
17,00010001,41,00101001,58,00111010
9,00001001,23,00010111,32,00100000
77,01001101,71,01000111,148,10010100
127,01111111,90,01011010,217,11011001
26,00011010,19,00010011,45,00101101
67,01000011,56,00111000,123,01111011
8,00001000,46,00101110,54,00110110
123,01111011,72,01001000,195,11000011
2,00000010,123,01111011,125,01111101
5,00000101,14,00001110,19,00010011
33,00100001,68,01000100,101,01100101
118,01110110,97,01100001,215,11010111
104,01101000,65,01000001,169,10101001
51,00110011,43,00101011,94,01011110
120,01111000,110,01101110,230,11100110
3,00000011,105,01101001,108,01101100
52,00110100,88,01011000,140,10001100
4,00000100,26,00011010,30,00011110
30,00011110,36,00100100,66,01000010
46,00101110,123,01111011,169,10101001
73,01001001,7,00000111,80,01010000
28,00011100,108,01101100,136,10001000
14,00001110,57,00111001,71,01000111
126,01111110,31,00011111,157,10011101
40,00101000,65,01000001,105,01101001
85,01010101,21,00010101,106,01101010
102,01100110,95,01011111,197,11000101
82,01010010,124,01111100,206,11001110
31,00011111,97,01100001,128,10000000
6,00000110,28,00011100,34,00100010
88,01011000,84,01010100,172,10101100
28,00011100,17,00010001,45,00101101
39,00100111,16,00010000,55,00110111
58,00111010,1,00000001,59,00111011
105,01101001,53,00110101,158,10011110
69,01000101,55,00110111,124,01111100
56,00111000,99,01100011,155,10011011
36,00100100,121,01111001,157,10011101
31,00011111,104,01101000,135,10000111
125,01111101,65,01000001,190,10111110
104,01101000,95,01011111,199,11000111
96,01100000,18,00010010,114,01110010
104,01101000,30,00011110,134,10000110
14,00001110,85,01010101,99,01100011
95,01011111,32,00100000,127,01111111
11,00001011,102,01100110,113,01110001
108,01101100,78,01001110,186,10111010
15,00001111,7,00000111,22,00010110
71,01000111,74,01001010,145,10010001
62,00111110,84,01010100,146,10010010
33,00100001,119,01110111,152,10011000
18,00010010,127,01111111,145,10010001
42,00101010,104,01101000,146,10010010
27,00011011,24,00011000,51,00110011
69,01000101,67,01000011,136,10001000
29,00011101,30,00011110,59,00111011
95,01011111,34,00100010,129,10000001
26,00011010,67,01000011,93,01011101
112,01110000,23,00010111,135,10000111
72,01001000,106,01101010,178,10110010
24,00011000,106,01101010,130,10000010
6,00000110,74,01001010,80,01010000
125,01111101,121,01111001,246,11110110
111,01101111,99,01100011,210,11010010
43,00101011,110,01101110,153,10011001
121,01111001,103,01100111,224,11100000
111,01101111,113,01110001,224,11100000
52,00110100,90,01011010,142,10001110
45,00101101,100,01100100,145,10010001
79,01001111,18,00010010,97,01100001
3,00000011,92,01011100,95,01011111
63,00111111,58,00111010,121,01111001
63,00111111,39,00100111,102,01100110
94,01011110,5,00000101,99,01100011
47,00101111,22,00010110,69,01000101
107,01101011,51,00110011,158,10011110
49,00110001,73,01001001,122,01111010
12,00001100,32,00100000,44,00101100
79,01001111,118,01110110,197,11000101
32,00100000,35,00100011,67,01000011
114,01110010,124,01111100,238,11101110
126,01111110,60,00111100,186,10111010
62,00111110,111,01101111,173,10101101
92,01011100,127,01111111,219,11011011
90,01011010,99,01100011,189,10111101
82,01010010,44,00101100,126,01111110
106,01101010,51,00110011,157,10011101
56,00111000,92,01011100,148,10010100
8,00001000,49,00110001,57,00111001
48,00110000,125,01111101,173,10101101
55,00110111,22,00010110,77,01001101
62,00111110,95,01011111,157,10011101
57,00111001,85,01010101,142,10001110
34,00100010,55,00110111,89,01011001
41,00101001,64,01000000,105,01101001
43,00101011,11,00001011,54,00110110
8,00001000,23,00010111,31,00011111
56,00111000,85,01010101,141,10001101
121,01111001,56,00111000,177,10110001
112,01110000,55,00110111,167,10100111
110,01101110,93,01011101,203,11001011
125,01111101,8,00001000,133,10000101
21,00010101,120,01111000,141,10001101
116,01110100,76,01001100,192,11000000
109,01101101,43,00101011,152,10011000
9,00001001,123,01111011,132,10000100
75,01001011,33,00100001,108,01101100
45,00101101,105,01101001,150,10010110
51,00110011,112,01110000,163,10100011
88,01011000,71,01000111,159,10011111
85,01010101,29,00011101,114,01110010
106,01101010,103,01100111,209,11010001
102,01100110,87,01010111,189,10111101
66,01000010,42,00101010,108,01101100
37,00100101,115,01110011,152,10011000
113,01110001,70,01000110,183,10110111
20,00010100,49,00110001,69,01000101
100,01100100,38,00100110,138,10001010
85,01010101,41,00101001,126,01111110
125,01111101,81,01010001,206,11001110
124,01111100,32,00100000,156,10011100
47,00101111,82,01010010,129,10000001
27,00011011,75,01001011,102,01100110
85,01010101,72,01001000,157,10011101
62,00111110,87,01010111,149,10010101
40,00101000,83,01010011,123,01111011
20,00010100,91,01011011,111,01101111
125,01111101,6,00000110,131,10000011
41,00101001,92,01011100,133,10000101
112,01110000,75,01001011,187,10111011
6,00000110,80,01010000,86,01010110
31,00011111,45,00101101,76,01001100
71,01000111,36,00100100,107,01101011
25,00011001,29,00011101,54,00110110
118,01110110,126,01111110,244,11110100
127,01111111,46,00101110,173,10101101
69,01000101,57,00111001,126,01111110
63,00111111,72,01001000,135,10000111
68,01000100,33,00100001,101,01100101
37,00100101,1,00000001,38,00100110
23,00010111,49,00110001,72,01001000
12,00001100,1,00000001,13,00001101
71,01000111,92,01011100,163,10100011
8,00001000,46,00101110,54,00110110
36,00100100,48,00110000,84,01010100
56,00111000,41,00101001,97,01100001
88,01011000,64,01000000,152,10011000
98,01100010,45,00101101,143,10001111
45,00101101,15,00001111,60,00111100
39,00100111,2,00000010,41,00101001
42,00101010,11,00001011,53,00110101
111,01101111,68,01000100,179,10110011
95,01011111,110,01101110,205,11001101
70,01000110,60,00111100,130,10000010
66,01000010,57,00111001,123,01111011
74,01001010,100,01100100,174,10101110
42,00101010,45,00101101,87,01010111
81,01010001,110,01101110,191,10111111
76,01001100,104,01101000,180,10110100
17,00010001,47,00101111,64,01000000
53,00110101,7,00000111,60,00111100
75,01001011,26,00011010,101,01100101
22,00010110,100,01100100,122,01111010
113,01110001,91,01011011,204,11001100
124,01111100,76,01001100,200,11001000
71,01000111,82,01010010,153,10011001
63,00111111,81,01010001,144,10010000
54,00110110,7,00000111,61,00111101
54,00110110,71,01000111,125,01111101
8,00001000,84,01010100,92,01011100
49,00110001,11,00001011,60,00111100
88,01011000,124,01111100,212,11010100
50,00110010,26,00011010,76,01001100
13,00001101,112,01110000,125,01111101
44,00101100,12,00001100,56,00111000
75,01001011,78,01001110,153,10011001
19,00010011,34,00100010,53,00110101
18,00010010,102,01100110,120,01111000
60,00111100,65,01000001,125,01111101
31,00011111,69,01000101,100,01100100
51,00110011,103,01100111,154,10011010
112,01110000,8,00001000,120,01111000
32,00100000,122,01111010,154,10011010
6,00000110,33,00100001,39,00100111
0,00000000,122,01111010,122,01111010
3,00000011,63,00111111,66,01000010
123,01111011,41,00101001,164,10100100
53,00110101,47,00101111,100,01100100
58,00111010,69,01000101,127,01111111
44,00101100,123,01111011,167,10100111
98,01100010,1,00000001,99,01100011
103,01100111,11,00001011,114,01110010
114,01110010,13,00001101,127,01111111
12,00001100,76,01001100,88,01011000
17,00010001,59,00111011,76,01001100
41,00101001,52,00110100,93,01011101
89,01011001,107,01101011,196,11000100
35,00100011,26,00011010,61,00111101
55,00110111,62,00111110,117,01110101
98,01100010,53,00110101,151,10010111
72,01001000,42,00101010,114,01110010
71,01000111,13,00001101,84,01010100
8,00001000,26,00011010,34,00100010
83,01010011,47,00101111,130,10000010
115,01110011,57,00111001,172,10101100
30,00011110,75,01001011,105,01101001
54,00110110,115,01110011,169,10101001
56,00111000,49,00110001,105,01101001
99,01100011,19,00010011,118,01110110
22,00010110,100,01100100,122,01111010
19,00010011,116,01110100,135,10000111
47,00101111,50,00110010,97,01100001
98,01100010,123,01111011,221,11011101
73,01001001,43,00101011,116,01110100
18,00010010,52,00110100,70,01000110
108,01101100,5,00000101,113,01110001
26,00011010,15,00001111,41,00101001
31,00011111,11,00001011,42,00101010
2,00000010,55,00110111,57,00111001
42,00101010,124,01111100,166,10100110
78,01001110,12,00001100,90,01011010
74,01001010,71,01000111,145,10010001
22,00010110,55,00110111,77,01001101
79,01001111,52,00110100,131,10000011
67,01000011,79,01001111,146,10010010
107,01101011,96,01100000,203,11001011
2,00000010,127,01111111,129,10000001
127,01111111,110,01101110,237,11101101
25,00011001,109,01101101,134,10000110
59,00111011,6,00000110,65,01000001
13,00001101,110,01101110,123,01111011
76,01001100,114,01110010,190,10111110
121,01111001,121,01111001,242,11110010
94,01011110,89,01011001,183,10110111
46,00101110,1,00000001,47,00101111
55,00110111,79,01001111,134,10000110
51,00110011,72,01001000,123,01111011
108,01101100,91,01011011,199,11000111
64,01000000,43,00101011,107,01101011
36,00100100,59,00111011,95,01011111
92,01011100,42,00101010,134,10000110
43,00101011,106,01101010,149,10010101
83,01010011,34,00100010,117,01110101
69,01000101,98,01100010,167,10100111
34,00100010,65,01000001,99,01100011
96,01100000,0,00000000,96,01100000
63,00111111,101,01100101,164,10100100
2,00000010,127,01111111,129,10000001
69,01000101,57,00111001,126,01111110
121,01111001,76,01001100,197,11000101
1,00000001,7,00000111,8,00001000
39,00100111,34,00100010,73,01001001
108,01101100,95,01011111,203,11001011
88,01011000,78,01001110,166,10100110
56,00111000,51,00110011,107,01101011
114,01110010,95,01011111,209,11010001
118,01110110,21,00010101,139,10001011
83,01010011,31,00011111,114,01110010
87,01010111,48,00110000,135,10000111
49,00110001,60,00111100,109,01101101
61,00111101,99,01100011,160,10100000
50,00110010,32,00100000,82,01010010
64,01000000,101,01100101,165,10100101
20,00010100,72,01001000,92,01011100
125,01111101,43,00101011,168,10101000
69,01000101,40,00101000,109,01101101
112,01110000,124,01111100,236,11101100
25,00011001,119,01110111,144,10010000
70,01000110,125,01111101,195,11000011
18,00010010,87,01010111,105,01101001
69,01000101,74,01001010,143,10001111
99,01100011,53,00110101,152,10011000
50,00110010,20,00010100,70,01000110
124,01111100,64,01000000,188,10111100
45,00101101,95,01011111,140,10001100
7,00000111,80,01010000,87,01010111
99,01100011,101,01100101,200,11001000
81,01010001,62,00111110,143,10001111
55,00110111,80,01010000,135,10000111
20,00010100,120,01111000,140,10001100
35,00100011,35,00100011,70,01000110
23,00010111,88,01011000,111,01101111
57,00111001,10,00001010,67,01000011
21,00010101,84,01010100,105,01101001
105,01101001,91,01011011,196,11000100
20,00010100,101,01100101,121,01111001
111,01101111,84,01010100,195,11000011
82,01010010,19,00010011,101,01100101
74,01001010,71,01000111,145,10010001
42,00101010,63,00111111,105,01101001
105,01101001,95,01011111,200,11001000
78,01001110,93,01011101,171,10101011
51,00110011,115,01110011,166,10100110
31,00011111,33,00100001,64,01000000
94,01011110,103,01100111,197,11000101
118,01110110,107,01101011,225,11100001
33,00100001,123,01111011,156,10011100
29,00011101,8,00001000,37,00100101
35,00100011,6,00000110,41,00101001
72,01001000,127,01111111,199,11000111
109,01101101,34,00100010,143,10001111
74,01001010,62,00111110,136,10001000
58,00111010,116,01110100,174,10101110
50,00110010,102,01100110,152,10011000
24,00011000,61,00111101,85,01010101
25,00011001,94,01011110,119,01110111
73,01001001,52,00110100,125,01111101
30,00011110,43,00101011,73,01001001
98,01100010,27,00011011,125,01111101
127,01111111,7,00000111,134,10000110
25,00011001,80,01010000,105,01101001
52,00110100,52,00110100,104,01101000
108,01101100,66,01000010,174,10101110
54,00110110,30,00011110,84,01010100
4,00000100,72,01001000,76,01001100
112,01110000,20,00010100,132,10000100
47,00101111,97,01100001,144,10010000
61,00111101,70,01000110,131,10000011
119,01110111,29,00011101,148,10010100
70,01000110,121,01111001,191,10111111
36,00100100,90,01011010,126,01111110
33,00100001,84,01010100,117,01110101
79,01001111,56,00111000,135,10000111
11,00001011,15,00001111,26,00011010
121,01111001,106,01101010,227,11100011
21,00010101,91,01011011,112,01110000
43,00101011,82,01010010,125,01111101
10,00001010,12,00001100,22,00010110
48,00110000,118,01110110,166,10100110
118,01110110,114,01110010,232,11101000
2,00000010,75,01001011,77,01001101
6,00000110,97,01100001,103,01100111
87,01010111,117,01110101,204,11001100
105,01101001,94,01011110,199,11000111
61,00111101,63,00111111,124,01111100
26,00011010,120,01111000,146,10010010
42,00101010,88,01011000,130,10000010
3,00000011,84,01010100,87,01010111
87,01010111,127,01111111,214,11010110
75,01001011,4,00000100,79,01001111
53,00110101,43,00101011,96,01100000
114,01110010,70,01000110,184,10111000
93,01011101,74,01001010,167,10100111
88,01011000,127,01111111,215,11010111
58,00111010,85,01010101,143,10001111
73,01001001,38,00100110,111,01101111
74,01001010,73,01001001,147,10010011
37,00100101,75,01001011,112,01110000
19,00010011,100,01100100,119,01110111
47,00101111,53,00110101,100,01100100
60,00111100,114,01110010,174,10101110
46,00101110,122,01111010,168,10101000
29,00011101,28,00011100,57,00111001
39,00100111,70,01000110,109,01101101
2,00000010,9,00001001,11,00001011
99,01100011,8,00001000,107,01101011
8,00001000,3,00000011,11,00001011
80,01010000,72,01001000,152,10011000
73,01001001,27,00011011,100,01100100
118,01110110,23,00010111,141,10001101
125,01111101,116,01110100,241,11110001
27,00011011,58,00111010,85,01010101
26,00011010,27,00011011,53,00110101
64,01000000,65,01000001,129,10000001
22,00010110,31,00011111,53,00110101
18,00010010,116,01110100,134,10000110
25,00011001,68,01000100,93,01011101
48,00110000,76,01001100,124,01111100
124,01111100,50,00110010,174,10101110
0,00000000,44,00101100,44,00101100
121,01111001,83,01010011,204,11001100
117,01110101,123,01111011,240,11110000
122,01111010,54,00110110,176,10110000
31,00011111,4,00000100,35,00100011
103,01100111,105,01101001,208,11010000
89,01011001,45,00101101,134,10000110
92,01011100,21,00010101,113,01110001
38,00100110,23,00010111,61,00111101
55,00110111,30,00011110,85,01010101
100,01100100,96,01100000,196,11000100
43,00101011,100,01100100,143,10001111
15,00001111,28,00011100,43,00101011
119,01110111,9,00001001,128,10000000
38,00100110,109,01101101,147,10010011
77,01001101,26,00011010,103,01100111
125,01111101,67,01000011,192,11000000
107,01101011,39,00100111,146,10010010
99,01100011,24,00011000,123,01111011
99,01100011,25,00011001,124,01111100
100,01100100,73,01001001,173,10101101
24,00011000,88,01011000,112,01110000
17,00010001,34,00100010,51,00110011
63,00111111,58,00111010,121,01111001
21,00010101,85,01010101,106,01101010
120,01111000,23,00010111,143,10001111
109,01101101,74,01001010,183,10110111
15,00001111,101,01100101,116,01110100
37,00100101,94,01011110,131,10000011
6,00000110,94,01011110,100,01100100
102,01100110,125,01111101,227,11100011
33,00100001,72,01001000,105,01101001
119,01110111,75,01001011,194,11000010
31,00011111,106,01101010,137,10001001
117,01110101,29,00011101,146,10010010
126,01111110,90,01011010,216,11011000
37,00100101,9,00001001,46,00101110
95,01011111,127,01111111,222,11011110
53,00110101,81,01010001,134,10000110
89,01011001,18,00010010,107,01101011
98,01100010,72,01001000,170,10101010
74,01001010,0,00000000,74,01001010
33,00100001,93,01011101,126,01111110
75,01001011,98,01100010,173,10101101
126,01111110,81,01010001,207,11001111
75,01001011,79,01001111,154,10011010
101,01100101,119,01110111,220,11011100
81,01010001,69,01000101,150,10010110
11,00001011,2,00000010,13,00001101
121,01111001,26,00011010,147,10010011
40,00101000,25,00011001,65,01000001
75,01001011,103,01100111,178,10110010
121,01111001,12,00001100,133,10000101
86,01010110,84,01010100,170,10101010
32,00100000,57,00111001,89,01011001
54,00110110,1,00000001,55,00110111
53,00110101,19,00010011,72,01001000
78,01001110,125,01111101,203,11001011
43,00101011,83,01010011,126,01111110
73,01001001,49,00110001,122,01111010
36,00100100,34,00100010,70,01000110
6,00000110,123,01111011,129,10000001
122,01111010,21,00010101,143,10001111
37,00100101,82,01010010,119,01110111
80,01010000,70,01000110,150,10010110
79,01001111,111,01101111,190,10111110
38,00100110,105,01101001,143,10001111
77,01001101,57,00111001,134,10000110
20,00010100,1,00000001,21,00010101
48,00110000,46,00101110,94,01011110
53,00110101,30,00011110,83,01010011
33,00100001,71,01000111,104,01101000
51,00110011,51,00110011,102,01100110
46,00101110,116,01110100,162,10100010
94,01011110,85,01010101,179,10110011
46,00101110,67,01000011,113,01110001
104,01101000,25,00011001,129,10000001
122,01111010,113,01110001,235,11101011
104,01101000,41,00101001,145,10010001
86,01010110,65,01000001,151,10010111
99,01100011,64,01000000,163,10100011
35,00100011,76,01001100,111,01101111
22,00010110,61,00111101,83,01010011
61,00111101,20,00010100,81,01010001
104,01101000,103,01100111,207,11001111
46,00101110,48,00110000,94,01011110
92,01011100,77,01001101,169,10101001
5,00000101,18,00010010,23,00010111
13,00001101,70,01000110,83,01010011
94,01011110,69,01000101,163,10100011
108,01101100,86,01010110,194,11000010
33,00100001,68,01000100,101,01100101
14,00001110,62,00111110,76,01001100
46,00101110,37,00100101,83,01010011
76,01001100,43,00101011,119,01110111
70,01000110,40,00101000,110,01101110
27,00011011,43,00101011,70,01000110
3,00000011,17,00010001,20,00010100
47,00101111,48,00110000,95,01011111
76,01001100,47,00101111,123,01111011
31,00011111,15,00001111,46,00101110
81,01010001,11,00001011,92,01011100
41,00101001,1,00000001,42,00101010
22,00010110,102,01100110,124,01111100
55,00110111,5,00000101,60,00111100
107,01101011,67,01000011,174,10101110
17,00010001,49,00110001,66,01000010
112,01110000,24,00011000,136,10001000
59,00111011,51,00110011,110,01101110
81,01010001,85,01010101,166,10100110
58,00111010,0,00000000,58,00111010
82,01010010,81,01010001,163,10100011
28,00011100,15,00001111,43,00101011
100,01100100,100,01100100,200,11001000
44,00101100,95,01011111,139,10001011
65,01000001,14,00001110,79,01001111
32,00100000,48,00110000,80,01010000
2,00000010,107,01101011,109,01101101
20,00010100,8,00001000,28,00011100
17,00010001,54,00110110,71,01000111
83,01010011,114,01110010,197,11000101
34,00100010,72,01001000,106,01101010
87,01010111,86,01010110,173,10101101
89,01011001,105,01101001,194,11000010
63,00111111,77,01001101,140,10001100
120,01111000,47,00101111,167,10100111
14,00001110,56,00111000,70,01000110
40,00101000,54,00110110,94,01011110
80,01010000,38,00100110,118,01110110
25,00011001,57,00111001,82,01010010
88,01011000,81,01010001,169,10101001
63,00111111,114,01110010,177,10110001
37,00100101,94,01011110,131,10000011
65,01000001,9,00001001,74,01001010
109,01101101,59,00111011,168,10101000
110,01101110,1,00000001,111,01101111
24,00011000,37,00100101,61,00111101
120,01111000,24,00011000,144,10010000
60,00111100,81,01010001,141,10001101
103,01100111,101,01100101,204,11001100
70,01000110,107,01101011,177,10110001
78,01001110,88,01011000,166,10100110
104,01101000,87,01010111,191,10111111
37,00100101,28,00011100,65,01000001
2,00000010,84,01010100,86,01010110
56,00111000,79,01001111,135,10000111
29,00011101,79,01001111,108,01101100
8,00001000,105,01101001,113,01110001
18,00010010,95,01011111,113,01110001
72,01001000,59,00111011,131,10000011
94,01011110,47,00101111,141,10001101
127,01111111,101,01100101,228,11100100
102,01100110,80,01010000,182,10110110
5,00000101,44,00101100,49,00110001
86,01010110,117,01110101,203,11001011
36,00100100,46,00101110,82,01010010
118,01110110,13,00001101,131,10000011
113,01110001,15,00001111,128,10000000
112,01110000,72,01001000,184,10111000
31,00011111,89,01011001,120,01111000
45,00101101,21,00010101,66,01000010
80,01010000,34,00100010,114,01110010
9,00001001,9,00001001,18,00010010
93,01011101,30,00011110,123,01111011
10,00001010,102,01100110,112,01110000
35,00100011,120,01111000,155,10011011
56,00111000,46,00101110,102,01100110
94,01011110,27,00011011,121,01111001
53,00110101,68,01000100,121,01111001
81,01010001,57,00111001,138,10001010
45,00101101,116,01110100,161,10100001
10,00001010,44,00101100,54,00110110
23,00010111,106,01101010,129,10000001
81,01010001,39,00100111,120,01111000
120,01111000,61,00111101,181,10110101
54,00110110,103,01100111,157,10011101
26,00011010,117,01110101,143,10001111
57,00111001,89,01011001,146,10010010
50,00110010,102,01100110,152,10011000
91,01011011,122,01111010,213,11010101
23,00010111,33,00100001,56,00111000
30,00011110,40,00101000,70,01000110
36,00100100,91,01011011,127,01111111
121,01111001,80,01010000,201,11001001
83,01010011,110,01101110,193,11000001
120,01111000,126,01111110,246,11110110
53,00110101,25,00011001,78,01001110
127,01111111,8,00001000,135,10000111
29,00011101,57,00111001,86,01010110
79,01001111,111,01101111,190,10111110
64,01000000,120,01111000,184,10111000
51,00110011,60,00111100,111,01101111
117,01110101,55,00110111,172,10101100
11,00001011,114,01110010,125,01111101
86,01010110,98,01100010,184,10111000
89,01011001,40,00101000,129,10000001
115,01110011,96,01100000,211,11010011
54,00110110,93,01011101,147,10010011
68,01000100,53,00110101,121,01111001
39,00100111,56,00111000,95,01011111
110,01101110,73,01001001,183,10110111
67,01000011,74,01001010,141,10001101
127,01111111,22,00010110,149,10010101
28,00011100,88,01011000,116,01110100
125,01111101,86,01010110,211,11010011
4,00000100,84,01010100,88,01011000
84,01010100,62,00111110,146,10010010
93,01011101,108,01101100,201,11001001
115,01110011,111,01101111,226,11100010
52,00110100,14,00001110,66,01000010
68,01000100,87,01010111,155,10011011
110,01101110,3,00000011,113,01110001
57,00111001,50,00110010,107,01101011
87,01010111,6,00000110,93,01011101
74,01001010,116,01110100,190,10111110
78,01001110,12,00001100,90,01011010
18,00010010,63,00111111,81,01010001
88,01011000,72,01001000,160,10100000
28,00011100,122,01111010,150,10010110
22,00010110,56,00111000,78,01001110
8,00001000,82,01010010,90,01011010
120,01111000,13,00001101,133,10000101
127,01111111,114,01110010,241,11110001
27,00011011,52,00110100,79,01001111
50,00110010,78,01001110,128,10000000
15,00001111,9,00001001,24,00011000
109,01101101,50,00110010,159,10011111
95,01011111,11,00001011,106,01101010
93,01011101,73,01001001,166,10100110
8,00001000,47,00101111,55,00110111
1,00000001,25,00011001,26,00011010
77,01001101,54,00110110,131,10000011
64,01000000,121,01111001,185,10111001
96,01100000,73,01001001,169,10101001
96,01100000,50,00110010,146,10010010
59,00111011,51,00110011,110,01101110
89,01011001,83,01010011,172,10101100
62,00111110,99,01100011,161,10100001
121,01111001,64,01000000,185,10111001
100,01100100,114,01110010,214,11010110
35,00100011,89,01011001,124,01111100
40,00101000,46,00101110,86,01010110
62,00111110,29,00011101,91,01011011
57,00111001,102,01100110,159,10011111
100,01100100,55,00110111,155,10011011
99,01100011,93,01011101,192,11000000
20,00010100,54,00110110,74,01001010
120,01111000,82,01010010,202,11001010
123,01111011,64,01000000,187,10111011
1,00000001,22,00010110,23,00010111
105,01101001,47,00101111,152,10011000
18,00010010,114,01110010,132,10000100
123,01111011,8,00001000,131,10000011
47,00101111,112,01110000,159,10011111
21,00010101,46,00101110,67,01000011
82,01010010,125,01111101,207,11001111
76,01001100,15,00001111,91,01011011
93,01011101,122,01111010,215,11010111
79,01001111,50,00110010,129,10000001
7,00000111,23,00010111,30,00011110
95,01011111,110,01101110,205,11001101
21,00010101,103,01100111,124,01111100
14,00001110,61,00111101,75,01001011
25,00011001,82,01010010,107,01101011
68,01000100,111,01101111,179,10110011
95,01011111,97,01100001,192,11000000
63,00111111,70,01000110,133,10000101
33,00100001,22,00010110,55,00110111
124,01111100,108,01101100,232,11101000
73,01001001,23,00010111,96,01100000
87,01010111,95,01011111,182,10110110
103,01100111,111,01101111,214,11010110
14,00001110,41,00101001,55,00110111
9,00001001,100,01100100,109,01101101
24,00011000,115,01110011,139,10001011
67,01000011,117,01110101,184,10111000
5,00000101,63,00111111,68,01000100
74,01001010,102,01100110,176,10110000
28,00011100,95,01011111,123,01111011
22,00010110,105,01101001,127,01111111
118,01110110,72,01001000,190,10111110
126,01111110,74,01001010,200,11001000
85,01010101,30,00011110,115,01110011
82,01010010,57,00111001,139,10001011
94,01011110,92,01011100,186,10111010
107,01101011,31,00011111,138,10001010
94,01011110,32,00100000,126,01111110
41,00101001,120,01111000,161,10100001
28,00011100,68,01000100,96,01100000
106,01101010,65,01000001,171,10101011
127,01111111,98,01100010,225,11100001
98,01100010,22,00010110,120,01111000
112,01110000,109,01101101,221,11011101
70,01000110,105,01101001,175,10101111
89,01011001,108,01101100,197,11000101
83,01010011,126,01111110,209,11010001
9,00001001,98,01100010,107,01101011
86,01010110,102,01100110,188,10111100
41,00101001,59,00111011,100,01100100
56,00111000,53,00110101,109,01101101
28,00011100,23,00010111,51,00110011
4,00000100,125,01111101,129,10000001
87,01010111,103,01100111,190,10111110
17,00010001,62,00111110,79,01001111
8,00001000,73,01001001,81,01010001
116,01110100,120,01111000,236,11101100
65,01000001,124,01111100,189,10111101
95,01011111,15,00001111,110,01101110
81,01010001,69,01000101,150,10010110
7,00000111,109,01101101,116,01110100
66,01000010,27,00011011,93,01011101
98,01100010,70,01000110,168,10101000
24,00011000,114,01110010,138,10001010
100,01100100,109,01101101,209,11010001
12,00001100,53,00110101,65,01000001
13,00001101,93,01011101,106,01101010
109,01101101,29,00011101,138,10001010
81,01010001,74,01001010,155,10011011
40,00101000,27,00011011,67,01000011
30,00011110,98,01100010,128,10000000
24,00011000,66,01000010,90,01011010
58,00111010,9,00001001,67,01000011
63,00111111,101,01100101,164,10100100
6,00000110,108,01101100,114,01110010
5,00000101,43,00101011,48,00110000
115,01110011,102,01100110,217,11011001
6,00000110,119,01110111,125,01111101
58,00111010,33,00100001,91,01011011
10,00001010,14,00001110,24,00011000
114,01110010,88,01011000,202,11001010
9,00001001,22,00010110,31,00011111
40,00101000,2,00000010,42,00101010
115,01110011,82,01010010,197,11000101
35,00100011,40,00101000,75,01001011
122,01111010,74,01001010,196,11000100
32,00100000,51,00110011,83,01010011
22,00010110,21,00010101,43,00101011
56,00111000,42,00101010,98,01100010
73,01001001,114,01110010,187,10111011
80,01010000,106,01101010,186,10111010
43,00101011,87,01010111,130,10000010
117,01110101,91,01011011,208,11010000
54,00110110,122,01111010,176,10110000
87,01010111,126,01111110,213,11010101
109,01101101,57,00111001,166,10100110
78,01001110,46,00101110,124,01111100
32,00100000,104,01101000,136,10001000
9,00001001,96,01100000,105,01101001
22,00010110,55,00110111,77,01001101
100,01100100,109,01101101,209,11010001
117,01110101,47,00101111,164,10100100
30,00011110,125,01111101,155,10011011
8,00001000,97,01100001,105,01101001
110,01101110,12,00001100,122,01111010
97,01100001,88,01011000,185,10111001
40,00101000,36,00100100,76,01001100
35,00100011,111,01101111,146,10010010
6,00000110,47,00101111,53,00110101
25,00011001,110,01101110,135,10000111
50,00110010,5,00000101,55,00110111
39,00100111,41,00101001,80,01010000
60,00111100,121,01111001,181,10110101
63,00111111,43,00101011,106,01101010
25,00011001,49,00110001,74,01001010
97,01100001,58,00111010,155,10011011
119,01110111,77,01001101,196,11000100
115,01110011,52,00110100,167,10100111
45,00101101,7,00000111,52,00110100
79,01001111,19,00010011,98,01100010
121,01111001,124,01111100,245,11110101
51,00110011,51,00110011,102,01100110
34,00100010,95,01011111,129,10000001
26,00011010,107,01101011,133,10000101
53,00110101,68,01000100,121,01111001
57,00111001,89,01011001,146,10010010
114,01110010,89,01011001,203,11001011
20,00010100,64,01000000,84,01010100
55,00110111,10,00001010,65,01000001
30,00011110,113,01110001,143,10001111
75,01001011,120,01111000,195,11000011
28,00011100,12,00001100,40,00101000
117,01110101,50,00110010,167,10100111
8,00001000,5,00000101,13,00001101
69,01000101,37,00100101,106,01101010
113,01110001,74,01001010,187,10111011
47,00101111,64,01000000,111,01101111
116,01110100,111,01101111,227,11100011
19,00010011,116,01110100,135,10000111
51,00110011,26,00011010,77,01001101
13,00001101,24,00011000,37,00100101
106,01101010,18,00010010,124,01111100
73,01001001,60,00111100,133,10000101
12,00001100,27,00011011,39,00100111
77,01001101,8,00001000,85,01010101
54,00110110,119,01110111,173,10101101
98,01100010,67,01000011,165,10100101
6,00000110,78,01001110,84,01010100
81,01010001,73,01001001,154,10011010
17,00010001,84,01010100,101,01100101
119,01110111,105,01101001,224,11100000
71,01000111,14,00001110,85,01010101
85,01010101,96,01100000,181,10110101
98,01100010,49,00110001,147,10010011
114,01110010,3,00000011,117,01110101
100,01100100,93,01011101,193,11000001
121,01111001,22,00010110,143,10001111
15,00001111,104,01101000,119,01110111
97,01100001,101,01100101,198,11000110
81,01010001,78,01001110,159,10011111
3,00000011,96,01100000,99,01100011
57,00111001,16,00010000,73,01001001
101,01100101,68,01000100,169,10101001
120,01111000,51,00110011,171,10101011
112,01110000,95,01011111,207,11001111
24,00011000,125,01111101,149,10010101
12,00001100,23,00010111,35,00100011
53,00110101,13,00001101,66,01000010
44,00101100,22,00010110,66,01000010
55,00110111,87,01010111,142,10001110
87,01010111,86,01010110,173,10101101
82,01010010,24,00011000,106,01101010
121,01111001,108,01101100,229,11100101
76,01001100,127,01111111,203,11001011
102,01100110,110,01101110,212,11010100
11,00001011,13,00001101,24,00011000
0,00000000,63,00111111,63,00111111
15,00001111,62,00111110,77,01001101
112,01110000,104,01101000,216,11011000
123,01111011,89,01011001,212,11010100
33,00100001,105,01101001,138,10001010
90,01011010,107,01101011,197,11000101
11,00001011,93,01011101,104,01101000
55,00110111,74,01001010,129,10000001
21,00010101,88,01011000,109,01101101
77,01001101,33,00100001,110,01101110
108,01101100,9,00001001,117,01110101
45,00101101,35,00100011,80,01010000
98,01100010,37,00100101,135,10000111
87,01010111,106,01101010,193,11000001
107,01101011,61,00111101,168,10101000
117,01110101,107,01101011,224,11100000
66,01000010,38,00100110,104,01101000
107,01101011,46,00101110,153,10011001
1,00000001,106,01101010,107,01101011
93,01011101,58,00111010,151,10010111
95,01011111,68,01000100,163,10100011
46,00101110,89,01011001,135,10000111
119,01110111,109,01101101,228,11100100
41,00101001,120,01111000,161,10100001
7,00000111,108,01101100,115,01110011
67,01000011,122,01111010,189,10111101
39,00100111,7,00000111,46,00101110
20,00010100,88,01011000,108,01101100
24,00011000,33,00100001,57,00111001
50,00110010,80,01010000,130,10000010
123,01111011,73,01001001,196,11000100
28,00011100,78,01001110,106,01101010
30,00011110,45,00101101,75,01001011
74,01001010,97,01100001,171,10101011
28,00011100,63,00111111,91,01011011
61,00111101,70,01000110,131,10000011
40,00101000,70,01000110,110,01101110
104,01101000,85,01010101,189,10111101
113,01110001,24,00011000,137,10001001
49,00110001,55,00110111,104,01101000
15,00001111,11,00001011,26,00011010
46,00101110,24,00011000,70,01000110
82,01010010,88,01011000,170,10101010
87,01010111,98,01100010,185,10111001
5,00000101,78,01001110,83,01010011
119,01110111,31,00011111,150,10010110
111,01101111,57,00111001,168,10101000
39,00100111,127,01111111,166,10100110
114,01110010,120,01111000,234,11101010
102,01100110,54,00110110,156,10011100
116,01110100,81,01010001,197,11000101
62,00111110,98,01100010,160,10100000
40,00101000,0,00000000,40,00101000
19,00010011,102,01100110,121,01111001
27,00011011,92,01011100,119,01110111
5,00000101,25,00011001,30,00011110
67,01000011,6,00000110,73,01001001
20,00010100,10,00001010,30,00011110
1,00000001,39,00100111,40,00101000
121,01111001,21,00010101,142,10001110
77,01001101,37,00100101,114,01110010
11,00001011,54,00110110,65,01000001
25,00011001,119,01110111,144,10010000
118,01110110,117,01110101,235,11101011
68,01000100,105,01101001,173,10101101
0,00000000,94,01011110,94,01011110
116,01110100,101,01100101,217,11011001
92,01011100,9,00001001,101,01100101
127,01111111,81,01010001,208,11010000
62,00111110,15,00001111,77,01001101
53,00110101,51,00110011,104,01101000
117,01110101,39,00100111,156,10011100
80,01010000,107,01101011,187,10111011
121,01111001,24,00011000,145,10010001
122,01111010,38,00100110,160,10100000
102,01100110,43,00101011,145,10010001
17,00010001,44,00101100,61,00111101
53,00110101,20,00010100,73,01001001
9,00001001,31,00011111,40,00101000
7,00000111,90,01011010,97,01100001
55,00110111,86,01010110,141,10001101
122,01111010,127,01111111,249,11111001
96,01100000,4,00000100,100,01100100
18,00010010,83,01010011,101,01100101
45,00101101,10,00001010,55,00110111
95,01011111,6,00000110,101,01100101
107,01101011,124,01111100,231,11100111
115,01110011,105,01101001,220,11011100
6,00000110,101,01100101,107,01101011
107,01101011,101,01100101,208,11010000
47,00101111,89,01011001,136,10001000
18,00010010,15,00001111,33,00100001
113,01110001,92,01011100,205,11001101
111,01101111,5,00000101,116,01110100
7,00000111,12,00001100,19,00010011
59,00111011,100,01100100,159,10011111
48,00110000,19,00010011,67,01000011
103,01100111,32,00100000,135,10000111
53,00110101,68,01000100,121,01111001
125,01111101,50,00110010,175,10101111
42,00101010,61,00111101,103,01100111
53,00110101,71,01000111,124,01111100
52,00110100,2,00000010,54,00110110
106,01101010,23,00010111,129,10000001
101,01100101,12,00001100,113,01110001
108,01101100,32,00100000,140,10001100
105,01101001,96,01100000,201,11001001
67,01000011,21,00010101,88,01011000
27,00011011,90,01011010,117,01110101
61,00111101,3,00000011,64,01000000
117,01110101,118,01110110,235,11101011
42,00101010,101,01100101,143,10001111
78,01001110,92,01011100,170,10101010
85,01010101,53,00110101,138,10001010
97,01100001,22,00010110,119,01110111
44,00101100,20,00010100,64,01000000
7,00000111,28,00011100,35,00100011
74,01001010,74,01001010,148,10010100
81,01010001,12,00001100,93,01011101
97,01100001,30,00011110,127,01111111
46,00101110,85,01010101,131,10000011
114,01110010,78,01001110,192,11000000
38,00100110,124,01111100,162,10100010
65,01000001,61,00111101,126,01111110
118,01110110,67,01000011,185,10111001
38,00100110,31,00011111,69,01000101
124,01111100,91,01011011,215,11010111
59,00111011,22,00010110,81,01010001
16,00010000,116,01110100,132,10000100
117,01110101,41,00101001,158,10011110
78,01001110,113,01110001,191,10111111
97,01100001,35,00100011,132,10000100
76,01001100,120,01111000,196,11000100
114,01110010,32,00100000,146,10010010
69,01000101,37,00100101,106,01101010
17,00010001,72,01001000,89,01011001
126,01111110,53,00110101,179,10110011
83,01010011,57,00111001,140,10001100
125,01111101,8,00001000,133,10000101
13,00001101,53,00110101,66,01000010
8,00001000,98,01100010,106,01101010
45,00101101,69,01000101,114,01110010
17,00010001,127,01111111,144,10010000
18,00010010,65,01000001,83,01010011
6,00000110,90,01011010,96,01100000
120,01111000,11,00001011,131,10000011
122,01111010,41,00101001,163,10100011
124,01111100,76,01001100,200,11001000
98,01100010,8,00001000,106,01101010
93,01011101,125,01111101,218,11011010
90,01011010,62,00111110,152,10011000
19,00010011,7,00000111,26,00011010
121,01111001,60,00111100,181,10110101
81,01010001,79,01001111,160,10100000
70,01000110,97,01100001,167,10100111
34,00100010,40,00101000,74,01001010
1,00000001,78,01001110,79,01001111
24,00011000,99,01100011,123,01111011
69,01000101,91,01011011,160,10100000
63,00111111,29,00011101,92,01011100
109,01101101,64,01000000,173,10101101
71,01000111,58,00111010,129,10000001
47,00101111,66,01000010,113,01110001
42,00101010,84,01010100,126,01111110
94,01011110,3,00000011,97,01100001
102,01100110,79,01001111,181,10110101
83,01010011,77,01001101,160,10100000
33,00100001,104,01101000,137,10001001
28,00011100,61,00111101,89,01011001
22,00010110,68,01000100,90,01011010
86,01010110,1,00000001,87,01010111
48,00110000,110,01101110,158,10011110
34,00100010,65,01000001,99,01100011
82,01010010,98,01100010,180,10110100
47,00101111,117,01110101,164,10100100
101,01100101,18,00010010,119,01110111
34,00100010,117,01110101,151,10010111
51,00110011,37,00100101,88,01011000
69,01000101,49,00110001,118,01110110
69,01000101,68,01000100,137,10001001
48,00110000,43,00101011,91,01011011
1,00000001,10,00001010,11,00001011
19,00010011,72,01001000,91,01011011
26,00011010,49,00110001,75,01001011
107,01101011,98,01100010,205,11001101
67,01000011,10,00001010,77,01001101
119,01110111,2,00000010,121,01111001
18,00010010,31,00011111,49,00110001
35,00100011,92,01011100,127,01111111
48,00110000,45,00101101,93,01011101
102,01100110,5,00000101,107,01101011
69,01000101,59,00111011,128,10000000
94,01011110,113,01110001,207,11001111
38,00100110,109,01101101,147,10010011
95,01011111,72,01001000,167,10100111
48,00110000,70,01000110,118,01110110
78,01001110,2,00000010,80,01010000
21,00010101,65,01000001,86,01010110
19,00010011,90,01011010,109,01101101
23,00010111,109,01101101,132,10000100
119,01110111,71,01000111,190,10111110
25,00011001,25,00011001,50,00110010
8,00001000,57,00111001,65,01000001
76,01001100,89,01011001,165,10100101
95,01011111,6,00000110,101,01100101
116,01110100,98,01100010,214,11010110
39,00100111,75,01001011,114,01110010
27,00011011,44,00101100,71,01000111
112,01110000,55,00110111,167,10100111
115,01110011,25,00011001,140,10001100
35,00100011,47,00101111,82,01010010
114,01110010,25,00011001,139,10001011
111,01101111,42,00101010,153,10011001
55,00110111,53,00110101,108,01101100
59,00111011,40,00101000,99,01100011
49,00110001,77,01001101,126,01111110
90,01011010,28,00011100,118,01110110
66,01000010,68,01000100,134,10000110
76,01001100,80,01010000,156,10011100
44,00101100,79,01001111,123,01111011
97,01100001,99,01100011,196,11000100
127,01111111,78,01001110,205,11001101
18,00010010,21,00010101,39,00100111
33,00100001,28,00011100,61,00111101
9,00001001,17,00010001,26,00011010
8,00001000,110,01101110,118,01110110
84,01010100,25,00011001,109,01101101
39,00100111,87,01010111,126,01111110
5,00000101,122,01111010,127,01111111
56,00111000,70,01000110,126,01111110
33,00100001,42,00101010,75,01001011
98,01100010,124,01111100,222,11011110
113,01110001,102,01100110,215,11010111
28,00011100,10,00001010,38,00100110
41,00101001,109,01101101,150,10010110
100,01100100,92,01011100,192,11000000
6,00000110,51,00110011,57,00111001
13,00001101,14,00001110,27,00011011
69,01000101,48,00110000,117,01110101
82,01010010,34,00100010,116,01110100
44,00101100,122,01111010,166,10100110
26,00011010,49,00110001,75,01001011
3,00000011,33,00100001,36,00100100
94,01011110,33,00100001,127,01111111
90,01011010,50,00110010,140,10001100
38,00100110,58,00111010,96,01100000
105,01101001,77,01001101,182,10110110
125,01111101,23,00010111,148,10010100
73,01001001,99,01100011,172,10101100
60,00111100,45,00101101,105,01101001
45,00101101,17,00010001,62,00111110
74,01001010,89,01011001,163,10100011
112,01110000,70,01000110,182,10110110
121,01111001,121,01111001,242,11110010
110,01101110,0,00000000,110,01101110
107,01101011,47,00101111,154,10011010
97,01100001,88,01011000,185,10111001
101,01100101,95,01011111,196,11000100
111,01101111,40,00101000,151,10010111
101,01100101,48,00110000,149,10010101
67,01000011,112,01110000,179,10110011
39,00100111,68,01000100,107,01101011
39,00100111,6,00000110,45,00101101
50,00110010,100,01100100,150,10010110
47,00101111,89,01011001,136,10001000
11,00001011,7,00000111,18,00010010
29,00011101,55,00110111,84,01010100
46,00101110,13,00001101,59,00111011
67,01000011,103,01100111,170,10101010
19,00010011,17,00010001,36,00100100
40,00101000,9,00001001,49,00110001
72,01001000,80,01010000,152,10011000
76,01001100,88,01011000,164,10100100
73,01001001,104,01101000,177,10110001
5,00000101,125,01111101,130,10000010
121,01111001,63,00111111,184,10111000
115,01110011,36,00100100,151,10010111
46,00101110,88,01011000,134,10000110
119,01110111,19,00010011,138,10001010
63,00111111,83,01010011,146,10010010
119,01110111,57,00111001,176,10110000
7,00000111,99,01100011,106,01101010
39,00100111,67,01000011,106,01101010
80,01010000,101,01100101,181,10110101
10,00001010,80,01010000,90,01011010
90,01011010,38,00100110,128,10000000
75,01001011,82,01010010,157,10011101
99,01100011,88,01011000,187,10111011
49,00110001,114,01110010,163,10100011
84,01010100,79,01001111,163,10100011
9,00001001,6,00000110,15,00001111
2,00000010,87,01010111,89,01011001
61,00111101,51,00110011,112,01110000
71,01000111,67,01000011,138,10001010
115,01110011,83,01010011,198,11000110
109,01101101,39,00100111,148,10010100
14,00001110,5,00000101,19,00010011
19,00010011,110,01101110,129,10000001
119,01110111,104,01101000,223,11011111
66,01000010,113,01110001,179,10110011
42,00101010,106,01101010,148,10010100
77,01001101,24,00011000,101,01100101
32,00100000,102,01100110,134,10000110
69,01000101,43,00101011,112,01110000
55,00110111,27,00011011,82,01010010
106,01101010,0,00000000,106,01101010
17,00010001,122,01111010,139,10001011
104,01101000,102,01100110,206,11001110
79,01001111,26,00011010,105,01101001
78,01001110,24,00011000,102,01100110
66,01000010,89,01011001,155,10011011
8,00001000,54,00110110,62,00111110
62,00111110,76,01001100,138,10001010
91,01011011,16,00010000,107,01101011
114,01110010,19,00010011,133,10000101
106,01101010,54,00110110,160,10100000
56,00111000,122,01111010,178,10110010
120,01111000,112,01110000,232,11101000
123,01111011,104,01101000,227,11100011
62,00111110,9,00001001,71,01000111
12,00001100,53,00110101,65,01000001
78,01001110,63,00111111,141,10001101
81,01010001,112,01110000,193,11000001
4,00000100,23,00010111,27,00011011
114,01110010,103,01100111,217,11011001
58,00111010,33,00100001,91,01011011
5,00000101,91,01011011,96,01100000
13,00001101,60,00111100,73,01001001
85,01010101,44,00101100,129,10000001
35,00100011,78,01001110,113,01110001
18,00010010,45,00101101,63,00111111
56,00111000,119,01110111,175,10101111
55,00110111,79,01001111,134,10000110
61,00111101,106,01101010,167,10100111
47,00101111,62,00111110,109,01101101
16,00010000,106,01101010,122,01111010
36,00100100,92,01011100,128,10000000
54,00110110,64,01000000,118,01110110
106,01101010,94,01011110,200,11001000
40,00101000,104,01101000,144,10010000
45,00101101,10,00001010,55,00110111
120,01111000,24,00011000,144,10010000
18,00010010,118,01110110,136,10001000
33,00100001,41,00101001,74,01001010
6,00000110,99,01100011,105,01101001
57,00111001,127,01111111,184,10111000
109,01101101,66,01000010,175,10101111
118,01110110,111,01101111,229,11100101
80,01010000,30,00011110,110,01101110
125,01111101,114,01110010,239,11101111
60,00111100,110,01101110,170,10101010
114,01110010,63,00111111,177,10110001
81,01010001,31,00011111,112,01110000
59,00111011,120,01111000,179,10110011
21,00010101,96,01100000,117,01110101
61,00111101,87,01010111,148,10010100
113,01110001,61,00111101,174,10101110
123,01111011,28,00011100,151,10010111
91,01011011,11,00001011,102,01100110
73,01001001,3,00000011,76,01001100
80,01010000,51,00110011,131,10000011
73,01001001,19,00010011,92,01011100
67,01000011,32,00100000,99,01100011
112,01110000,73,01001001,185,10111001
106,01101010,104,01101000,210,11010010
14,00001110,57,00111001,71,01000111
101,01100101,47,00101111,148,10010100
59,00111011,88,01011000,147,10010011
20,00010100,97,01100001,117,01110101
84,01010100,88,01011000,172,10101100
102,01100110,7,00000111,109,01101101
76,01001100,126,01111110,202,11001010
10,00001010,72,01001000,82,01010010
115,01110011,1,00000001,116,01110100
92,01011100,114,01110010,206,11001110
92,01011100,38,00100110,130,10000010
80,01010000,28,00011100,108,01101100
110,01101110,69,01000101,179,10110011
33,00100001,68,01000100,101,01100101
38,00100110,124,01111100,162,10100010
107,01101011,46,00101110,153,10011001
10,00001010,127,01111111,137,10001001
31,00011111,20,00010100,51,00110011
107,01101011,92,01011100,199,11000111
7,00000111,28,00011100,35,00100011
22,00010110,10,00001010,32,00100000
5,00000101,116,01110100,121,01111001
125,01111101,62,00111110,187,10111011
78,01001110,66,01000010,144,10010000
95,01011111,84,01010100,179,10110011
6,00000110,74,01001010,80,01010000
44,00101100,114,01110010,158,10011110
120,01111000,4,00000100,124,01111100
67,01000011,108,01101100,175,10101111
124,01111100,111,01101111,235,11101011
67,01000011,92,01011100,159,10011111
80,01010000,79,01001111,159,10011111
123,01111011,19,00010011,142,10001110
71,01000111,74,01001010,145,10010001
58,00111010,67,01000011,125,01111101
123,01111011,36,00100100,159,10011111
16,00010000,122,01111010,138,10001010
113,01110001,76,01001100,189,10111101
29,00011101,108,01101100,137,10001001
37,00100101,48,00110000,85,01010101
94,01011110,94,01011110,188,10111100
106,01101010,73,01001001,179,10110011
78,01001110,15,00001111,93,01011101
71,01000111,102,01100110,173,10101101
86,01010110,42,00101010,128,10000000
18,00010010,23,00010111,41,00101001
80,01010000,52,00110100,132,10000100
62,00111110,56,00111000,118,01110110
6,00000110,42,00101010,48,00110000
49,00110001,108,01101100,157,10011101
56,00111000,61,00111101,117,01110101
59,00111011,121,01111001,180,10110100
86,01010110,30,00011110,116,01110100
30,00011110,43,00101011,73,01001001
102,01100110,10,00001010,112,01110000
113,01110001,126,01111110,239,11101111
53,00110101,65,01000001,118,01110110
103,01100111,85,01010101,188,10111100
54,00110110,45,00101101,99,01100011
92,01011100,71,01000111,163,10100011
106,01101010,85,01010101,191,10111111
32,00100000,78,01001110,110,01101110
105,01101001,88,01011000,193,11000001
50,00110010,10,00001010,60,00111100
43,00101011,8,00001000,51,00110011
56,00111000,12,00001100,68,01000100
114,01110010,58,00111010,172,10101100
26,00011010,5,00000101,31,00011111
114,01110010,124,01111100,238,11101110
51,00110011,66,01000010,117,01110101
25,00011001,91,01011011,116,01110100
36,00100100,107,01101011,143,10001111
115,01110011,55,00110111,170,10101010
116,01110100,57,00111001,173,10101101
117,01110101,53,00110101,170,10101010
34,00100010,109,01101101,143,10001111
111,01101111,125,01111101,236,11101100
30,00011110,121,01111001,151,10010111
127,01111111,106,01101010,233,11101001
76,01001100,64,01000000,140,10001100
116,01110100,19,00010011,135,10000111
66,01000010,76,01001100,142,10001110
30,00011110,23,00010111,53,00110101
65,01000001,70,01000110,135,10000111
13,00001101,24,00011000,37,00100101
17,00010001,53,00110101,70,01000110
49,00110001,39,00100111,88,01011000
51,00110011,18,00010010,69,01000101
114,01110010,28,00011100,142,10001110
77,01001101,91,01011011,168,10101000
118,01110110,44,00101100,162,10100010
10,00001010,99,01100011,109,01101101
66,01000010,63,00111111,129,10000001
75,01001011,88,01011000,163,10100011
40,00101000,114,01110010,154,10011010
125,01111101,19,00010011,144,10010000
119,01110111,20,00010100,139,10001011
96,01100000,47,00101111,143,10001111
124,01111100,95,01011111,219,11011011
0,00000000,46,00101110,46,00101110
102,01100110,74,01001010,176,10110000
12,00001100,79,01001111,91,01011011
63,00111111,110,01101110,173,10101101
109,01101101,109,01101101,218,11011010
78,01001110,70,01000110,148,10010100
19,00010011,110,01101110,129,10000001
64,01000000,75,01001011,139,10001011
25,00011001,15,00001111,40,00101000
36,00100100,80,01010000,116,01110100
109,01101101,107,01101011,216,11011000
90,01011010,41,00101001,131,10000011
126,01111110,33,00100001,159,10011111
78,01001110,6,00000110,84,01010100
99,01100011,36,00100100,135,10000111
86,01010110,26,00011010,112,01110000
27,00011011,59,00111011,86,01010110
75,01001011,31,00011111,106,01101010
3,00000011,99,01100011,102,01100110
13,00001101,95,01011111,108,01101100
14,00001110,63,00111111,77,01001101
118,01110110,43,00101011,161,10100001
18,00010010,10,00001010,28,00011100
123,01111011,58,00111010,181,10110101
38,00100110,63,00111111,101,01100101
64,01000000,32,00100000,96,01100000
97,01100001,104,01101000,201,11001001
53,00110101,65,01000001,118,01110110
111,01101111,78,01001110,189,10111101
61,00111101,95,01011111,156,10011100
114,01110010,67,01000011,181,10110101
21,00010101,3,00000011,24,00011000
88,01011000,10,00001010,98,01100010
68,01000100,71,01000111,139,10001011
14,00001110,59,00111011,73,01001001
34,00100010,107,01101011,141,10001101
71,01000111,46,00101110,117,01110101
104,01101000,100,01100100,204,11001100
19,00010011,10,00001010,29,00011101
89,01011001,101,01100101,190,10111110
67,01000011,23,00010111,90,01011010
81,01010001,94,01011110,175,10101111
22,00010110,122,01111010,144,10010000
110,01101110,3,00000011,113,01110001
124,01111100,40,00101000,164,10100100
8,00001000,106,01101010,114,01110010
21,00010101,60,00111100,81,01010001
46,00101110,70,01000110,116,01110100
78,01001110,20,00010100,98,01100010
102,01100110,48,00110000,150,10010110
113,01110001,82,01010010,195,11000011
76,01001100,61,00111101,137,10001001
19,00010011,98,01100010,117,01110101
87,01010111,56,00111000,143,10001111
102,01100110,11,00001011,113,01110001
50,00110010,114,01110010,164,10100100
105,01101001,47,00101111,152,10011000
11,00001011,110,01101110,121,01111001
101,01100101,48,00110000,149,10010101
50,00110010,81,01010001,131,10000011
104,01101000,43,00101011,147,10010011
24,00011000,13,00001101,37,00100101
115,01110011,56,00111000,171,10101011
15,00001111,47,00101111,62,00111110
19,00010011,114,01110010,133,10000101
38,00100110,123,01111011,161,10100001
63,00111111,48,00110000,111,01101111
84,01010100,22,00010110,106,01101010
40,00101000,37,00100101,77,01001101
40,00101000,80,01010000,120,01111000
44,00101100,54,00110110,98,01100010
94,01011110,8,00001000,102,01100110
119,01110111,62,00111110,181,10110101
80,01010000,106,01101010,186,10111010
46,00101110,29,00011101,75,01001011
73,01001001,4,00000100,77,01001101
4,00000100,32,00100000,36,00100100
7,00000111,12,00001100,19,00010011
110,01101110,86,01010110,196,11000100
6,00000110,20,00010100,26,00011010
107,01101011,29,00011101,136,10001000
81,01010001,68,01000100,149,10010101
109,01101101,125,01111101,234,11101010
41,00101001,116,01110100,157,10011101
127,01111111,34,00100010,161,10100001
81,01010001,3,00000011,84,01010100
62,00111110,76,01001100,138,10001010
47,00101111,95,01011111,142,10001110
8,00001000,46,00101110,54,00110110
28,00011100,108,01101100,136,10001000
13,00001101,116,01110100,129,10000001
97,01100001,92,01011100,189,10111101
25,00011001,77,01001101,102,01100110
91,01011011,29,00011101,120,01111000
7,00000111,90,01011010,97,01100001
2,00000010,74,01001010,76,01001100
4,00000100,61,00111101,65,01000001
121,01111001,90,01011010,211,11010011
51,00110011,66,01000010,117,01110101
28,00011100,56,00111000,84,01010100
74,01001010,84,01010100,158,10011110
68,01000100,56,00111000,124,01111100
122,01111010,14,00001110,136,10001000
70,01000110,93,01011101,163,10100011
87,01010111,66,01000010,153,10011001
54,00110110,30,00011110,84,01010100
67,01000011,93,01011101,160,10100000
20,00010100,54,00110110,74,01001010
79,01001111,26,00011010,105,01101001
62,00111110,122,01111010,184,10111000
57,00111001,120,01111000,177,10110001
91,01011011,88,01011000,179,10110011
105,01101001,69,01000101,174,10101110
77,01001101,13,00001101,90,01011010
65,01000001,121,01111001,186,10111010
102,01100110,13,00001101,115,01110011
58,00111010,40,00101000,98,01100010
72,01001000,100,01100100,172,10101100
122,01111010,123,01111011,245,11110101
7,00000111,23,00010111,30,00011110
75,01001011,68,01000100,143,10001111
49,00110001,66,01000010,115,01110011
88,01011000,60,00111100,148,10010100
61,00111101,95,01011111,156,10011100
48,00110000,46,00101110,94,01011110
109,01101101,120,01111000,229,11100101
64,01000000,93,01011101,157,10011101
105,01101001,93,01011101,198,11000110
75,01001011,25,00011001,100,01100100
79,01001111,87,01010111,166,10100110
9,00001001,67,01000011,76,01001100
43,00101011,71,01000111,114,01110010
124,01111100,94,01011110,218,11011010
113,01110001,10,00001010,123,01111011
16,00010000,66,01000010,82,01010010
90,01011010,34,00100010,124,01111100
51,00110011,52,00110100,103,01100111
93,01011101,61,00111101,154,10011010
41,00101001,11,00001011,52,00110100
30,00011110,52,00110100,82,01010010
52,00110100,68,01000100,120,01111000
31,00011111,127,01111111,158,10011110
36,00100100,22,00010110,58,00111010
102,01100110,53,00110101,155,10011011
31,00011111,24,00011000,55,00110111
95,01011111,40,00101000,135,10000111
6,00000110,123,01111011,129,10000001
65,01000001,113,01110001,178,10110010
5,00000101,51,00110011,56,00111000
49,00110001,3,00000011,52,00110100
119,01110111,25,00011001,144,10010000
5,00000101,98,01100010,103,01100111
126,01111110,32,00100000,158,10011110
110,01101110,11,00001011,121,01111001
76,01001100,87,01010111,163,10100011
69,01000101,6,00000110,75,01001011
79,01001111,57,00111001,136,10001000
59,00111011,114,01110010,173,10101101
71,01000111,42,00101010,113,01110001
7,00000111,56,00111000,63,00111111
6,00000110,29,00011101,35,00100011
46,00101110,11,00001011,57,00111001
99,01100011,1,00000001,100,01100100
44,00101100,62,00111110,106,01101010
18,00010010,47,00101111,65,01000001
126,01111110,102,01100110,228,11100100
12,00001100,98,01100010,110,01101110
54,00110110,57,00111001,111,01101111
64,01000000,27,00011011,91,01011011
58,00111010,7,00000111,65,01000001
42,00101010,99,01100011,141,10001101
80,01010000,114,01110010,194,11000010
71,01000111,47,00101111,118,01110110
31,00011111,20,00010100,51,00110011
105,01101001,48,00110000,153,10011001
4,00000100,2,00000010,6,00000110
96,01100000,107,01101011,203,11001011
29,00011101,88,01011000,117,01110101
101,01100101,10,00001010,111,01101111
25,00011001,124,01111100,149,10010101
3,00000011,64,01000000,67,01000011
73,01001001,57,00111001,130,10000010
68,01000100,120,01111000,188,10111100
88,01011000,4,00000100,92,01011100
97,01100001,96,01100000,193,11000001
11,00001011,29,00011101,40,00101000
98,01100010,63,00111111,161,10100001
48,00110000,99,01100011,147,10010011
33,00100001,124,01111100,157,10011101
123,01111011,27,00011011,150,10010110
32,00100000,12,00001100,44,00101100
12,00001100,3,00000011,15,00001111
99,01100011,121,01111001,220,11011100
118,01110110,53,00110101,171,10101011
5,00000101,7,00000111,12,00001100
96,01100000,100,01100100,196,11000100
86,01010110,82,01010010,168,10101000
91,01011011,31,00011111,122,01111010
77,01001101,70,01000110,147,10010011
26,00011010,7,00000111,33,00100001
93,01011101,99,01100011,192,11000000
29,00011101,125,01111101,154,10011010
22,00010110,44,00101100,66,01000010
48,00110000,98,01100010,146,10010010
97,01100001,100,01100100,197,11000101
46,00101110,47,00101111,93,01011101
90,01011010,119,01110111,209,11010001
79,01001111,51,00110011,130,10000010
85,01010101,8,00001000,93,01011101
115,01110011,40,00101000,155,10011011
83,01010011,34,00100010,117,01110101
121,01111001,38,00100110,159,10011111
27,00011011,114,01110010,141,10001101
78,01001110,37,00100101,115,01110011
74,01001010,99,01100011,173,10101101
33,00100001,102,01100110,135,10000111
85,01010101,127,01111111,212,11010100
56,00111000,78,01001110,134,10000110
122,01111010,106,01101010,228,11100100
119,01110111,14,00001110,133,10000101
50,00110010,118,01110110,168,10101000
98,01100010,23,00010111,121,01111001
91,01011011,103,01100111,194,11000010
16,00010000,63,00111111,79,01001111
99,01100011,81,01010001,180,10110100
93,01011101,40,00101000,133,10000101
5,00000101,55,00110111,60,00111100
29,00011101,124,01111100,153,10011001
97,01100001,45,00101101,142,10001110
15,00001111,101,01100101,116,01110100
118,01110110,59,00111011,177,10110001
21,00010101,7,00000111,28,00011100
106,01101010,85,01010101,191,10111111
19,00010011,83,01010011,102,01100110
67,01000011,113,01110001,180,10110100
76,01001100,79,01001111,155,10011011
70,01000110,6,00000110,76,01001100
78,01001110,66,01000010,144,10010000
21,00010101,122,01111010,143,10001111
67,01000011,51,00110011,118,01110110
91,01011011,94,01011110,185,10111001
31,00011111,115,01110011,146,10010010
97,01100001,103,01100111,200,11001000
105,01101001,61,00111101,166,10100110
119,01110111,53,00110101,172,10101100
32,00100000,16,00010000,48,00110000
53,00110101,71,01000111,124,01111100
89,01011001,51,00110011,140,10001100
114,01110010,121,01111001,235,11101011
9,00001001,8,00001000,17,00010001
39,00100111,108,01101100,147,10010011
82,01010010,10,00001010,92,01011100
13,00001101,31,00011111,44,00101100
44,00101100,96,01100000,140,10001100
95,01011111,70,01000110,165,10100101
66,01000010,40,00101000,106,01101010
61,00111101,120,01111000,181,10110101
110,01101110,91,01011011,201,11001001
85,01010101,116,01110100,201,11001001
44,00101100,91,01011011,135,10000111
96,01100000,127,01111111,223,11011111
40,00101000,10,00001010,50,00110010
52,00110100,69,01000101,121,01111001
10,00001010,90,01011010,100,01100100
118,01110110,118,01110110,236,11101100
21,00010101,36,00100100,57,00111001
50,00110010,111,01101111,161,10100001
20,00010100,56,00111000,76,01001100
127,01111111,101,01100101,228,11100100
56,00111000,57,00111001,113,01110001
18,00010010,18,00010010,36,00100100
28,00011100,2,00000010,30,00011110
49,00110001,47,00101111,96,01100000
51,00110011,99,01100011,150,10010110
118,01110110,80,01010000,198,11000110
113,01110001,78,01001110,191,10111111
14,00001110,8,00001000,22,00010110
62,00111110,5,00000101,67,01000011
68,01000100,43,00101011,111,01101111
37,00100101,69,01000101,106,01101010
46,00101110,68,01000100,114,01110010
41,00101001,14,00001110,55,00110111
16,00010000,88,01011000,104,01101000
53,00110101,26,00011010,79,01001111
57,00111001,9,00001001,66,01000010
48,00110000,84,01010100,132,10000100
90,01011010,0,00000000,90,01011010
77,01001101,3,00000011,80,01010000
66,01000010,10,00001010,76,01001100
109,01101101,80,01010000,189,10111101
59,00111011,2,00000010,61,00111101
70,01000110,60,00111100,130,10000010
112,01110000,60,00111100,172,10101100
95,01011111,28,00011100,123,01111011
117,01110101,56,00111000,173,10101101
84,01010100,6,00000110,90,01011010
17,00010001,123,01111011,140,10001100
51,00110011,20,00010100,71,01000111
91,01011011,18,00010010,109,01101101
114,01110010,69,01000101,183,10110111
83,01010011,49,00110001,132,10000100
1,00000001,15,00001111,16,00010000
80,01010000,13,00001101,93,01011101
72,01001000,42,00101010,114,01110010
101,01100101,115,01110011,216,11011000
4,00000100,30,00011110,34,00100010
38,00100110,120,01111000,158,10011110
70,01000110,115,01110011,185,10111001
49,00110001,43,00101011,92,01011100
89,01011001,126,01111110,215,11010111
32,00100000,95,01011111,127,01111111
42,00101010,61,00111101,103,01100111
117,01110101,65,01000001,182,10110110
91,01011011,64,01000000,155,10011011
60,00111100,0,00000000,60,00111100
15,00001111,0,00000000,15,00001111
98,01100010,103,01100111,201,11001001
26,00011010,97,01100001,123,01111011
113,01110001,1,00000001,114,01110010
60,00111100,95,01011111,155,10011011
26,00011010,125,01111101,151,10010111
35,00100011,42,00101010,77,01001101
91,01011011,84,01010100,175,10101111
60,00111100,19,00010011,79,01001111
83,01010011,9,00001001,92,01011100
124,01111100,69,01000101,193,11000001
47,00101111,62,00111110,109,01101101
2,00000010,95,01011111,97,01100001
11,00001011,113,01110001,124,01111100
17,00010001,68,01000100,85,01010101
79,01001111,57,00111001,136,10001000
1,00000001,0,00000000,1,00000001
3,00000011,56,00111000,59,00111011
66,01000010,70,01000110,136,10001000
64,01000000,66,01000010,130,10000010
78,01001110,118,01110110,196,11000100
34,00100010,108,01101100,142,10001110
95,01011111,120,01111000,215,11010111
60,00111100,127,01111111,187,10111011
30,00011110,93,01011101,123,01111011
126,01111110,17,00010001,143,10001111
68,01000100,64,01000000,132,10000100
124,01111100,67,01000011,191,10111111
55,00110111,59,00111011,114,01110010
101,01100101,87,01010111,188,10111100
3,00000011,103,01100111,106,01101010
6,00000110,73,01001001,79,01001111
16,00010000,120,01111000,136,10001000
19,00010011,83,01010011,102,01100110
20,00010100,105,01101001,125,01111101
65,01000001,30,00011110,95,01011111
52,00110100,95,01011111,147,10010011
39,00100111,27,00011011,66,01000010
32,00100000,85,01010101,117,01110101
109,01101101,36,00100100,145,10010001
1,00000001,103,01100111,104,01101000
3,00000011,42,00101010,45,00101101
20,00010100,107,01101011,127,01111111
85,01010101,80,01010000,165,10100101
122,01111010,10,00001010,132,10000100
64,01000000,93,01011101,157,10011101
8,00001000,104,01101000,112,01110000
77,01001101,52,00110100,129,10000001
4,00000100,3,00000011,7,00000111
66,01000010,2,00000010,68,01000100
5,00000101,50,00110010,55,00110111
53,00110101,41,00101001,94,01011110
9,00001001,112,01110000,121,01111001
10,00001010,67,01000011,77,01001101
27,00011011,103,01100111,130,10000010
91,01011011,23,00010111,114,01110010
33,00100001,127,01111111,160,10100000
121,01111001,84,01010100,205,11001101
7,00000111,90,01011010,97,01100001
122,01111010,86,01010110,208,11010000
7,00000111,111,01101111,118,01110110
98,01100010,46,00101110,144,10010000
111,01101111,110,01101110,221,11011101
12,00001100,19,00010011,31,00011111
119,01110111,83,01010011,202,11001010
108,01101100,108,01101100,216,11011000
22,00010110,66,01000010,88,01011000
78,01001110,68,01000100,146,10010010
78,01001110,94,01011110,172,10101100
94,01011110,21,00010101,115,01110011
117,01110101,122,01111010,239,11101111
80,01010000,18,00010010,98,01100010
96,01100000,113,01110001,209,11010001
81,01010001,74,01001010,155,10011011
9,00001001,58,00111010,67,01000011
94,01011110,4,00000100,98,01100010
44,00101100,33,00100001,77,01001101
97,01100001,15,00001111,112,01110000
126,01111110,66,01000010,192,11000000
61,00111101,40,00101000,101,01100101
16,00010000,77,01001101,93,01011101
21,00010101,125,01111101,146,10010010
75,01001011,121,01111001,196,11000100
81,01010001,114,01110010,195,11000011
111,01101111,57,00111001,168,10101000
102,01100110,37,00100101,139,10001011
74,01001010,105,01101001,179,10110011
2,00000010,120,01111000,122,01111010
87,01010111,70,01000110,157,10011101
20,00010100,20,00010100,40,00101000
61,00111101,102,01100110,163,10100011
5,00000101,49,00110001,54,00110110
69,01000101,117,01110101,186,10111010
80,01010000,76,01001100,156,10011100
22,00010110,116,01110100,138,10001010
50,00110010,79,01001111,129,10000001
39,00100111,68,01000100,107,01101011
39,00100111,17,00010001,56,00111000
48,00110000,95,01011111,143,10001111
26,00011010,29,00011101,55,00110111
11,00001011,127,01111111,138,10001010
102,01100110,65,01000001,167,10100111
122,01111010,114,01110010,236,11101100
29,00011101,46,00101110,75,01001011
125,01111101,107,01101011,232,11101000
48,00110000,119,01110111,167,10100111
102,01100110,51,00110011,153,10011001
127,01111111,3,00000011,130,10000010
81,01010001,62,00111110,143,10001111
81,01010001,4,00000100,85,01010101
82,01010010,81,01010001,163,10100011
98,01100010,67,01000011,165,10100101
29,00011101,49,00110001,78,01001110
113,01110001,19,00010011,132,10000100
46,00101110,82,01010010,128,10000000
39,00100111,74,01001010,113,01110001
125,01111101,93,01011101,218,11011010
72,01001000,126,01111110,198,11000110
40,00101000,88,01011000,128,10000000
98,01100010,110,01101110,208,11010000
59,00111011,85,01010101,144,10010000
110,01101110,5,00000101,115,01110011
68,01000100,36,00100100,104,01101000
124,01111100,39,00100111,163,10100011
118,01110110,85,01010101,203,11001011
121,01111001,36,00100100,157,10011101
46,00101110,76,01001100,122,01111010
77,01001101,67,01000011,144,10010000
45,00101101,40,00101000,85,01010101
35,00100011,105,01101001,140,10001100
103,01100111,56,00111000,159,10011111
114,01110010,30,00011110,144,10010000
42,00101010,81,01010001,123,01111011
91,01011011,67,01000011,158,10011110
26,00011010,11,00001011,37,00100101
42,00101010,75,01001011,117,01110101
121,01111001,19,00010011,140,10001100
115,01110011,85,01010101,200,11001000
3,00000011,100,01100100,103,01100111
52,00110100,126,01111110,178,10110010
21,00010101,122,01111010,143,10001111
105,01101001,113,01110001,218,11011010
108,01101100,103,01100111,211,11010011
90,01011010,109,01101101,199,11000111
93,01011101,81,01010001,174,10101110
13,00001101,62,00111110,75,01001011
65,01000001,118,01110110,183,10110111
21,00010101,75,01001011,96,01100000
84,01010100,73,01001001,157,10011101
124,01111100,11,00001011,135,10000111
7,00000111,28,00011100,35,00100011
15,00001111,101,01100101,116,01110100
91,01011011,21,00010101,112,01110000
25,00011001,88,01011000,113,01110001
102,01100110,73,01001001,175,10101111
73,01001001,123,01111011,196,11000100
33,00100001,76,01001100,109,01101101
1,00000001,92,01011100,93,01011101
120,01111000,103,01100111,223,11011111
109,01101101,36,00100100,145,10010001
92,01011100,35,00100011,127,01111111
43,00101011,67,01000011,110,01101110
28,00011100,9,00001001,37,00100101
35,00100011,6,00000110,41,00101001
15,00001111,118,01110110,133,10000101
87,01010111,81,01010001,168,10101000
102,01100110,89,01011001,191,10111111
6,00000110,81,01010001,87,01010111
103,01100111,85,01010101,188,10111100
125,01111101,75,01001011,200,11001000
25,00011001,40,00101000,65,01000001
7,00000111,108,01101100,115,01110011
27,00011011,109,01101101,136,10001000
10,00001010,41,00101001,51,00110011
76,01001100,63,00111111,139,10001011
90,01011010,74,01001010,164,10100100
100,01100100,37,00100101,137,10001001
96,01100000,5,00000101,101,01100101
124,01111100,57,00111001,181,10110101
57,00111001,73,01001001,130,10000010
90,01011010,43,00101011,133,10000101
38,00100110,88,01011000,126,01111110
4,00000100,74,01001010,78,01001110
94,01011110,89,01011001,183,10110111
124,01111100,53,00110101,177,10110001
47,00101111,32,00100000,79,01001111
27,00011011,89,01011001,116,01110100
27,00011011,2,00000010,29,00011101
62,00111110,61,00111101,123,01111011
14,00001110,107,01101011,121,01111001
65,01000001,1,00000001,66,01000010
8,00001000,122,01111010,130,10000010
103,01100111,56,00111000,159,10011111
54,00110110,27,00011011,81,01010001
60,00111100,57,00111001,117,01110101
8,00001000,21,00010101,29,00011101
1,00000001,61,00111101,62,00111110
4,00000100,17,00010001,21,00010101
3,00000011,30,00011110,33,00100001
44,00101100,50,00110010,94,01011110
87,01010111,80,01010000,167,10100111
127,01111111,89,01011001,216,11011000
91,01011011,15,00001111,106,01101010
24,00011000,1,00000001,25,00011001
115,01110011,52,00110100,167,10100111
10,00001010,73,01001001,83,01010011
45,00101101,73,01001001,118,01110110
1,00000001,74,01001010,75,01001011
41,00101001,106,01101010,147,10010011
29,00011101,82,01010010,111,01101111
76,01001100,125,01111101,201,11001001
64,01000000,59,00111011,123,01111011
93,01011101,66,01000010,159,10011111
69,01000101,16,00010000,85,01010101
14,00001110,10,00001010,24,00011000
4,00000100,124,01111100,128,10000000
62,00111110,6,00000110,68,01000100
108,01101100,23,00010111,131,10000011
85,01010101,4,00000100,89,01011001
55,00110111,104,01101000,159,10011111
1,00000001,79,01001111,80,01010000
77,01001101,43,00101011,120,01111000
114,01110010,41,00101001,155,10011011
48,00110000,94,01011110,142,10001110
104,01101000,99,01100011,203,11001011
77,01001101,91,01011011,168,10101000
39,00100111,76,01001100,115,01110011
41,00101001,6,00000110,47,00101111
40,00101000,17,00010001,57,00111001
37,00100101,2,00000010,39,00100111
60,00111100,121,01111001,181,10110101
106,01101010,67,01000011,173,10101101
124,01111100,44,00101100,168,10101000
125,01111101,42,00101010,167,10100111
76,01001100,88,01011000,164,10100100
124,01111100,121,01111001,245,11110101
110,01101110,77,01001101,187,10111011
3,00000011,41,00101001,44,00101100
82,01010010,116,01110100,198,11000110
85,01010101,103,01100111,188,10111100
101,01100101,59,00111011,160,10100000
91,01011011,13,00001101,104,01101000
23,00010111,116,01110100,139,10001011
78,01001110,81,01010001,159,10011111
88,01011000,98,01100010,186,10111010
14,00001110,4,00000100,18,00010010
120,01111000,30,00011110,150,10010110
92,01011100,53,00110101,145,10010001
98,01100010,81,01010001,179,10110011
33,00100001,74,01001010,107,01101011
34,00100010,62,00111110,96,01100000
57,00111001,21,00010101,78,01001110
81,01010001,68,01000100,149,10010101
14,00001110,96,01100000,110,01101110
100,01100100,107,01101011,207,11001111
24,00011000,96,01100000,120,01111000
74,01001010,62,00111110,136,10001000
127,01111111,126,01111110,253,11111101
4,00000100,110,01101110,114,01110010
0,00000000,80,01010000,80,01010000
34,00100010,81,01010001,115,01110011
99,01100011,121,01111001,220,11011100
72,01001000,93,01011101,165,10100101
13,00001101,27,00011011,40,00101000
73,01001001,49,00110001,122,01111010
53,00110101,37,00100101,90,01011010
53,00110101,126,01111110,179,10110011
101,01100101,52,00110100,153,10011001
21,00010101,21,00010101,42,00101010
44,00101100,118,01110110,162,10100010
43,00101011,35,00100011,78,01001110
104,01101000,28,00011100,132,10000100
109,01101101,74,01001010,183,10110111
88,01011000,26,00011010,114,01110010
4,00000100,65,01000001,69,01000101
25,00011001,24,00011000,49,00110001
59,00111011,46,00101110,105,01101001
36,00100100,102,01100110,138,10001010
82,01010010,42,00101010,124,01111100
15,00001111,40,00101000,55,00110111
103,01100111,0,00000000,103,01100111
12,00001100,1,00000001,13,00001101
48,00110000,60,00111100,108,01101100
33,00100001,126,01111110,159,10011111
75,01001011,125,01111101,200,11001000
39,00100111,75,01001011,114,01110010
107,01101011,66,01000010,173,10101101
27,00011011,84,01010100,111,01101111
0,00000000,25,00011001,25,00011001
36,00100100,97,01100001,133,10000101
0,00000000,98,01100010,98,01100010
80,01010000,88,01011000,168,10101000
56,00111000,23,00010111,79,01001111
85,01010101,25,00011001,110,01101110
45,00101101,16,00010000,61,00111101
92,01011100,59,00111011,151,10010111
19,00010011,69,01000101,88,01011000
12,00001100,2,00000010,14,00001110
43,00101011,49,00110001,92,01011100
98,01100010,63,00111111,161,10100001
120,01111000,86,01010110,206,11001110
34,00100010,5,00000101,39,00100111
31,00011111,55,00110111,86,01010110
40,00101000,83,01010011,123,01111011
38,00100110,120,01111000,158,10011110
58,00111010,56,00111000,114,01110010
36,00100100,63,00111111,99,01100011
87,01010111,88,01011000,175,10101111
116,01110100,126,01111110,242,11110010
39,00100111,73,01001001,112,01110000
108,01101100,62,00111110,170,10101010
22,00010110,82,01010010,104,01101000
47,00101111,49,00110001,96,01100000
58,00111010,97,01100001,155,10011011
119,01110111,110,01101110,229,11100101
81,01010001,92,01011100,173,10101101
61,00111101,13,00001101,74,01001010
77,01001101,25,00011001,102,01100110
34,00100010,13,00001101,47,00101111
90,01011010,33,00100001,123,01111011
126,01111110,81,01010001,207,11001111
56,00111000,120,01111000,176,10110000
113,01110001,89,01011001,202,11001010
117,01110101,107,01101011,224,11100000
53,00110101,112,01110000,165,10100101
47,00101111,109,01101101,156,10011100
52,00110100,106,01101010,158,10011110
100,01100100,93,01011101,193,11000001
70,01000110,104,01101000,174,10101110
80,01010000,29,00011101,109,01101101
67,01000011,14,00001110,81,01010001
19,00010011,92,01011100,111,01101111
110,01101110,127,01111111,237,11101101
35,00100011,35,00100011,70,01000110
97,01100001,63,00111111,160,10100000
125,01111101,9,00001001,134,10000110
37,00100101,93,01011101,130,10000010
115,01110011,66,01000010,181,10110101
114,01110010,78,01001110,192,11000000
7,00000111,1,00000001,8,00001000
106,01101010,109,01101101,215,11010111
74,01001010,41,00101001,115,01110011
14,00001110,2,00000010,16,00010000
84,01010100,92,01011100,176,10110000
48,00110000,101,01100101,149,10010101
106,01101010,70,01000110,176,10110000
108,01101100,76,01001100,184,10111000
116,01110100,70,01000110,186,10111010
111,01101111,75,01001011,186,10111010
22,00010110,22,00010110,44,00101100
22,00010110,113,01110001,135,10000111
98,01100010,15,00001111,113,01110001
125,01111101,28,00011100,153,10011001
24,00011000,54,00110110,78,01001110
51,00110011,75,01001011,126,01111110
45,00101101,41,00101001,86,01010110
125,01111101,74,01001010,199,11000111
7,00000111,112,01110000,119,01110111
37,00100101,82,01010010,119,01110111
85,01010101,92,01011100,177,10110001
7,00000111,53,00110101,60,00111100
32,00100000,125,01111101,157,10011101
0,00000000,34,00100010,34,00100010
114,01110010,107,01101011,221,11011101
101,01100101,92,01011100,193,11000001
126,01111110,29,00011101,155,10011011
70,01000110,68,01000100,138,10001010
9,00001001,7,00000111,16,00010000
82,01010010,108,01101100,190,10111110
94,01011110,77,01001101,171,10101011
109,01101101,127,01111111,236,11101100
89,01011001,103,01100111,192,11000000
34,00100010,111,01101111,145,10010001
105,01101001,45,00101101,150,10010110
20,00010100,107,01101011,127,01111111
88,01011000,15,00001111,103,01100111
79,01001111,85,01010101,164,10100100
43,00101011,55,00110111,98,01100010
70,01000110,30,00011110,100,01100100
22,00010110,32,00100000,54,00110110
113,01110001,18,00010010,131,10000011
10,00001010,93,01011101,103,01100111
127,01111111,90,01011010,217,11011001
75,01001011,26,00011010,101,01100101
29,00011101,80,01010000,109,01101101
72,01001000,8,00001000,80,01010000
34,00100010,92,01011100,126,01111110
38,00100110,127,01111111,165,10100101
104,01101000,0,00000000,104,01101000
100,01100100,125,01111101,225,11100001
26,00011010,14,00001110,40,00101000
122,01111010,59,00111011,181,10110101
98,01100010,32,00100000,130,10000010
51,00110011,103,01100111,154,10011010
100,01100100,84,01010100,184,10111000
57,00111001,126,01111110,183,10110111
3,00000011,124,01111100,127,01111111
31,00011111,14,00001110,45,00101101
1,00000001,95,01011111,96,01100000
32,00100000,124,01111100,156,10011100
118,01110110,113,01110001,231,11100111
97,01100001,11,00001011,108,01101100
74,01001010,120,01111000,194,11000010
114,01110010,49,00110001,163,10100011
12,00001100,66,01000010,78,01001110
5,00000101,15,00001111,20,00010100
23,00010111,125,01111101,148,10010100
50,00110010,28,00011100,78,01001110
14,00001110,106,01101010,120,01111000
53,00110101,63,00111111,116,01110100
20,00010100,104,01101000,124,01111100
126,01111110,5,00000101,131,10000011
51,00110011,20,00010100,71,01000111
100,01100100,94,01011110,194,11000010
60,00111100,51,00110011,111,01101111
65,01000001,37,00100101,102,01100110
86,01010110,56,00111000,142,10001110
22,00010110,37,00100101,59,00111011
79,01001111,20,00010100,99,01100011
122,01111010,55,00110111,177,10110001
48,00110000,47,00101111,95,01011111
108,01101100,41,00101001,149,10010101
74,01001010,100,01100100,174,10101110
99,01100011,42,00101010,141,10001101
14,00001110,30,00011110,44,00101100
47,00101111,91,01011011,138,10001010
64,01000000,98,01100010,162,10100010
5,00000101,58,00111010,63,00111111
51,00110011,78,01001110,129,10000001
96,01100000,0,00000000,96,01100000
67,01000011,76,01001100,143,10001111
89,01011001,31,00011111,120,01111000
3,00000011,107,01101011,110,01101110
71,01000111,92,01011100,163,10100011
111,01101111,52,00110100,163,10100011
13,00001101,47,00101111,60,00111100
13,00001101,58,00111010,71,01000111
62,00111110,103,01100111,165,10100101
14,00001110,90,01011010,104,01101000
40,00101000,60,00111100,100,01100100
22,00010110,110,01101110,132,10000100
64,01000000,110,01101110,174,10101110
27,00011011,112,01110000,139,10001011
3,00000011,91,01011011,94,01011110
63,00111111,28,00011100,91,01011011
16,00010000,28,00011100,44,00101100
53,00110101,115,01110011,168,10101000
21,00010101,90,01011010,111,01101111
105,01101001,57,00111001,162,10100010
68,01000100,43,00101011,111,01101111
63,00111111,76,01001100,139,10001011
52,00110100,62,00111110,114,01110010
87,01010111,85,01010101,172,10101100
34,00100010,6,00000110,40,00101000
84,01010100,54,00110110,138,10001010
56,00111000,37,00100101,93,01011101
15,00001111,126,01111110,141,10001101
14,00001110,61,00111101,75,01001011
98,01100010,25,00011001,123,01111011
12,00001100,68,01000100,80,01010000
105,01101001,58,00111010,163,10100011
13,00001101,58,00111010,71,01000111
43,00101011,32,00100000,75,01001011
82,01010010,78,01001110,160,10100000
38,00100110,125,01111101,163,10100011
62,00111110,100,01100100,162,10100010
40,00101000,90,01011010,130,10000010
94,01011110,39,00100111,133,10000101
59,00111011,0,00000000,59,00111011
33,00100001,52,00110100,85,01010101
88,01011000,80,01010000,168,10101000
8,00001000,96,01100000,104,01101000
65,01000001,16,00010000,81,01010001
23,00010111,93,01011101,116,01110100
7,00000111,93,01011101,100,01100100
37,00100101,1,00000001,38,00100110
48,00110000,56,00111000,104,01101000
41,00101001,110,01101110,151,10010111
103,01100111,16,00010000,119,01110111
42,00101010,57,00111001,99,01100011
125,01111101,36,00100100,161,10100001
26,00011010,32,00100000,58,00111010
112,01110000,20,00010100,132,10000100
42,00101010,61,00111101,103,01100111
9,00001001,18,00010010,27,00011011
36,00100100,81,01010001,117,01110101
118,01110110,121,01111001,239,11101111
19,00010011,72,01001000,91,01011011
62,00111110,25,00011001,87,01010111
25,00011001,11,00001011,36,00100100
35,00100011,49,00110001,84,01010100
100,01100100,85,01010101,185,10111001
125,01111101,15,00001111,140,10001100
51,00110011,90,01011010,141,10001101
28,00011100,98,01100010,126,01111110
18,00010010,94,01011110,112,01110000
92,01011100,105,01101001,197,11000101
24,00011000,69,01000101,93,01011101
87,01010111,90,01011010,177,10110001
20,00010100,71,01000111,91,01011011
66,01000010,16,00010000,82,01010010
115,01110011,91,01011011,206,11001110
53,00110101,29,00011101,82,01010010
71,01000111,99,01100011,170,10101010
37,00100101,38,00100110,75,01001011
10,00001010,34,00100010,44,00101100
84,01010100,14,00001110,98,01100010
30,00011110,54,00110110,84,01010100
89,01011001,38,00100110,127,01111111
96,01100000,59,00111011,155,10011011
97,01100001,56,00111000,153,10011001
19,00010011,83,01010011,102,01100110
29,00011101,101,01100101,130,10000010
126,01111110,1,00000001,127,01111111
126,01111110,53,00110101,179,10110011
72,01001000,4,00000100,76,01001100
37,00100101,51,00110011,88,01011000
102,01100110,89,01011001,191,10111111
89,01011001,118,01110110,207,11001111
37,00100101,60,00111100,97,01100001
102,01100110,116,01110100,218,11011010
23,00010111,121,01111001,144,10010000
126,01111110,113,01110001,239,11101111
55,00110111,77,01001101,132,10000100
114,01110010,32,00100000,146,10010010
20,00010100,124,01111100,144,10010000
28,00011100,113,01110001,141,10001101
37,00100101,70,01000110,107,01101011
115,01110011,64,01000000,179,10110011
101,01100101,81,01010001,182,10110110
126,01111110,80,01010000,206,11001110
85,01010101,73,01001001,158,10011110
116,01110100,107,01101011,223,11011111
66,01000010,1,00000001,67,01000011
1,00000001,103,01100111,104,01101000
86,01010110,20,00010100,106,01101010
126,01111110,74,01001010,200,11001000
108,01101100,9,00001001,117,01110101
4,00000100,45,00101101,49,00110001
55,00110111,87,01010111,142,10001110
63,00111111,112,01110000,175,10101111
72,01001000,119,01110111,191,10111111
16,00010000,34,00100010,50,00110010
45,00101101,30,00011110,75,01001011
8,00001000,35,00100011,43,00101011
58,00111010,60,00111100,118,01110110
92,01011100,54,00110110,146,10010010
23,00010111,5,00000101,28,00011100
99,01100011,120,01111000,219,11011011
92,01011100,76,01001100,168,10101000
36,00100100,90,01011010,126,01111110
20,00010100,99,01100011,119,01110111
87,01010111,125,01111101,212,11010100
66,01000010,74,01001010,140,10001100
4,00000100,125,01111101,129,10000001
113,01110001,99,01100011,212,11010100
35,00100011,51,00110011,86,01010110
18,00010010,18,00010010,36,00100100
26,00011010,127,01111111,153,10011001
58,00111010,106,01101010,164,10100100
33,00100001,39,00100111,72,01001000
83,01010011,83,01010011,166,10100110
4,00000100,14,00001110,18,00010010
75,01001011,101,01100101,176,10110000
85,01010101,5,00000101,90,01011010
105,01101001,14,00001110,119,01110111
70,01000110,78,01001110,148,10010100
6,00000110,74,01001010,80,01010000
17,00010001,109,01101101,126,01111110
87,01010111,66,01000010,153,10011001
86,01010110,60,00111100,146,10010010
18,00010010,80,01010000,98,01100010
119,01110111,48,00110000,167,10100111
66,01000010,72,01001000,138,10001010
85,01010101,99,01100011,184,10111000
11,00001011,41,00101001,52,00110100
79,01001111,51,00110011,130,10000010
20,00010100,116,01110100,136,10001000
86,01010110,101,01100101,187,10111011
89,01011001,71,01000111,160,10100000
88,01011000,108,01101100,196,11000100
43,00101011,15,00001111,58,00111010
111,01101111,75,01001011,186,10111010
23,00010111,42,00101010,65,01000001
89,01011001,96,01100000,185,10111001
117,01110101,87,01010111,204,11001100
103,01100111,110,01101110,213,11010101
18,00010010,109,01101101,127,01111111
45,00101101,35,00100011,80,01010000
33,00100001,49,00110001,82,01010010
44,00101100,75,01001011,119,01110111
61,00111101,43,00101011,104,01101000
34,00100010,27,00011011,61,00111101
14,00001110,3,00000011,17,00010001
72,01001000,65,01000001,137,10001001
8,00001000,79,01001111,87,01010111
77,01001101,54,00110110,131,10000011
123,01111011,45,00101101,168,10101000
66,01000010,52,00110100,118,01110110
72,01001000,125,01111101,197,11000101
119,01110111,104,01101000,223,11011111
58,00111010,83,01010011,141,10001101
12,00001100,120,01111000,132,10000100
18,00010010,126,01111110,144,10010000
48,00110000,91,01011011,139,10001011
91,01011011,21,00010101,112,01110000
16,00010000,38,00100110,54,00110110
68,01000100,95,01011111,163,10100011
23,00010111,45,00101101,68,01000100
99,01100011,15,00001111,114,01110010
17,00010001,108,01101100,125,01111101
75,01001011,124,01111100,199,11000111
33,00100001,21,00010101,54,00110110
24,00011000,78,01001110,102,01100110
81,01010001,100,01100100,181,10110101
29,00011101,31,00011111,60,00111100
109,01101101,106,01101010,215,11010111
69,01000101,101,01100101,170,10101010
2,00000010,52,00110100,54,00110110
29,00011101,118,01110110,147,10010011
31,00011111,98,01100010,129,10000001
67,01000011,118,01110110,185,10111001
12,00001100,99,01100011,111,01101111
20,00010100,38,00100110,58,00111010
49,00110001,118,01110110,167,10100111
44,00101100,28,00011100,72,01001000
8,00001000,82,01010010,90,01011010
10,00001010,81,01010001,91,01011011
33,00100001,105,01101001,138,10001010
88,01011000,57,00111001,145,10010001
54,00110110,12,00001100,66,01000010
77,01001101,2,00000010,79,01001111
91,01011011,28,00011100,119,01110111
20,00010100,64,01000000,84,01010100
40,00101000,104,01101000,144,10010000
106,01101010,21,00010101,127,01111111
117,01110101,23,00010111,140,10001100
81,01010001,29,00011101,110,01101110
98,01100010,122,01111010,220,11011100
106,01101010,42,00101010,148,10010100
27,00011011,38,00100110,65,01000001
118,01110110,119,01110111,237,11101101
9,00001001,58,00111010,67,01000011
125,01111101,114,01110010,239,11101111
34,00100010,122,01111010,156,10011100
55,00110111,37,00100101,92,01011100
47,00101111,89,01011001,136,10001000
21,00010101,110,01101110,131,10000011
45,00101101,31,00011111,76,01001100
11,00001011,13,00001101,24,00011000
52,00110100,15,00001111,67,01000011
20,00010100,9,00001001,29,00011101
104,01101000,16,00010000,120,01111000
38,00100110,40,00101000,78,01001110
46,00101110,123,01111011,169,10101001
83,01010011,120,01111000,203,11001011
16,00010000,69,01000101,85,01010101
18,00010010,90,01011010,108,01101100
103,01100111,96,01100000,199,11000111
43,00101011,107,01101011,150,10010110
40,00101000,57,00111001,97,01100001
74,01001010,95,01011111,169,10101001
70,01000110,38,00100110,108,01101100
25,00011001,123,01111011,148,10010100
73,01001001,60,00111100,133,10000101
100,01100100,71,01000111,171,10101011
19,00010011,5,00000101,24,00011000
6,00000110,27,00011011,33,00100001
25,00011001,112,01110000,137,10001001
83,01010011,39,00100111,122,01111010
122,01111010,21,00010101,143,10001111
120,01111000,102,01100110,222,11011110
76,01001100,24,00011000,100,01100100
95,01011111,113,01110001,208,11010000
91,01011011,122,01111010,213,11010101
62,00111110,49,00110001,111,01101111
51,00110011,77,01001101,128,10000000
13,00001101,64,01000000,77,01001101
76,01001100,19,00010011,95,01011111
55,00110111,75,01001011,130,10000010
60,00111100,73,01001001,133,10000101
91,01011011,104,01101000,195,11000011
114,01110010,39,00100111,153,10011001
55,00110111,99,01100011,154,10011010
39,00100111,58,00111010,97,01100001
47,00101111,119,01110111,166,10100110
44,00101100,123,01111011,167,10100111
15,00001111,87,01010111,102,01100110
95,01011111,43,00101011,138,10001010
82,01010010,54,00110110,136,10001000
12,00001100,112,01110000,124,01111100
127,01111111,3,00000011,130,10000010
104,01101000,81,01010001,185,10111001
11,00001011,102,01100110,113,01110001
127,01111111,98,01100010,225,11100001
60,00111100,32,00100000,92,01011100
1,00000001,63,00111111,64,01000000
43,00101011,23,00010111,66,01000010
1,00000001,62,00111110,63,00111111
120,01111000,55,00110111,175,10101111
50,00110010,34,00100010,84,01010100
35,00100011,64,01000000,99,01100011
27,00011011,92,01011100,119,01110111
14,00001110,94,01011110,108,01101100
9,00001001,11,00001011,20,00010100
89,01011001,87,01010111,176,10110000
116,01110100,91,01011011,207,11001111
30,00011110,127,01111111,157,10011101
95,01011111,77,01001101,172,10101100
72,01001000,18,00010010,90,01011010
16,00010000,68,01000100,84,01010100
14,00001110,119,01110111,133,10000101
11,00001011,87,01010111,98,01100010
1,00000001,108,01101100,109,01101101
59,00111011,82,01010010,141,10001101
71,01000111,26,00011010,97,01100001
117,01110101,76,01001100,193,11000001
41,00101001,41,00101001,82,01010010
48,00110000,82,01010010,130,10000010
68,01000100,67,01000011,135,10000111
105,01101001,2,00000010,107,01101011
22,00010110,125,01111101,147,10010011
10,00001010,44,00101100,54,00110110
104,01101000,6,00000110,110,01101110
117,01110101,101,01100101,218,11011010
37,00100101,15,00001111,52,00110100
81,01010001,102,01100110,183,10110111
103,01100111,65,01000001,168,10101000
103,01100111,5,00000101,108,01101100
70,01000110,78,01001110,148,10010100
26,00011010,8,00001000,34,00100010
72,01001000,77,01001101,149,10010101
24,00011000,95,01011111,119,01110111
48,00110000,85,01010101,133,10000101
117,01110101,107,01101011,224,11100000
64,01000000,78,01001110,142,10001110
92,01011100,32,00100000,124,01111100
126,01111110,59,00111011,185,10111001
65,01000001,119,01110111,184,10111000
118,01110110,31,00011111,149,10010101
85,01010101,74,01001010,159,10011111
63,00111111,24,00011000,87,01010111
15,00001111,64,01000000,79,01001111
121,01111001,23,00010111,144,10010000
58,00111010,71,01000111,129,10000001
102,01100110,91,01011011,193,11000001
83,01010011,40,00101000,123,01111011
41,00101001,123,01111011,164,10100100
82,01010010,56,00111000,138,10001010
125,01111101,22,00010110,147,10010011
43,00101011,60,00111100,103,01100111
14,00001110,37,00100101,51,00110011
80,01010000,96,01100000,176,10110000
103,01100111,40,00101000,143,10001111
33,00100001,32,00100000,65,01000001
59,00111011,95,01011111,154,10011010
108,01101100,95,01011111,203,11001011
93,01011101,28,00011100,121,01111001
47,00101111,73,01001001,120,01111000
62,00111110,115,01110011,177,10110001
25,00011001,87,01010111,112,01110000
33,00100001,112,01110000,145,10010001
34,00100010,37,00100101,71,01000111
89,01011001,17,00010001,106,01101010
119,01110111,108,01101100,227,11100011
114,01110010,103,01100111,217,11011001
26,00011010,76,01001100,102,01100110
77,01001101,102,01100110,179,10110011
92,01011100,105,01101001,197,11000101
50,00110010,49,00110001,99,01100011
24,00011000,67,01000011,91,01011011
24,00011000,29,00011101,53,00110101
68,01000100,73,01001001,141,10001101
68,01000100,48,00110000,116,01110100
104,01101000,37,00100101,141,10001101
122,01111010,66,01000010,188,10111100
86,01010110,55,00110111,141,10001101
72,01001000,45,00101101,117,01110101
64,01000000,59,00111011,123,01111011
69,01000101,12,00001100,81,01010001
59,00111011,18,00010010,77,01001101
74,01001010,27,00011011,101,01100101
2,00000010,115,01110011,117,01110101
14,00001110,111,01101111,125,01111101
113,01110001,96,01100000,209,11010001
6,00000110,60,00111100,66,01000010
124,01111100,4,00000100,128,10000000
66,01000010,66,01000010,132,10000100
45,00101101,89,01011001,134,10000110
73,01001001,122,01111010,195,11000011
95,01011111,126,01111110,221,11011101
24,00011000,79,01001111,103,01100111
18,00010010,14,00001110,32,00100000
75,01001011,42,00101010,117,01110101
111,01101111,32,00100000,143,10001111
77,01001101,14,00001110,91,01011011
106,01101010,18,00010010,124,01111100
30,00011110,74,01001010,104,01101000
55,00110111,121,01111001,176,10110000
98,01100010,45,00101101,143,10001111
99,01100011,43,00101011,142,10001110
110,01101110,85,01010101,195,11000011
84,01010100,22,00010110,106,01101010
79,01001111,33,00100001,112,01110000
56,00111000,91,01011011,147,10010011
97,01100001,96,01100000,193,11000001
91,01011011,96,01100000,187,10111011
113,01110001,92,01011100,205,11001101
125,01111101,5,00000101,130,10000010
20,00010100,125,01111101,145,10010001
9,00001001,101,01100101,110,01101110
38,00100110,17,00010001,55,00110111
6,00000110,68,01000100,74,01001010
74,01001010,94,01011110,168,10101000
2,00000010,110,01101110,112,01110000
18,00010010,56,00111000,74,01001010
42,00101010,31,00011111,73,01001001
29,00011101,52,00110100,81,01010001
50,00110010,59,00111011,109,01101101
92,01011100,100,01100100,192,11000000
50,00110010,85,01010101,135,10000111
60,00111100,35,00100011,95,01011111
80,01010000,105,01101001,185,10111001
17,00010001,27,00011011,44,00101100
83,01010011,77,01001101,160,10100000
33,00100001,89,01011001,122,01111010
13,00001101,124,01111100,137,10001001
5,00000101,41,00101001,46,00101110
53,00110101,88,01011000,141,10001101
108,01101100,2,00000010,110,01101110
73,01001001,79,01001111,152,10011000
63,00111111,3,00000011,66,01000010
61,00111101,64,01000000,125,01111101
44,00101100,80,01010000,124,01111100
98,01100010,30,00011110,128,10000000
84,01010100,102,01100110,186,10111010
49,00110001,90,01011010,139,10001011
94,01011110,86,01010110,180,10110100
78,01001110,55,00110111,133,10000101
35,00100011,64,01000000,99,01100011
0,00000000,77,01001101,77,01001101
118,01110110,64,01000000,182,10110110
110,01101110,60,00111100,170,10101010
72,01001000,78,01001110,150,10010110
8,00001000,113,01110001,121,01111001
105,01101001,121,01111001,226,11100010
1,00000001,65,01000001,66,01000010
2,00000010,15,00001111,17,00010001
21,00010101,46,00101110,67,01000011
2,00000010,80,01010000,82,01010010
97,01100001,80,01010000,177,10110001
26,00011010,71,01000111,97,01100001
112,01110000,13,00001101,125,01111101
99,01100011,4,00000100,103,01100111
42,00101010,70,01000110,112,01110000
42,00101010,123,01111011,165,10100101
76,01001100,97,01100001,173,10101101
76,01001100,62,00111110,138,10001010
115,01110011,44,00101100,159,10011111
99,01100011,77,01001101,176,10110000
86,01010110,55,00110111,141,10001101
23,00010111,75,01001011,98,01100010
97,01100001,41,00101001,138,10001010
124,01111100,14,00001110,138,10001010
25,00011001,106,01101010,131,10000011
14,00001110,108,01101100,122,01111010
120,01111000,31,00011111,151,10010111
92,01011100,110,01101110,202,11001010
78,01001110,114,01110010,192,11000000
8,00001000,22,00010110,30,00011110
124,01111100,110,01101110,234,11101010
3,00000011,3,00000011,6,00000110
45,00101101,120,01111000,165,10100101
85,01010101,127,01111111,212,11010100
87,01010111,39,00100111,126,01111110
104,01101000,1,00000001,105,01101001
68,01000100,42,00101010,110,01101110
16,00010000,16,00010000,32,00100000
110,01101110,33,00100001,143,10001111
84,01010100,89,01011001,173,10101101
0,00000000,67,01000011,67,01000011
0,00000000,5,00000101,5,00000101
73,01001001,61,00111101,134,10000110
117,01110101,66,01000010,183,10110111
84,01010100,87,01010111,171,10101011
109,01101101,49,00110001,158,10011110
10,00001010,27,00011011,37,00100101
58,00111010,42,00101010,100,01100100
44,00101100,125,01111101,169,10101001
125,01111101,38,00100110,163,10100011
12,00001100,10,00001010,22,00010110
97,01100001,32,00100000,129,10000001
15,00001111,48,00110000,63,00111111
47,00101111,89,01011001,136,10001000
30,00011110,22,00010110,52,00110100
51,00110011,49,00110001,100,01100100
40,00101000,12,00001100,52,00110100
76,01001100,52,00110100,128,10000000
119,01110111,12,00001100,131,10000011
28,00011100,109,01101101,137,10001001
82,01010010,51,00110011,133,10000101
92,01011100,43,00101011,135,10000111
43,00101011,42,00101010,85,01010101
123,01111011,70,01000110,193,11000001
54,00110110,89,01011001,143,10001111
24,00011000,4,00000100,28,00011100
94,01011110,60,00111100,154,10011010
76,01001100,14,00001110,90,01011010
54,00110110,50,00110010,104,01101000
15,00001111,103,01100111,118,01110110
48,00110000,12,00001100,60,00111100
24,00011000,95,01011111,119,01110111
81,01010001,70,01000110,151,10010111
7,00000111,9,00001001,16,00010000
76,01001100,52,00110100,128,10000000
17,00010001,37,00100101,54,00110110
55,00110111,89,01011001,144,10010000
72,01001000,126,01111110,198,11000110
21,00010101,17,00010001,38,00100110
68,01000100,29,00011101,97,01100001
37,00100101,25,00011001,62,00111110
72,01001000,103,01100111,175,10101111
11,00001011,87,01010111,98,01100010
91,01011011,16,00010000,107,01101011
72,01001000,20,00010100,92,01011100
33,00100001,25,00011001,58,00111010
78,01001110,9,00001001,87,01010111
25,00011001,68,01000100,93,01011101
102,01100110,97,01100001,199,11000111
116,01110100,0,00000000,116,01110100
40,00101000,77,01001101,117,01110101
78,01001110,75,01001011,153,10011001
5,00000101,24,00011000,29,00011101
123,01111011,13,00001101,136,10001000
122,01111010,106,01101010,228,11100100
66,01000010,2,00000010,68,01000100
9,00001001,96,01100000,105,01101001
65,01000001,109,01101101,174,10101110
110,01101110,124,01111100,234,11101010
39,00100111,65,01000001,104,01101000
82,01010010,119,01110111,201,11001001
26,00011010,41,00101001,67,01000011
79,01001111,7,00000111,86,01010110
3,00000011,111,01101111,114,01110010
121,01111001,40,00101000,161,10100001
36,00100100,45,00101101,81,01010001
32,00100000,78,01001110,110,01101110
45,00101101,46,00101110,91,01011011
37,00100101,116,01110100,153,10011001
100,01100100,30,00011110,130,10000010
11,00001011,84,01010100,95,01011111
118,01110110,41,00101001,159,10011111
100,01100100,119,01110111,219,11011011
24,00011000,112,01110000,136,10001000
42,00101010,40,00101000,82,01010010
11,00001011,33,00100001,44,00101100
40,00101000,45,00101101,85,01010101
51,00110011,118,01110110,169,10101001
20,00010100,20,00010100,40,00101000
98,01100010,76,01001100,174,10101110
17,00010001,7,00000111,24,00011000
69,01000101,72,01001000,141,10001101
47,00101111,35,00100011,82,01010010
50,00110010,119,01110111,169,10101001
124,01111100,61,00111101,185,10111001
110,01101110,43,00101011,153,10011001
36,00100100,30,00011110,66,01000010
0,00000000,26,00011010,26,00011010
114,01110010,95,01011111,209,11010001
5,00000101,44,00101100,49,00110001
35,00100011,117,01110101,152,10011000
70,01000110,82,01010010,152,10011000
24,00011000,20,00010100,44,00101100
75,01001011,106,01101010,181,10110101
107,01101011,20,00010100,127,01111111
44,00101100,20,00010100,64,01000000
93,01011101,117,01110101,210,11010010
56,00111000,78,01001110,134,10000110
64,01000000,47,00101111,111,01101111
74,01001010,126,01111110,200,11001000
117,01110101,118,01110110,235,11101011
50,00110010,27,00011011,77,01001101
86,01010110,41,00101001,127,01111111
50,00110010,7,00000111,57,00111001
72,01001000,109,01101101,181,10110101
32,00100000,33,00100001,65,01000001
57,00111001,86,01010110,143,10001111
25,00011001,88,01011000,113,01110001
126,01111110,83,01010011,209,11010001
24,00011000,127,01111111,151,10010111
107,01101011,58,00111010,165,10100101
31,00011111,64,01000000,95,01011111
62,00111110,105,01101001,167,10100111
67,01000011,113,01110001,180,10110100
37,00100101,125,01111101,162,10100010
41,00101001,118,01110110,159,10011111
48,00110000,108,01101100,156,10011100
9,00001001,61,00111101,70,01000110
127,01111111,53,00110101,180,10110100
84,01010100,45,00101101,129,10000001
24,00011000,38,00100110,62,00111110
119,01110111,35,00100011,154,10011010
124,01111100,69,01000101,193,11000001
38,00100110,99,01100011,137,10001001
100,01100100,69,01000101,169,10101001
25,00011001,100,01100100,125,01111101
120,01111000,15,00001111,135,10000111
1,00000001,126,01111110,127,01111111
54,00110110,33,00100001,87,01010111
71,01000111,46,00101110,117,01110101
93,01011101,90,01011010,183,10110111
56,00111000,90,01011010,146,10010010
11,00001011,37,00100101,48,00110000
67,01000011,25,00011001,92,01011100
96,01100000,4,00000100,100,01100100
64,01000000,24,00011000,88,01011000
6,00000110,4,00000100,10,00001010
32,00100000,107,01101011,139,10001011
88,01011000,123,01111011,211,11010011
115,01110011,84,01010100,199,11000111
49,00110001,59,00111011,108,01101100
10,00001010,84,01010100,94,01011110
97,01100001,67,01000011,164,10100100
14,00001110,106,01101010,120,01111000
68,01000100,80,01010000,148,10010100
3,00000011,118,01110110,121,01111001
69,01000101,56,00111000,125,01111101
4,00000100,115,01110011,119,01110111
86,01010110,28,00011100,114,01110010
1,00000001,8,00001000,9,00001001
102,01100110,104,01101000,206,11001110
74,01001010,100,01100100,174,10101110
79,01001111,63,00111111,142,10001110
60,00111100,9,00001001,69,01000101
70,01000110,87,01010111,157,10011101
122,01111010,116,01110100,238,11101110
92,01011100,107,01101011,199,11000111
19,00010011,20,00010100,39,00100111
87,01010111,106,01101010,193,11000001
104,01101000,40,00101000,144,10010000
77,01001101,51,00110011,128,10000000
122,01111010,51,00110011,173,10101101
100,01100100,91,01011011,191,10111111
103,01100111,102,01100110,205,11001101
88,01011000,114,01110010,202,11001010
118,01110110,112,01110000,230,11100110
107,01101011,90,01011010,197,11000101
110,01101110,21,00010101,131,10000011
78,01001110,115,01110011,193,11000001
119,01110111,121,01111001,240,11110000
12,00001100,76,01001100,88,01011000
28,00011100,46,00101110,74,01001010
34,00100010,75,01001011,109,01101101
106,01101010,16,00010000,122,01111010
41,00101001,77,01001101,118,01110110
39,00100111,85,01010101,124,01111100
111,01101111,8,00001000,119,01110111
57,00111001,13,00001101,70,01000110
29,00011101,36,00100100,65,01000001
94,01011110,119,01110111,213,11010101
45,00101101,25,00011001,70,01000110
14,00001110,103,01100111,117,01110101
6,00000110,100,01100100,106,01101010
95,01011111,126,01111110,221,11011101
40,00101000,89,01011001,129,10000001
109,01101101,111,01101111,220,11011100
32,00100000,88,01011000,120,01111000
33,00100001,111,01101111,144,10010000
42,00101010,25,00011001,67,01000011
28,00011100,77,01001101,105,01101001
35,00100011,35,00100011,70,01000110
74,01001010,114,01110010,188,10111100
24,00011000,34,00100010,58,00111010
103,01100111,55,00110111,158,10011110
81,01010001,124,01111100,205,11001101
30,00011110,116,01110100,146,10010010
110,01101110,100,01100100,210,11010010
59,00111011,94,01011110,153,10011001
0,00000000,16,00010000,16,00010000
70,01000110,24,00011000,94,01011110
94,01011110,56,00111000,150,10010110
91,01011011,99,01100011,190,10111110
31,00011111,83,01010011,114,01110010
98,01100010,71,01000111,169,10101001
24,00011000,87,01010111,111,01101111
2,00000010,50,00110010,52,00110100
29,00011101,37,00100101,66,01000010
100,01100100,64,01000000,164,10100100
81,01010001,18,00010010,99,01100011
72,01001000,6,00000110,78,01001110
118,01110110,80,01010000,198,11000110
32,00100000,34,00100010,66,01000010
10,00001010,64,01000000,74,01001010
83,01010011,44,00101100,127,01111111
58,00111010,30,00011110,88,01011000
98,01100010,71,01000111,169,10101001
3,00000011,72,01001000,75,01001011
11,00001011,3,00000011,14,00001110
118,01110110,80,01010000,198,11000110
85,01010101,122,01111010,207,11001111
95,01011111,98,01100010,193,11000001
24,00011000,100,01100100,124,01111100
63,00111111,31,00011111,94,01011110
121,01111001,123,01111011,244,11110100
8,00001000,81,01010001,89,01011001
30,00011110,38,00100110,68,01000100
124,01111100,35,00100011,159,10011111
56,00111000,29,00011101,85,01010101
16,00010000,115,01110011,131,10000011
51,00110011,42,00101010,93,01011101
102,01100110,31,00011111,133,10000101
35,00100011,124,01111100,159,10011111
78,01001110,66,01000010,144,10010000
66,01000010,66,01000010,132,10000100
116,01110100,59,00111011,175,10101111
104,01101000,48,00110000,152,10011000
85,01010101,34,00100010,119,01110111
104,01101000,90,01011010,194,11000010
91,01011011,11,00001011,102,01100110
19,00010011,50,00110010,69,01000101
36,00100100,107,01101011,143,10001111
111,01101111,84,01010100,195,11000011
116,01110100,32,00100000,148,10010100
35,00100011,107,01101011,142,10001110
117,01110101,28,00011100,145,10010001
57,00111001,49,00110001,106,01101010
122,01111010,49,00110001,171,10101011
42,00101010,85,01010101,127,01111111
39,00100111,52,00110100,91,01011011
79,01001111,27,00011011,106,01101010
34,00100010,63,00111111,97,01100001
74,01001010,79,01001111,153,10011001
16,00010000,99,01100011,115,01110011
31,00011111,46,00101110,77,01001101
43,00101011,69,01000101,112,01110000
66,01000010,2,00000010,68,01000100
19,00010011,30,00011110,49,00110001
121,01111001,37,00100101,158,10011110
40,00101000,1,00000001,41,00101001
103,01100111,53,00110101,156,10011100
4,00000100,34,00100010,38,00100110
21,00010101,106,01101010,127,01111111
51,00110011,76,01001100,127,01111111
97,01100001,118,01110110,215,11010111
52,00110100,9,00001001,61,00111101
101,01100101,19,00010011,120,01111000
113,01110001,95,01011111,208,11010000
109,01101101,68,01000100,177,10110001
5,00000101,91,01011011,96,01100000
102,01100110,53,00110101,155,10011011
81,01010001,78,01001110,159,10011111
105,01101001,72,01001000,177,10110001
81,01010001,80,01010000,161,10100001
68,01000100,109,01101101,177,10110001
41,00101001,29,00011101,70,01000110
48,00110000,27,00011011,75,01001011
66,01000010,100,01100100,166,10100110
91,01011011,53,00110101,144,10010000
47,00101111,123,01111011,170,10101010
69,01000101,110,01101110,179,10110011
124,01111100,91,01011011,215,11010111
117,01110101,123,01111011,240,11110000
16,00010000,50,00110010,66,01000010
99,01100011,42,00101010,141,10001101
0,00000000,76,01001100,76,01001100
7,00000111,90,01011010,97,01100001
16,00010000,56,00111000,72,01001000
96,01100000,87,01010111,183,10110111
58,00111010,15,00001111,73,01001001
57,00111001,43,00101011,100,01100100
125,01111101,88,01011000,213,11010101
102,01100110,12,00001100,114,01110010
105,01101001,97,01100001,202,11001010
8,00001000,28,00011100,36,00100100
11,00001011,32,00100000,43,00101011
77,01001101,82,01010010,159,10011111
77,01001101,6,00000110,83,01010011
82,01010010,107,01101011,189,10111101
76,01001100,79,01001111,155,10011011
122,01111010,21,00010101,143,10001111
41,00101001,20,00010100,61,00111101
90,01011010,17,00010001,107,01101011
69,01000101,92,01011100,161,10100001
32,00100000,23,00010111,55,00110111
46,00101110,26,00011010,72,01001000
12,00001100,12,00001100,24,00011000
3,00000011,78,01001110,81,01010001
78,01001110,32,00100000,110,01101110
12,00001100,33,00100001,45,00101101
28,00011100,13,00001101,41,00101001
124,01111100,76,01001100,200,11001000
31,00011111,79,01001111,110,01101110
108,01101100,63,00111111,171,10101011
87,01010111,92,01011100,179,10110011
89,01011001,42,00101010,131,10000011
2,00000010,90,01011010,92,01011100
89,01011001,103,01100111,192,11000000
120,01111000,110,01101110,230,11100110
40,00101000,108,01101100,148,10010100
65,01000001,51,00110011,116,01110100
61,00111101,101,01100101,162,10100010
55,00110111,86,01010110,141,10001101
79,01001111,71,01000111,150,10010110
124,01111100,102,01100110,226,11100010
59,00111011,36,00100100,95,01011111
54,00110110,87,01010111,141,10001101
0,00000000,23,00010111,23,00010111
67,01000011,7,00000111,74,01001010
20,00010100,120,01111000,140,10001100
114,01110010,22,00010110,136,10001000
114,01110010,102,01100110,216,11011000
94,01011110,27,00011011,121,01111001
43,00101011,123,01111011,166,10100110
65,01000001,27,00011011,92,01011100
95,01011111,70,01000110,165,10100101
39,00100111,117,01110101,156,10011100
52,00110100,5,00000101,57,00111001
82,01010010,72,01001000,154,10011010
102,01100110,20,00010100,122,01111010
89,01011001,98,01100010,187,10111011
15,00001111,0,00000000,15,00001111
82,01010010,32,00100000,114,01110010
52,00110100,67,01000011,119,01110111
125,01111101,83,01010011,208,11010000
118,01110110,47,00101111,165,10100101
125,01111101,20,00010100,145,10010001
91,01011011,44,00101100,135,10000111
112,01110000,103,01100111,215,11010111
14,00001110,100,01100100,114,01110010
37,00100101,31,00011111,68,01000100
7,00000111,89,01011001,96,01100000
66,01000010,120,01111000,186,10111010
27,00011011,116,01110100,143,10001111
72,01001000,29,00011101,101,01100101
10,00001010,1,00000001,11,00001011
75,01001011,64,01000000,139,10001011
39,00100111,91,01011011,130,10000010
79,01001111,14,00001110,93,01011101
117,01110101,104,01101000,221,11011101
94,01011110,9,00001001,103,01100111
0,00000000,42,00101010,42,00101010
119,01110111,61,00111101,180,10110100
11,00001011,20,00010100,31,00011111
38,00100110,31,00011111,69,01000101
15,00001111,0,00000000,15,00001111
104,01101000,34,00100010,138,10001010
48,00110000,23,00010111,71,01000111
71,01000111,62,00111110,133,10000101
62,00111110,106,01101010,168,10101000
37,00100101,88,01011000,125,01111101
28,00011100,80,01010000,108,01101100
50,00110010,127,01111111,177,10110001
74,01001010,110,01101110,184,10111000
85,01010101,77,01001101,162,10100010
92,01011100,116,01110100,208,11010000
38,00100110,100,01100100,138,10001010
6,00000110,72,01001000,78,01001110
38,00100110,123,01111011,161,10100001
103,01100111,36,00100100,139,10001011
29,00011101,59,00111011,88,01011000
124,01111100,12,00001100,136,10001000
79,01001111,9,00001001,88,01011000
113,01110001,36,00100100,149,10010101
25,00011001,13,00001101,38,00100110
49,00110001,70,01000110,119,01110111
114,01110010,101,01100101,215,11010111
30,00011110,49,00110001,79,01001111
19,00010011,28,00011100,47,00101111
76,01001100,123,01111011,199,11000111
40,00101000,116,01110100,156,10011100
96,01100000,121,01111001,217,11011001
97,01100001,76,01001100,173,10101101
55,00110111,37,00100101,92,01011100
16,00010000,82,01010010,98,01100010
29,00011101,23,00010111,52,00110100
52,00110100,20,00010100,72,01001000
127,01111111,87,01010111,214,11010110
1,00000001,115,01110011,116,01110100
43,00101011,24,00011000,67,01000011
119,01110111,29,00011101,148,10010100
34,00100010,109,01101101,143,10001111
105,01101001,114,01110010,219,11011011
70,01000110,98,01100010,168,10101000
75,01001011,96,01100000,171,10101011
3,00000011,114,01110010,117,01110101
81,01010001,72,01001000,153,10011001
44,00101100,90,01011010,134,10000110
58,00111010,74,01001010,132,10000100
80,01010000,90,01011010,170,10101010
47,00101111,15,00001111,62,00111110
2,00000010,26,00011010,28,00011100
58,00111010,22,00010110,80,01010000
76,01001100,16,00010000,92,01011100
21,00010101,19,00010011,40,00101000
5,00000101,49,00110001,54,00110110
120,01111000,19,00010011,139,10001011
35,00100011,55,00110111,90,01011010
19,00010011,6,00000110,25,00011001
118,01110110,83,01010011,201,11001001
30,00011110,113,01110001,143,10001111
107,01101011,92,01011100,199,11000111
127,01111111,7,00000111,134,10000110
9,00001001,93,01011101,102,01100110
61,00111101,94,01011110,155,10011011
122,01111010,122,01111010,244,11110100
17,00010001,7,00000111,24,00011000
51,00110011,49,00110001,100,01100100
64,01000000,86,01010110,150,10010110
29,00011101,55,00110111,84,01010100
99,01100011,116,01110100,215,11010111
49,00110001,53,00110101,102,01100110
29,00011101,12,00001100,41,00101001
88,01011000,100,01100100,188,10111100
46,00101110,48,00110000,94,01011110
46,00101110,73,01001001,119,01110111
94,01011110,16,00010000,110,01101110
122,01111010,120,01111000,242,11110010
9,00001001,120,01111000,129,10000001
92,01011100,94,01011110,186,10111010
20,00010100,96,01100000,116,01110100
15,00001111,114,01110010,129,10000001
38,00100110,108,01101100,146,10010010
12,00001100,114,01110010,126,01111110
79,01001111,11,00001011,90,01011010
75,01001011,29,00011101,104,01101000
19,00010011,103,01100111,122,01111010
90,01011010,10,00001010,100,01100100
60,00111100,106,01101010,166,10100110
114,01110010,97,01100001,211,11010011
103,01100111,92,01011100,195,11000011
64,01000000,77,01001101,141,10001101
74,01001010,51,00110011,125,01111101
23,00010111,99,01100011,122,01111010
85,01010101,106,01101010,191,10111111
122,01111010,125,01111101,247,11110111
0,00000000,8,00001000,8,00001000
38,00100110,123,01111011,161,10100001
95,01011111,27,00011011,122,01111010
96,01100000,93,01011101,189,10111101
45,00101101,115,01110011,160,10100000
13,00001101,87,01010111,100,01100100
25,00011001,5,00000101,30,00011110
8,00001000,18,00010010,26,00011010
73,01001001,38,00100110,111,01101111
114,01110010,47,00101111,161,10100001
61,00111101,59,00111011,120,01111000
34,00100010,43,00101011,77,01001101
20,00010100,115,01110011,135,10000111
35,00100011,42,00101010,77,01001101
30,00011110,99,01100011,129,10000001
85,01010101,111,01101111,196,11000100
60,00111100,123,01111011,183,10110111
37,00100101,51,00110011,88,01011000
23,00010111,53,00110101,76,01001100
96,01100000,33,00100001,129,10000001
54,00110110,64,01000000,118,01110110
116,01110100,57,00111001,173,10101101
20,00010100,83,01010011,103,01100111
79,01001111,81,01010001,160,10100000
58,00111010,117,01110101,175,10101111
115,01110011,89,01011001,204,11001100
79,01001111,68,01000100,147,10010011
8,00001000,53,00110101,61,00111101
87,01010111,2,00000010,89,01011001
37,00100101,46,00101110,83,01010011
89,01011001,44,00101100,133,10000101
50,00110010,37,00100101,87,01010111
63,00111111,86,01010110,149,10010101
86,01010110,53,00110101,139,10001011
27,00011011,3,00000011,30,00011110
71,01000111,10,00001010,81,01010001
81,01010001,101,01100101,182,10110110
6,00000110,39,00100111,45,00101101
53,00110101,0,00000000,53,00110101
3,00000011,115,01110011,118,01110110
15,00001111,126,01111110,141,10001101
108,01101100,80,01010000,188,10111100
79,01001111,0,00000000,79,01001111
32,00100000,0,00000000,32,00100000
11,00001011,59,00111011,70,01000110
88,01011000,27,00011011,115,01110011
49,00110001,51,00110011,100,01100100
17,00010001,94,01011110,111,01101111
83,01010011,44,00101100,127,01111111
91,01011011,117,01110101,208,11010000
76,01001100,74,01001010,150,10010110
73,01001001,9,00001001,82,01010010
109,01101101,124,01111100,233,11101001
100,01100100,119,01110111,219,11011011
123,01111011,25,00011001,148,10010100
28,00011100,83,01010011,111,01101111
67,01000011,95,01011111,162,10100010
86,01010110,109,01101101,195,11000011
93,01011101,96,01100000,189,10111101
96,01100000,38,00100110,134,10000110
29,00011101,50,00110010,79,01001111
111,01101111,30,00011110,141,10001101
105,01101001,14,00001110,119,01110111
103,01100111,37,00100101,140,10001100
4,00000100,105,01101001,109,01101101
59,00111011,20,00010100,79,01001111
23,00010111,16,00010000,39,00100111
52,00110100,22,00010110,74,01001010
6,00000110,24,00011000,30,00011110
27,00011011,87,01010111,114,01110010
119,01110111,42,00101010,161,10100001
6,00000110,29,00011101,35,00100011
5,00000101,80,01010000,85,01010101
109,01101101,71,01000111,180,10110100
0,00000000,58,00111010,58,00111010
74,01001010,44,00101100,118,01110110
126,01111110,71,01000111,197,11000101
45,00101101,35,00100011,80,01010000
1,00000001,8,00001000,9,00001001
27,00011011,107,01101011,134,10000110
29,00011101,101,01100101,130,10000010
38,00100110,15,00001111,53,00110101
43,00101011,43,00101011,86,01010110
59,00111011,12,00001100,71,01000111
12,00001100,42,00101010,54,00110110
20,00010100,86,01010110,106,01101010
39,00100111,96,01100000,135,10000111
48,00110000,36,00100100,84,01010100
39,00100111,67,01000011,106,01101010
54,00110110,2,00000010,56,00111000
10,00001010,21,00010101,31,00011111
84,01010100,87,01010111,171,10101011
37,00100101,121,01111001,158,10011110
28,00011100,30,00011110,58,00111010
35,00100011,115,01110011,150,10010110
20,00010100,113,01110001,133,10000101
102,01100110,111,01101111,213,11010101
51,00110011,80,01010000,131,10000011
88,01011000,31,00011111,119,01110111
0,00000000,16,00010000,16,00010000
22,00010110,43,00101011,65,01000001
94,01011110,82,01010010,176,10110000
123,01111011,114,01110010,237,11101101
126,01111110,30,00011110,156,10011100
121,01111001,65,01000001,186,10111010
38,00100110,38,00100110,76,01001100
83,01010011,106,01101010,189,10111101
53,00110101,27,00011011,80,01010000
59,00111011,14,00001110,73,01001001
82,01010010,109,01101101,191,10111111
46,00101110,116,01110100,162,10100010
113,01110001,53,00110101,166,10100110
125,01111101,49,00110001,174,10101110
81,01010001,17,00010001,98,01100010
21,00010101,69,01000101,90,01011010
17,00010001,3,00000011,20,00010100
35,00100011,55,00110111,90,01011010
14,00001110,115,01110011,129,10000001
44,00101100,36,00100100,80,01010000
4,00000100,66,01000010,70,01000110
120,01111000,107,01101011,227,11100011
43,00101011,125,01111101,168,10101000
70,01000110,34,00100010,104,01101000
93,01011101,31,00011111,124,01111100
66,01000010,85,01010101,151,10010111
105,01101001,122,01111010,227,11100011
98,01100010,41,00101001,139,10001011
36,00100100,33,00100001,69,01000101
57,00111001,65,01000001,122,01111010
50,00110010,24,00011000,74,01001010
122,01111010,59,00111011,181,10110101
100,01100100,0,00000000,100,01100100
67,01000011,98,01100010,165,10100101
64,01000000,6,00000110,70,01000110
68,01000100,25,00011001,93,01011101
30,00011110,23,00010111,53,00110101
109,01101101,81,01010001,190,10111110
94,01011110,35,00100011,129,10000001
58,00111010,74,01001010,132,10000100
39,00100111,126,01111110,165,10100101
94,01011110,103,01100111,197,11000101
22,00010110,20,00010100,42,00101010
54,00110110,114,01110010,168,10101000
28,00011100,45,00101101,73,01001001
59,00111011,62,00111110,121,01111001
101,01100101,48,00110000,149,10010101
101,01100101,67,01000011,168,10101000
115,01110011,121,01111001,236,11101100
106,01101010,117,01110101,223,11011111
15,00001111,84,01010100,99,01100011
7,00000111,113,01110001,120,01111000
90,01011010,78,01001110,168,10101000
105,01101001,24,00011000,129,10000001
114,01110010,72,01001000,186,10111010
118,01110110,53,00110101,171,10101011
16,00010000,58,00111010,74,01001010
127,01111111,72,01001000,199,11000111
60,00111100,76,01001100,136,10001000
35,00100011,37,00100101,72,01001000
73,01001001,27,00011011,100,01100100
65,01000001,60,00111100,125,01111101
13,00001101,30,00011110,43,00101011
29,00011101,60,00111100,89,01011001
22,00010110,118,01110110,140,10001100
62,00111110,63,00111111,125,01111101
44,00101100,64,01000000,108,01101100
104,01101000,117,01110101,221,11011101
24,00011000,39,00100111,63,00111111
42,00101010,48,00110000,90,01011010
106,01101010,48,00110000,154,10011010
110,01101110,98,01100010,208,11010000
39,00100111,18,00010010,57,00111001
94,01011110,13,00001101,107,01101011
117,01110101,125,01111101,242,11110010
27,00011011,51,00110011,78,01001110
24,00011000,99,01100011,123,01111011
23,00010111,114,01110010,137,10001001
56,00111000,87,01010111,143,10001111
102,01100110,18,00010010,120,01111000
37,00100101,17,00010001,54,00110110
56,00111000,44,00101100,100,01100100
121,01111001,14,00001110,135,10000111
114,01110010,123,01111011,237,11101101
56,00111000,56,00111000,112,01110000
104,01101000,61,00111101,165,10100101
71,01000111,99,01100011,170,10101010
72,01001000,6,00000110,78,01001110
38,00100110,55,00110111,93,01011101
9,00001001,43,00101011,52,00110100
6,00000110,31,00011111,37,00100101
62,00111110,70,01000110,132,10000100
19,00010011,44,00101100,63,00111111
43,00101011,55,00110111,98,01100010
30,00011110,111,01101111,141,10001101
126,01111110,6,00000110,132,10000100
113,01110001,6,00000110,119,01110111
16,00010000,102,01100110,118,01110110
62,00111110,51,00110011,113,01110001
75,01001011,64,01000000,139,10001011
125,01111101,3,00000011,128,10000000
90,01011010,13,00001101,103,01100111
79,01001111,126,01111110,205,11001101
30,00011110,79,01001111,109,01101101
113,01110001,12,00001100,125,01111101
127,01111111,93,01011101,220,11011100
42,00101010,49,00110001,91,01011011
14,00001110,3,00000011,17,00010001
58,00111010,49,00110001,107,01101011
10,00001010,57,00111001,67,01000011
56,00111000,122,01111010,178,10110010
80,01010000,67,01000011,147,10010011
13,00001101,7,00000111,20,00010100
115,01110011,82,01010010,197,11000101
111,01101111,103,01100111,214,11010110
16,00010000,29,00011101,45,00101101
70,01000110,97,01100001,167,10100111
53,00110101,94,01011110,147,10010011
43,00101011,1,00000001,44,00101100
8,00001000,25,00011001,33,00100001
62,00111110,103,01100111,165,10100101
99,01100011,59,00111011,158,10011110
5,00000101,22,00010110,27,00011011
123,01111011,51,00110011,174,10101110
124,01111100,5,00000101,129,10000001
114,01110010,78,01001110,192,11000000
100,01100100,21,00010101,121,01111001
20,00010100,5,00000101,25,00011001
126,01111110,83,01010011,209,11010001
14,00001110,46,00101110,60,00111100
75,01001011,46,00101110,121,01111001
7,00000111,5,00000101,12,00001100
18,00010010,20,00010100,38,00100110
8,00001000,17,00010001,25,00011001
57,00111001,35,00100011,92,01011100
53,00110101,124,01111100,177,10110001
95,01011111,96,01100000,191,10111111
18,00010010,96,01100000,114,01110010
65,01000001,100,01100100,165,10100101
127,01111111,52,00110100,179,10110011
59,00111011,56,00111000,115,01110011
17,00010001,39,00100111,56,00111000
83,01010011,31,00011111,114,01110010
42,00101010,7,00000111,49,00110001
94,01011110,68,01000100,162,10100010
66,01000010,59,00111011,125,01111101
65,01000001,38,00100110,103,01100111
0,00000000,118,01110110,118,01110110
12,00001100,123,01111011,135,10000111
53,00110101,46,00101110,99,01100011
33,00100001,89,01011001,122,01111010
39,00100111,106,01101010,145,10010001
86,01010110,108,01101100,194,11000010
13,00001101,7,00000111,20,00010100
1,00000001,34,00100010,35,00100011
19,00010011,71,01000111,90,01011010
22,00010110,31,00011111,53,00110101
34,00100010,39,00100111,73,01001001
92,01011100,9,00001001,101,01100101
94,01011110,7,00000111,101,01100101
23,00010111,103,01100111,126,01111110
123,01111011,34,00100010,157,10011101
38,00100110,73,01001001,111,01101111
71,01000111,100,01100100,171,10101011
23,00010111,100,01100100,123,01111011
0,00000000,43,00101011,43,00101011
40,00101000,102,01100110,142,10001110
60,00111100,38,00100110,98,01100010
78,01001110,105,01101001,183,10110111
109,01101101,37,00100101,146,10010010
51,00110011,74,01001010,125,01111101
64,01000000,94,01011110,158,10011110
49,00110001,23,00010111,72,01001000
86,01010110,77,01001101,163,10100011
29,00011101,29,00011101,58,00111010
29,00011101,114,01110010,143,10001111
69,01000101,59,00111011,128,10000000
19,00010011,0,00000000,19,00010011
105,01101001,1,00000001,106,01101010
111,01101111,85,01010101,196,11000100
35,00100011,87,01010111,122,01111010
108,01101100,110,01101110,218,11011010
89,01011001,62,00111110,151,10010111
28,00011100,86,01010110,114,01110010
13,00001101,4,00000100,17,00010001
45,00101101,90,01011010,135,10000111
104,01101000,31,00011111,135,10000111
91,01011011,43,00101011,134,10000110
50,00110010,125,01111101,175,10101111
12,00001100,41,00101001,53,00110101
90,01011010,78,01001110,168,10101000
58,00111010,60,00111100,118,01110110
127,01111111,54,00110110,181,10110101
81,01010001,82,01010010,163,10100011
87,01010111,6,00000110,93,01011101
60,00111100,29,00011101,89,01011001
60,00111100,100,01100100,160,10100000
44,00101100,46,00101110,90,01011010
18,00010010,91,01011011,109,01101101
34,00100010,103,01100111,137,10001001
60,00111100,33,00100001,93,01011101
2,00000010,71,01000111,73,01001001
89,01011001,64,01000000,153,10011001
94,01011110,28,00011100,122,01111010
18,00010010,92,01011100,110,01101110
15,00001111,89,01011001,104,01101000
27,00011011,93,01011101,120,01111000
27,00011011,110,01101110,137,10001001
103,01100111,125,01111101,228,11100100
7,00000111,105,01101001,112,01110000
42,00101010,36,00100100,78,01001110
82,01010010,33,00100001,115,01110011
69,01000101,60,00111100,129,10000001
93,01011101,79,01001111,172,10101100
94,01011110,78,01001110,172,10101100
71,01000111,81,01010001,152,10011000
6,00000110,104,01101000,110,01101110
94,01011110,0,00000000,94,01011110
125,01111101,106,01101010,231,11100111
119,01110111,90,01011010,209,11010001
11,00001011,56,00111000,67,01000011
8,00001000,92,01011100,100,01100100
126,01111110,51,00110011,177,10110001
119,01110111,81,01010001,200,11001000
37,00100101,36,00100100,73,01001001
123,01111011,38,00100110,161,10100001
100,01100100,67,01000011,167,10100111
64,01000000,5,00000101,69,01000101
21,00010101,52,00110100,73,01001001
58,00111010,76,01001100,134,10000110
83,01010011,42,00101010,125,01111101
6,00000110,0,00000000,6,00000110
88,01011000,12,00001100,100,01100100
55,00110111,90,01011010,145,10010001
63,00111111,59,00111011,122,01111010
116,01110100,74,01001010,190,10111110
34,00100010,86,01010110,120,01111000
50,00110010,57,00111001,107,01101011
78,01001110,32,00100000,110,01101110
91,01011011,63,00111111,154,10011010
24,00011000,31,00011111,55,00110111
76,01001100,67,01000011,143,10001111
90,01011010,48,00110000,138,10001010
87,01010111,58,00111010,145,10010001
64,01000000,10,00001010,74,01001010
29,00011101,33,00100001,62,00111110
103,01100111,27,00011011,130,10000010
21,00010101,94,01011110,115,01110011
79,01001111,121,01111001,200,11001000
113,01110001,105,01101001,218,11011010
72,01001000,103,01100111,175,10101111
23,00010111,35,00100011,58,00111010
54,00110110,119,01110111,173,10101101
51,00110011,50,00110010,101,01100101
24,00011000,26,00011010,50,00110010
28,00011100,78,01001110,106,01101010
78,01001110,123,01111011,201,11001001
84,01010100,46,00101110,130,10000010
38,00100110,67,01000011,105,01101001
15,00001111,23,00010111,38,00100110
100,01100100,126,01111110,226,11100010
61,00111101,88,01011000,149,10010101
81,01010001,94,01011110,175,10101111
81,01010001,17,00010001,98,01100010
58,00111010,38,00100110,96,01100000
51,00110011,80,01010000,131,10000011
47,00101111,10,00001010,57,00111001
5,00000101,66,01000010,71,01000111
14,00001110,101,01100101,115,01110011
52,00110100,64,01000000,116,01110100
29,00011101,20,00010100,49,00110001
69,01000101,3,00000011,72,01001000
116,01110100,74,01001010,190,10111110
78,01001110,5,00000101,83,01010011
22,00010110,67,01000011,89,01011001
12,00001100,108,01101100,120,01111000
0,00000000,32,00100000,32,00100000
38,00100110,124,01111100,162,10100010
68,01000100,88,01011000,156,10011100
94,01011110,116,01110100,210,11010010
40,00101000,126,01111110,166,10100110
68,01000100,10,00001010,78,01001110
92,01011100,29,00011101,121,01111001
16,00010000,84,01010100,100,01100100
16,00010000,75,01001011,91,01011011
84,01010100,9,00001001,93,01011101
21,00010101,126,01111110,147,10010011
82,01010010,78,01001110,160,10100000
119,01110111,55,00110111,174,10101110
27,00011011,127,01111111,154,10011010
41,00101001,115,01110011,156,10011100
73,01001001,35,00100011,108,01101100
63,00111111,119,01110111,182,10110110
83,01010011,58,00111010,141,10001101
10,00001010,53,00110101,63,00111111
64,01000000,22,00010110,86,01010110
102,01100110,43,00101011,145,10010001
126,01111110,72,01001000,198,11000110
75,01001011,93,01011101,168,10101000
28,00011100,52,00110100,80,01010000
0,00000000,65,01000001,65,01000001
81,01010001,12,00001100,93,01011101
44,00101100,95,01011111,139,10001011
51,00110011,99,01100011,150,10010110
105,01101001,10,00001010,115,01110011
121,01111001,60,00111100,181,10110101
105,01101001,44,00101100,149,10010101
19,00010011,61,00111101,80,01010000
50,00110010,58,00111010,108,01101100
117,01110101,60,00111100,177,10110001
122,01111010,108,01101100,230,11100110
19,00010011,102,01100110,121,01111001
73,01001001,13,00001101,86,01010110
78,01001110,69,01000101,147,10010011
115,01110011,109,01101101,224,11100000
115,01110011,113,01110001,228,11100100
58,00111010,116,01110100,174,10101110
83,01010011,43,00101011,126,01111110
124,01111100,97,01100001,221,11011101
36,00100100,108,01101100,144,10010000
99,01100011,116,01110100,215,11010111
30,00011110,56,00111000,86,01010110
120,01111000,0,00000000,120,01111000
29,00011101,123,01111011,152,10011000
115,01110011,105,01101001,220,11011100
97,01100001,11,00001011,108,01101100
49,00110001,42,00101010,91,01011011
5,00000101,9,00001001,14,00001110
27,00011011,46,00101110,73,01001001
43,00101011,15,00001111,58,00111010
63,00111111,35,00100011,98,01100010
10,00001010,7,00000111,17,00010001
14,00001110,80,01010000,94,01011110
35,00100011,10,00001010,45,00101101
108,01101100,6,00000110,114,01110010
27,00011011,113,01110001,140,10001100
111,01101111,118,01110110,229,11100101
22,00010110,95,01011111,117,01110101
50,00110010,12,00001100,62,00111110
127,01111111,57,00111001,184,10111000
34,00100010,88,01011000,122,01111010
113,01110001,42,00101010,155,10011011
78,01001110,112,01110000,190,10111110
80,01010000,110,01101110,190,10111110
49,00110001,20,00010100,69,01000101
25,00011001,16,00010000,41,00101001
114,01110010,102,01100110,216,11011000
46,00101110,64,01000000,110,01101110
113,01110001,85,01010101,198,11000110
104,01101000,28,00011100,132,10000100
69,01000101,96,01100000,165,10100101
76,01001100,92,01011100,168,10101000
74,01001010,120,01111000,194,11000010
74,01001010,123,01111011,197,11000101
58,00111010,26,00011010,84,01010100
55,00110111,4,00000100,59,00111011
116,01110100,123,01111011,239,11101111
69,01000101,84,01010100,153,10011001
68,01000100,18,00010010,86,01010110
28,00011100,104,01101000,132,10000100
59,00111011,92,01011100,151,10010111
65,01000001,2,00000010,67,01000011
93,01011101,47,00101111,140,10001100
106,01101010,64,01000000,170,10101010
71,01000111,113,01110001,184,10111000
69,01000101,27,00011011,96,01100000
66,01000010,64,01000000,130,10000010
4,00000100,75,01001011,79,01001111
42,00101010,31,00011111,73,01001001
92,01011100,84,01010100,176,10110000
40,00101000,5,00000101,45,00101101
100,01100100,67,01000011,167,10100111
23,00010111,29,00011101,52,00110100
116,01110100,93,01011101,209,11010001
34,00100010,87,01010111,121,01111001
61,00111101,38,00100110,99,01100011
51,00110011,107,01101011,158,10011110
55,00110111,96,01100000,151,10010111
71,01000111,80,01010000,151,10010111
104,01101000,25,00011001,129,10000001
46,00101110,49,00110001,95,01011111
48,00110000,14,00001110,62,00111110
68,01000100,62,00111110,130,10000010
4,00000100,27,00011011,31,00011111
125,01111101,44,00101100,169,10101001
68,01000100,6,00000110,74,01001010
42,00101010,123,01111011,165,10100101
24,00011000,56,00111000,80,01010000
52,00110100,47,00101111,99,01100011
48,00110000,119,01110111,167,10100111
31,00011111,24,00011000,55,00110111
84,01010100,111,01101111,195,11000011
109,01101101,102,01100110,211,11010011
54,00110110,4,00000100,58,00111010
38,00100110,104,01101000,142,10001110
58,00111010,59,00111011,117,01110101
29,00011101,122,01111010,151,10010111
62,00111110,100,01100100,162,10100010
3,00000011,2,00000010,5,00000101
1,00000001,50,00110010,51,00110011
14,00001110,119,01110111,133,10000101
102,01100110,29,00011101,131,10000011
101,01100101,101,01100101,202,11001010
61,00111101,24,00011000,85,01010101
23,00010111,88,01011000,111,01101111
40,00101000,4,00000100,44,00101100
14,00001110,64,01000000,78,01001110
27,00011011,2,00000010,29,00011101
42,00101010,116,01110100,158,10011110
91,01011011,79,01001111,170,10101010
87,01010111,19,00010011,106,01101010
67,01000011,105,01101001,172,10101100
24,00011000,105,01101001,129,10000001
118,01110110,82,01010010,200,11001000
38,00100110,108,01101100,146,10010010
11,00001011,0,00000000,11,00001011
49,00110001,109,01101101,158,10011110
113,01110001,32,00100000,145,10010001
94,01011110,5,00000101,99,01100011
125,01111101,114,01110010,239,11101111
125,01111101,54,00110110,179,10110011
0,00000000,58,00111010,58,00111010
27,00011011,51,00110011,78,01001110
106,01101010,122,01111010,228,11100100
62,00111110,110,01101110,172,10101100
61,00111101,107,01101011,168,10101000
94,01011110,76,01001100,170,10101010
59,00111011,38,00100110,97,01100001
46,00101110,31,00011111,77,01001101
118,01110110,50,00110010,168,10101000
37,00100101,39,00100111,76,01001100
108,01101100,115,01110011,223,11011111
94,01011110,113,01110001,207,11001111
0,00000000,49,00110001,49,00110001
0,00000000,101,01100101,101,01100101
113,01110001,119,01110111,232,11101000
60,00111100,107,01101011,167,10100111
26,00011010,100,01100100,126,01111110
105,01101001,64,01000000,169,10101001
47,00101111,52,00110100,99,01100011
36,00100100,87,01010111,123,01111011
105,01101001,57,00111001,162,10100010
99,01100011,26,00011010,125,01111101
55,00110111,57,00111001,112,01110000
82,01010010,21,00010101,103,01100111
110,01101110,124,01111100,234,11101010
125,01111101,126,01111110,251,11111011
69,01000101,99,01100011,168,10101000
54,00110110,84,01010100,138,10001010
21,00010101,124,01111100,145,10010001
84,01010100,108,01101100,192,11000000
115,01110011,40,00101000,155,10011011
119,01110111,14,00001110,133,10000101
69,01000101,104,01101000,173,10101101
18,00010010,34,00100010,52,00110100
24,00011000,74,01001010,98,01100010
14,00001110,74,01001010,88,01011000
15,00001111,23,00010111,38,00100110
105,01101001,65,01000001,170,10101010
62,00111110,31,00011111,93,01011101
0,00000000,44,00101100,44,00101100
54,00110110,67,01000011,121,01111001
65,01000001,118,01110110,183,10110111
104,01101000,125,01111101,229,11100101
40,00101000,123,01111011,163,10100011
24,00011000,95,01011111,119,01110111
27,00011011,38,00100110,65,01000001
49,00110001,83,01010011,132,10000100
26,00011010,12,00001100,38,00100110
85,01010101,57,00111001,142,10001110
23,00010111,41,00101001,64,01000000
33,00100001,28,00011100,61,00111101
44,00101100,86,01010110,130,10000010
75,01001011,3,00000011,78,01001110
110,01101110,2,00000010,112,01110000
51,00110011,91,01011011,142,10001110
102,01100110,106,01101010,208,11010000
122,01111010,99,01100011,221,11011101
87,01010111,66,01000010,153,10011001
65,01000001,64,01000000,129,10000001
118,01110110,120,01111000,238,11101110
54,00110110,108,01101100,162,10100010
63,00111111,100,01100100,163,10100011
25,00011001,29,00011101,54,00110110
97,01100001,90,01011010,187,10111011
55,00110111,74,01001010,129,10000001
22,00010110,117,01110101,139,10001011
67,01000011,100,01100100,167,10100111
115,01110011,40,00101000,155,10011011
104,01101000,111,01101111,215,11010111
62,00111110,26,00011010,88,01011000
54,00110110,52,00110100,106,01101010
127,01111111,81,01010001,208,11010000
124,01111100,105,01101001,229,11100101
39,00100111,59,00111011,98,01100010
41,00101001,13,00001101,54,00110110
58,00111010,60,00111100,118,01110110
73,01001001,53,00110101,126,01111110
5,00000101,91,01011011,96,01100000
94,01011110,89,01011001,183,10110111
99,01100011,63,00111111,162,10100010
57,00111001,112,01110000,169,10101001
34,00100010,71,01000111,105,01101001
111,01101111,29,00011101,140,10001100
47,00101111,44,00101100,91,01011011
106,01101010,28,00011100,134,10000110
1,00000001,122,01111010,123,01111011
0,00000000,49,00110001,49,00110001
8,00001000,73,01001001,81,01010001
43,00101011,36,00100100,79,01001111
92,01011100,93,01011101,185,10111001
32,00100000,112,01110000,144,10010000
119,01110111,0,00000000,119,01110111
59,00111011,73,01001001,132,10000100
42,00101010,0,00000000,42,00101010
119,01110111,46,00101110,165,10100101
32,00100000,125,01111101,157,10011101
91,01011011,37,00100101,128,10000000
106,01101010,124,01111100,230,11100110
101,01100101,23,00010111,124,01111100
104,01101000,20,00010100,124,01111100
8,00001000,41,00101001,49,00110001
14,00001110,64,01000000,78,01001110
80,01010000,117,01110101,197,11000101
80,01010000,51,00110011,131,10000011
15,00001111,11,00001011,26,00011010
48,00110000,11,00001011,59,00111011
67,01000011,98,01100010,165,10100101
56,00111000,118,01110110,174,10101110
67,01000011,76,01001100,143,10001111
84,01010100,34,00100010,118,01110110
45,00101101,15,00001111,60,00111100
119,01110111,17,00010001,136,10001000
76,01001100,58,00111010,134,10000110
23,00010111,77,01001101,100,01100100
99,01100011,79,01001111,178,10110010
33,00100001,57,00111001,90,01011010
73,01001001,71,01000111,144,10010000
53,00110101,116,01110100,169,10101001
33,00100001,32,00100000,65,01000001
15,00001111,3,00000011,18,00010010
27,00011011,37,00100101,64,01000000
110,01101110,89,01011001,199,11000111
49,00110001,47,00101111,96,01100000
121,01111001,110,01101110,231,11100111
91,01011011,113,01110001,204,11001100
89,01011001,107,01101011,196,11000100
2,00000010,54,00110110,56,00111000
11,00001011,114,01110010,125,01111101
108,01101100,12,00001100,120,01111000
74,01001010,107,01101011,181,10110101
110,01101110,79,01001111,189,10111101
64,01000000,75,01001011,139,10001011
11,00001011,15,00001111,26,00011010
39,00100111,82,01010010,121,01111001
54,00110110,61,00111101,115,01110011
56,00111000,112,01110000,168,10101000
108,01101100,111,01101111,219,11011011
48,00110000,114,01110010,162,10100010
122,01111010,31,00011111,153,10011001
64,01000000,120,01111000,184,10111000
35,00100011,74,01001010,109,01101101
81,01010001,94,01011110,175,10101111
35,00100011,46,00101110,81,01010001
90,01011010,103,01100111,193,11000001
90,01011010,76,01001100,166,10100110
37,00100101,83,01010011,120,01111000
70,01000110,90,01011010,160,10100000
54,00110110,67,01000011,121,01111001
26,00011010,2,00000010,28,00011100
41,00101001,68,01000100,109,01101101
107,01101011,74,01001010,181,10110101
115,01110011,99,01100011,214,11010110
31,00011111,72,01001000,103,01100111
38,00100110,19,00010011,57,00111001
16,00010000,83,01010011,99,01100011
99,01100011,15,00001111,114,01110010
64,01000000,111,01101111,175,10101111
60,00111100,70,01000110,130,10000010
14,00001110,123,01111011,137,10001001
38,00100110,18,00010010,56,00111000
52,00110100,94,01011110,146,10010010
25,00011001,91,01011011,116,01110100
41,00101001,108,01101100,149,10010101
58,00111010,38,00100110,96,01100000
123,01111011,48,00110000,171,10101011
87,01010111,41,00101001,128,10000000
104,01101000,54,00110110,158,10011110
84,01010100,75,01001011,159,10011111
91,01011011,85,01010101,176,10110000
1,00000001,9,00001001,10,00001010
86,01010110,114,01110010,200,11001000
12,00001100,97,01100001,109,01101101
48,00110000,53,00110101,101,01100101
110,01101110,69,01000101,179,10110011
56,00111000,59,00111011,115,01110011
92,01011100,29,00011101,121,01111001
2,00000010,125,01111101,127,01111111
30,00011110,34,00100010,64,01000000
58,00111010,113,01110001,171,10101011
76,01001100,85,01010101,161,10100001
76,01001100,80,01010000,156,10011100
87,01010111,74,01001010,161,10100001
80,01010000,85,01010101,165,10100101
89,01011001,19,00010011,108,01101100
98,01100010,23,00010111,121,01111001
16,00010000,108,01101100,124,01111100
32,00100000,65,01000001,97,01100001
90,01011010,13,00001101,103,01100111
30,00011110,35,00100011,65,01000001
105,01101001,44,00101100,149,10010101
31,00011111,41,00101001,72,01001000
56,00111000,86,01010110,142,10001110
1,00000001,126,01111110,127,01111111
127,01111111,15,00001111,142,10001110
31,00011111,126,01111110,157,10011101
66,01000010,77,01001101,143,10001111
0,00000000,0,00000000,0,00000000
10,00001010,16,00010000,26,00011010
120,01111000,11,00001011,131,10000011
60,00111100,89,01011001,149,10010101
22,00010110,127,01111111,149,10010101
63,00111111,69,01000101,132,10000100
67,01000011,110,01101110,177,10110001
124,01111100,19,00010011,143,10001111
70,01000110,51,00110011,121,01111001
17,00010001,55,00110111,72,01001000
16,00010000,25,00011001,41,00101001
124,01111100,98,01100010,222,11011110
54,00110110,41,00101001,95,01011111
81,01010001,108,01101100,189,10111101
24,00011000,10,00001010,34,00100010
114,01110010,106,01101010,220,11011100
26,00011010,123,01111011,149,10010101
55,00110111,119,01110111,174,10101110
100,01100100,124,01111100,224,11100000
94,01011110,112,01110000,206,11001110
82,01010010,0,00000000,82,01010010
3,00000011,62,00111110,65,01000001
98,01100010,28,00011100,126,01111110
127,01111111,127,01111111,254,11111110
10,00001010,81,01010001,91,01011011
72,01001000,61,00111101,133,10000101
21,00010101,47,00101111,68,01000100
91,01011011,78,01001110,169,10101001
24,00011000,82,01010010,106,01101010
34,00100010,111,01101111,145,10010001
122,01111010,119,01110111,241,11110001
83,01010011,111,01101111,194,11000010
92,01011100,75,01001011,167,10100111
82,01010010,64,01000000,146,10010010
38,00100110,106,01101010,144,10010000
111,01101111,45,00101101,156,10011100
36,00100100,1,00000001,37,00100101
40,00101000,108,01101100,148,10010100
95,01011111,107,01101011,202,11001010
113,01110001,96,01100000,209,11010001
24,00011000,64,01000000,88,01011000
29,00011101,62,00111110,91,01011011
119,01110111,108,01101100,227,11100011
98,01100010,111,01101111,209,11010001
114,01110010,108,01101100,222,11011110
44,00101100,66,01000010,110,01101110
18,00010010,77,01001101,95,01011111
117,01110101,72,01001000,189,10111101
4,00000100,19,00010011,23,00010111
9,00001001,93,01011101,102,01100110
64,01000000,38,00100110,102,01100110
113,01110001,22,00010110,135,10000111
25,00011001,27,00011011,52,00110100
17,00010001,61,00111101,78,01001110
58,00111010,118,01110110,176,10110000
89,01011001,118,01110110,207,11001111
118,01110110,107,01101011,225,11100001
75,01001011,70,01000110,145,10010001
68,01000100,30,00011110,98,01100010
8,00001000,60,00111100,68,01000100
15,00001111,19,00010011,34,00100010
16,00010000,96,01100000,112,01110000
92,01011100,10,00001010,102,01100110
58,00111010,29,00011101,87,01010111
77,01001101,39,00100111,116,01110100
99,01100011,113,01110001,212,11010100
115,01110011,43,00101011,158,10011110
58,00111010,107,01101011,165,10100101
6,00000110,106,01101010,112,01110000
6,00000110,51,00110011,57,00111001
92,01011100,41,00101001,133,10000101
77,01001101,100,01100100,177,10110001
38,00100110,113,01110001,151,10010111
20,00010100,113,01110001,133,10000101
27,00011011,85,01010101,112,01110000
99,01100011,14,00001110,113,01110001
98,01100010,114,01110010,212,11010100
114,01110010,104,01101000,218,11011010
16,00010000,60,00111100,76,01001100
14,00001110,33,00100001,47,00101111
53,00110101,20,00010100,73,01001001
110,01101110,80,01010000,190,10111110
54,00110110,94,01011110,148,10010100
42,00101010,14,00001110,56,00111000
114,01110010,21,00010101,135,10000111
7,00000111,57,00111001,64,01000000
50,00110010,57,00111001,107,01101011
33,00100001,9,00001001,42,00101010
1,00000001,72,01001000,73,01001001
5,00000101,110,01101110,115,01110011
44,00101100,27,00011011,71,01000111
22,00010110,3,00000011,25,00011001
59,00111011,120,01111000,179,10110011
83,01010011,47,00101111,130,10000010
56,00111000,75,01001011,131,10000011
51,00110011,107,01101011,158,10011110
68,01000100,50,00110010,118,01110110
8,00001000,100,01100100,108,01101100
35,00100011,53,00110101,88,01011000
79,01001111,17,00010001,96,01100000
118,01110110,85,01010101,203,11001011
59,00111011,66,01000010,125,01111101
91,01011011,71,01000111,162,10100010
26,00011010,0,00000000,26,00011010
96,01100000,8,00001000,104,01101000
63,00111111,58,00111010,121,01111001
71,01000111,58,00111010,129,10000001
92,01011100,111,01101111,203,11001011
27,00011011,77,01001101,104,01101000
20,00010100,63,00111111,83,01010011
101,01100101,17,00010001,118,01110110
112,01110000,88,01011000,200,11001000
84,01010100,68,01000100,152,10011000
12,00001100,11,00001011,23,00010111
10,00001010,56,00111000,66,01000010
77,01001101,58,00111010,135,10000111
11,00001011,32,00100000,43,00101011
92,01011100,60,00111100,152,10011000
75,01001011,39,00100111,114,01110010
69,01000101,113,01110001,182,10110110
115,01110011,33,00100001,148,10010100
100,01100100,61,00111101,161,10100001
97,01100001,33,00100001,130,10000010
6,00000110,30,00011110,36,00100100
102,01100110,91,01011011,193,11000001
14,00001110,97,01100001,111,01101111
90,01011010,99,01100011,189,10111101
87,01010111,84,01010100,171,10101011
67,01000011,86,01010110,153,10011001
69,01000101,13,00001101,82,01010010
31,00011111,115,01110011,146,10010010
79,01001111,69,01000101,148,10010100
52,00110100,81,01010001,133,10000101
102,01100110,95,01011111,197,11000101
115,01110011,88,01011000,203,11001011
86,01010110,57,00111001,143,10001111
17,00010001,123,01111011,140,10001100
62,00111110,68,01000100,130,10000010
107,01101011,81,01010001,188,10111100
45,00101101,54,00110110,99,01100011
63,00111111,105,01101001,168,10101000
70,01000110,108,01101100,178,10110010
59,00111011,85,01010101,144,10010000
6,00000110,44,00101100,50,00110010
30,00011110,52,00110100,82,01010010
22,00010110,112,01110000,134,10000110
22,00010110,42,00101010,64,01000000
53,00110101,49,00110001,102,01100110
90,01011010,40,00101000,130,10000010
119,01110111,77,01001101,196,11000100
8,00001000,47,00101111,55,00110111
125,01111101,12,00001100,137,10001001
88,01011000,111,01101111,199,11000111
127,01111111,23,00010111,150,10010110
114,01110010,37,00100101,151,10010111
9,00001001,33,00100001,42,00101010
120,01111000,92,01011100,212,11010100
97,01100001,10,00001010,107,01101011
2,00000010,91,01011011,93,01011101
14,00001110,90,01011010,104,01101000
3,00000011,19,00010011,22,00010110
63,00111111,76,01001100,139,10001011
55,00110111,90,01011010,145,10010001
74,01001010,50,00110010,124,01111100
24,00011000,100,01100100,124,01111100
56,00111000,115,01110011,171,10101011
42,00101010,126,01111110,168,10101000
101,01100101,4,00000100,105,01101001
3,00000011,68,01000100,71,01000111
9,00001001,105,01101001,114,01110010
79,01001111,35,00100011,114,01110010
106,01101010,124,01111100,230,11100110
3,00000011,70,01000110,73,01001001
78,01001110,24,00011000,102,01100110
69,01000101,40,00101000,109,01101101
72,01001000,40,00101000,112,01110000
14,00001110,8,00001000,22,00010110
104,01101000,112,01110000,216,11011000
35,00100011,21,00010101,56,00111000
3,00000011,38,00100110,41,00101001
86,01010110,69,01000101,155,10011011
125,01111101,0,00000000,125,01111101
48,00110000,21,00010101,69,01000101
47,00101111,96,01100000,143,10001111
48,00110000,56,00111000,104,01101000
7,00000111,23,00010111,30,00011110
4,00000100,30,00011110,34,00100010
113,01110001,13,00001101,126,01111110
50,00110010,113,01110001,163,10100011
3,00000011,58,00111010,61,00111101
68,01000100,42,00101010,110,01101110
25,00011001,82,01010010,107,01101011
28,00011100,80,01010000,108,01101100
49,00110001,49,00110001,98,01100010
14,00001110,107,01101011,121,01111001
100,01100100,74,01001010,174,10101110
103,01100111,97,01100001,200,11001000
62,00111110,89,01011001,151,10010111
54,00110110,117,01110101,171,10101011
91,01011011,116,01110100,207,11001111
79,01001111,43,00101011,122,01111010
113,01110001,114,01110010,227,11100011
120,01111000,43,00101011,163,10100011
41,00101001,30,00011110,71,01000111
58,00111010,85,01010101,143,10001111
69,01000101,20,00010100,89,01011001
29,00011101,97,01100001,126,01111110
57,00111001,127,01111111,184,10111000
50,00110010,76,01001100,126,01111110
76,01001100,102,01100110,178,10110010
25,00011001,6,00000110,31,00011111
34,00100010,37,00100101,71,01000111
42,00101010,113,01110001,155,10011011
102,01100110,48,00110000,150,10010110
54,00110110,50,00110010,104,01101000
95,01011111,70,01000110,165,10100101
109,01101101,8,00001000,117,01110101
59,00111011,125,01111101,184,10111000
30,00011110,38,00100110,68,01000100
94,01011110,121,01111001,215,11010111
29,00011101,94,01011110,123,01111011
2,00000010,126,01111110,128,10000000
122,01111010,84,01010100,206,11001110
57,00111001,82,01010010,139,10001011
116,01110100,55,00110111,171,10101011
88,01011000,91,01011011,179,10110011
32,00100000,84,01010100,116,01110100
37,00100101,117,01110101,154,10011010
65,01000001,126,01111110,191,10111111
38,00100110,77,01001101,115,01110011
13,00001101,86,01010110,99,01100011
119,01110111,69,01000101,188,10111100
97,01100001,3,00000011,100,01100100
41,00101001,5,00000101,46,00101110
30,00011110,4,00000100,34,00100010
119,01110111,108,01101100,227,11100011
112,01110000,100,01100100,212,11010100
122,01111010,51,00110011,173,10101101
102,01100110,1,00000001,103,01100111
11,00001011,50,00110010,61,00111101
120,01111000,83,01010011,203,11001011
84,01010100,79,01001111,163,10100011
64,01000000,127,01111111,191,10111111
109,01101101,53,00110101,162,10100010
38,00100110,88,01011000,126,01111110
25,00011001,106,01101010,131,10000011
115,01110011,78,01001110,193,11000001
16,00010000,98,01100010,114,01110010
29,00011101,53,00110101,82,01010010
113,01110001,88,01011000,201,11001001
56,00111000,25,00011001,81,01010001
126,01111110,14,00001110,140,10001100
92,01011100,83,01010011,175,10101111
63,00111111,8,00001000,71,01000111
126,01111110,83,01010011,209,11010001
124,01111100,32,00100000,156,10011100
22,00010110,16,00010000,38,00100110
41,00101001,31,00011111,72,01001000
68,01000100,20,00010100,88,01011000
110,01101110,77,01001101,187,10111011
62,00111110,16,00010000,78,01001110
77,01001101,90,01011010,167,10100111
120,01111000,32,00100000,152,10011000
70,01000110,125,01111101,195,11000011
101,01100101,88,01011000,189,10111101
9,00001001,116,01110100,125,01111101
85,01010101,20,00010100,105,01101001
28,00011100,79,01001111,107,01101011
15,00001111,108,01101100,123,01111011
12,00001100,95,01011111,107,01101011
44,00101100,46,00101110,90,01011010
119,01110111,55,00110111,174,10101110
77,01001101,82,01010010,159,10011111
89,01011001,4,00000100,93,01011101
69,01000101,30,00011110,99,01100011
8,00001000,102,01100110,110,01101110
2,00000010,33,00100001,35,00100011
34,00100010,79,01001111,113,01110001
34,00100010,96,01100000,130,10000010
3,00000011,58,00111010,61,00111101
52,00110100,106,01101010,158,10011110
57,00111001,123,01111011,180,10110100
67,01000011,85,01010101,152,10011000
55,00110111,36,00100100,91,01011011
61,00111101,58,00111010,119,01110111
70,01000110,85,01010101,155,10011011
121,01111001,14,00001110,135,10000111
117,01110101,14,00001110,131,10000011
81,01010001,94,01011110,175,10101111
59,00111011,83,01010011,142,10001110
108,01101100,109,01101101,217,11011001
98,01100010,96,01100000,194,11000010
96,01100000,93,01011101,189,10111101
54,00110110,23,00010111,77,01001101
70,01000110,106,01101010,176,10110000
55,00110111,95,01011111,150,10010110
48,00110000,22,00010110,70,01000110
86,01010110,54,00110110,140,10001100
107,01101011,96,01100000,203,11001011
1,00000001,125,01111101,126,01111110
84,01010100,20,00010100,104,01101000
13,00001101,62,00111110,75,01001011
70,01000110,101,01100101,171,10101011
62,00111110,48,00110000,110,01101110
34,00100010,101,01100101,135,10000111
102,01100110,84,01010100,186,10111010
109,01101101,34,00100010,143,10001111
51,00110011,10,00001010,61,00111101
85,01010101,94,01011110,179,10110011
42,00101010,1,00000001,43,00101011
6,00000110,28,00011100,34,00100010
76,01001100,48,00110000,124,01111100
59,00111011,50,00110010,109,01101101
63,00111111,75,01001011,138,10001010
106,01101010,52,00110100,158,10011110
117,01110101,76,01001100,193,11000001
111,01101111,48,00110000,159,10011111
5,00000101,46,00101110,51,00110011
119,01110111,84,01010100,203,11001011
15,00001111,16,00010000,31,00011111
115,01110011,108,01101100,223,11011111
64,01000000,25,00011001,89,01011001
103,01100111,100,01100100,203,11001011
104,01101000,63,00111111,167,10100111
37,00100101,111,01101111,148,10010100
29,00011101,41,00101001,70,01000110
75,01001011,41,00101001,116,01110100
90,01011010,6,00000110,96,01100000
86,01010110,104,01101000,190,10111110
97,01100001,108,01101100,205,11001101
29,00011101,82,01010010,111,01101111
90,01011010,75,01001011,165,10100101
117,01110101,49,00110001,166,10100110
85,01010101,8,00001000,93,01011101
106,01101010,45,00101101,151,10010111
105,01101001,48,00110000,153,10011001
32,00100000,26,00011010,58,00111010
15,00001111,50,00110010,65,01000001
80,01010000,0,00000000,80,01010000
73,01001001,104,01101000,177,10110001
7,00000111,93,01011101,100,01100100
99,01100011,0,00000000,99,01100011
112,01110000,32,00100000,144,10010000
96,01100000,14,00001110,110,01101110
50,00110010,71,01000111,121,01111001
98,01100010,24,00011000,122,01111010
34,00100010,16,00010000,50,00110010
10,00001010,54,00110110,64,01000000
114,01110010,9,00001001,123,01111011
11,00001011,108,01101100,119,01110111
20,00010100,62,00111110,82,01010010
19,00010011,45,00101101,64,01000000
84,01010100,96,01100000,180,10110100
114,01110010,22,00010110,136,10001000
87,01010111,113,01110001,200,11001000
93,01011101,87,01010111,180,10110100
63,00111111,48,00110000,111,01101111
70,01000110,117,01110101,187,10111011
50,00110010,55,00110111,105,01101001
69,01000101,14,00001110,83,01010011
75,01001011,26,00011010,101,01100101
76,01001100,38,00100110,114,01110010
35,00100011,45,00101101,80,01010000
37,00100101,33,00100001,70,01000110
27,00011011,43,00101011,70,01000110
62,00111110,88,01011000,150,10010110
43,00101011,36,00100100,79,01001111
104,01101000,45,00101101,149,10010101
32,00100000,2,00000010,34,00100010
2,00000010,76,01001100,78,01001110
23,00010111,85,01010101,108,01101100
112,01110000,7,00000111,119,01110111
98,01100010,95,01011111,193,11000001
67,01000011,58,00111010,125,01111101
70,01000110,28,00011100,98,01100010
40,00101000,82,01010010,122,01111010
48,00110000,52,00110100,100,01100100
76,01001100,65,01000001,141,10001101
13,00001101,72,01001000,85,01010101
30,00011110,79,01001111,109,01101101
56,00111000,49,00110001,105,01101001
101,01100101,92,01011100,193,11000001
101,01100101,96,01100000,197,11000101
27,00011011,93,01011101,120,01111000
89,01011001,36,00100100,125,01111101
11,00001011,82,01010010,93,01011101
57,00111001,76,01001100,133,10000101
85,01010101,70,01000110,155,10011011
73,01001001,101,01100101,174,10101110
37,00100101,43,00101011,80,01010000
0,00000000,105,01101001,105,01101001
69,01000101,90,01011010,159,10011111
36,00100100,13,00001101,49,00110001
14,00001110,51,00110011,65,01000001
39,00100111,60,00111100,99,01100011
18,00010010,123,01111011,141,10001101
121,01111001,40,00101000,161,10100001
5,00000101,126,01111110,131,10000011
86,01010110,118,01110110,204,11001100
8,00001000,120,01111000,128,10000000
99,01100011,14,00001110,113,01110001
107,01101011,51,00110011,158,10011110
73,01001001,109,01101101,182,10110110
105,01101001,60,00111100,165,10100101
16,00010000,106,01101010,122,01111010
18,00010010,46,00101110,64,01000000
36,00100100,93,01011101,129,10000001
114,01110010,65,01000001,179,10110011
103,01100111,85,01010101,188,10111100
122,01111010,49,00110001,171,10101011
35,00100011,87,01010111,122,01111010
68,01000100,125,01111101,193,11000001
65,01000001,118,01110110,183,10110111
21,00010101,51,00110011,72,01001000
31,00011111,99,01100011,130,10000010
6,00000110,2,00000010,8,00001000
15,00001111,59,00111011,74,01001010
117,01110101,58,00111010,175,10101111
122,01111010,39,00100111,161,10100001
20,00010100,32,00100000,52,00110100
88,01011000,34,00100010,122,01111010
70,01000110,59,00111011,129,10000001
54,00110110,116,01110100,170,10101010
104,01101000,9,00001001,113,01110001
43,00101011,13,00001101,56,00111000
73,01001001,120,01111000,193,11000001
84,01010100,77,01001101,161,10100001
118,01110110,13,00001101,131,10000011
116,01110100,76,01001100,192,11000000
85,01010101,122,01111010,207,11001111
37,00100101,76,01001100,113,01110001
78,01001110,73,01001001,151,10010111
103,01100111,27,00011011,130,10000010
101,01100101,94,01011110,195,11000011
19,00010011,100,01100100,119,01110111
21,00010101,6,00000110,27,00011011
99,01100011,66,01000010,165,10100101
117,01110101,38,00100110,155,10011011
19,00010011,4,00000100,23,00010111
80,01010000,81,01010001,161,10100001
38,00100110,77,01001101,115,01110011
126,01111110,107,01101011,233,11101001
46,00101110,37,00100101,83,01010011
25,00011001,13,00001101,38,00100110
85,01010101,60,00111100,145,10010001
37,00100101,42,00101010,79,01001111
105,01101001,104,01101000,209,11010001
4,00000100,90,01011010,94,01011110
57,00111001,86,01010110,143,10001111
78,01001110,113,01110001,191,10111111
78,01001110,42,00101010,120,01111000
83,01010011,25,00011001,108,01101100
94,01011110,48,00110000,142,10001110
36,00100100,11,00001011,47,00101111
54,00110110,94,01011110,148,10010100
58,00111010,22,00010110,80,01010000
65,01000001,107,01101011,172,10101100
116,01110100,26,00011010,142,10001110
80,01010000,16,00010000,96,01100000
96,01100000,80,01010000,176,10110000
69,01000101,10,00001010,79,01001111
75,01001011,21,00010101,96,01100000
100,01100100,35,00100011,135,10000111
112,01110000,60,00111100,172,10101100
86,01010110,96,01100000,182,10110110
57,00111001,96,01100000,153,10011001
17,00010001,77,01001101,94,01011110
19,00010011,85,01010101,104,01101000
119,01110111,106,01101010,225,11100001
68,01000100,88,01011000,156,10011100
87,01010111,1,00000001,88,01011000
7,00000111,42,00101010,49,00110001
74,01001010,1,00000001,75,01001011
22,00010110,50,00110010,72,01001000
71,01000111,9,00001001,80,01010000
92,01011100,123,01111011,215,11010111
44,00101100,123,01111011,167,10100111
105,01101001,46,00101110,151,10010111
19,00010011,122,01111010,141,10001101
103,01100111,69,01000101,172,10101100
90,01011010,8,00001000,98,01100010
57,00111001,44,00101100,101,01100101
85,01010101,17,00010001,102,01100110
5,00000101,78,01001110,83,01010011
96,01100000,37,00100101,133,10000101
27,00011011,94,01011110,121,01111001
61,00111101,60,00111100,121,01111001
60,00111100,58,00111010,118,01110110
56,00111000,70,01000110,126,01111110
76,01001100,75,01001011,151,10010111
27,00011011,116,01110100,143,10001111
81,01010001,82,01010010,163,10100011
79,01001111,4,00000100,83,01010011
16,00010000,123,01111011,139,10001011
103,01100111,72,01001000,175,10101111
11,00001011,41,00101001,52,00110100
42,00101010,62,00111110,104,01101000
12,00001100,125,01111101,137,10001001
36,00100100,22,00010110,58,00111010
122,01111010,85,01010101,207,11001111
124,01111100,43,00101011,167,10100111
124,01111100,62,00111110,186,10111010
127,01111111,73,01001001,200,11001000
120,01111000,123,01111011,243,11110011
76,01001100,81,01010001,157,10011101
87,01010111,52,00110100,139,10001011
55,00110111,15,00001111,70,01000110
3,00000011,95,01011111,98,01100010
58,00111010,125,01111101,183,10110111
47,00101111,61,00111101,108,01101100
11,00001011,32,00100000,43,00101011
106,01101010,79,01001111,185,10111001
25,00011001,15,00001111,40,00101000
65,01000001,93,01011101,158,10011110
16,00010000,29,00011101,45,00101101
56,00111000,100,01100100,156,10011100
93,01011101,64,01000000,157,10011101
61,00111101,119,01110111,180,10110100
39,00100111,86,01010110,125,01111101
2,00000010,101,01100101,103,01100111
48,00110000,126,01111110,174,10101110
19,00010011,71,01000111,90,01011010
14,00001110,98,01100010,112,01110000
30,00011110,3,00000011,33,00100001
74,01001010,120,01111000,194,11000010
108,01101100,22,00010110,130,10000010
47,00101111,106,01101010,153,10011001
54,00110110,110,01101110,164,10100100
87,01010111,48,00110000,135,10000111
127,01111111,73,01001001,200,11001000
33,00100001,113,01110001,146,10010010
90,01011010,8,00001000,98,01100010
29,00011101,92,01011100,121,01111001
97,01100001,49,00110001,146,10010010
104,01101000,117,01110101,221,11011101
54,00110110,44,00101100,98,01100010
124,01111100,18,00010010,142,10001110
78,01001110,2,00000010,80,01010000
104,01101000,10,00001010,114,01110010
89,01011001,70,01000110,159,10011111
28,00011100,53,00110101,81,01010001
92,01011100,16,00010000,108,01101100
103,01100111,85,01010101,188,10111100
86,01010110,61,00111101,147,10010011
120,01111000,82,01010010,202,11001010
0,00000000,72,01001000,72,01001000
113,01110001,66,01000010,179,10110011
59,00111011,118,01110110,177,10110001
9,00001001,35,00100011,44,00101100
77,01001101,106,01101010,183,10110111
58,00111010,92,01011100,150,10010110
44,00101100,21,00010101,65,01000001
0,00000000,83,01010011,83,01010011
72,01001000,34,00100010,106,01101010
58,00111010,88,01011000,146,10010010
51,00110011,74,01001010,125,01111101
116,01110100,109,01101101,225,11100001
12,00001100,5,00000101,17,00010001
100,01100100,41,00101001,141,10001101
116,01110100,72,01001000,188,10111100
66,01000010,119,01110111,185,10111001
114,01110010,88,01011000,202,11001010
105,01101001,106,01101010,211,11010011
26,00011010,82,01010010,108,01101100
37,00100101,42,00101010,79,01001111
126,01111110,79,01001111,205,11001101
17,00010001,104,01101000,121,01111001
15,00001111,113,01110001,128,10000000
112,01110000,0,00000000,112,01110000
105,01101001,96,01100000,201,11001001
110,01101110,119,01110111,229,11100101
86,01010110,35,00100011,121,01111001
14,00001110,125,01111101,139,10001011
32,00100000,32,00100000,64,01000000
77,01001101,58,00111010,135,10000111
21,00010101,22,00010110,43,00101011
10,00001010,21,00010101,31,00011111
119,01110111,83,01010011,202,11001010
1,00000001,41,00101001,42,00101010
99,01100011,80,01010000,179,10110011
72,01001000,3,00000011,75,01001011
118,01110110,85,01010101,203,11001011
15,00001111,24,00011000,39,00100111
29,00011101,87,01010111,116,01110100
64,01000000,108,01101100,172,10101100
0,00000000,55,00110111,55,00110111
63,00111111,33,00100001,96,01100000
7,00000111,27,00011011,34,00100010
86,01010110,90,01011010,176,10110000
85,01010101,100,01100100,185,10111001
52,00110100,53,00110101,105,01101001
51,00110011,89,01011001,140,10001100
91,01011011,9,00001001,100,01100100
57,00111001,54,00110110,111,01101111
48,00110000,29,00011101,77,01001101
90,01011010,9,00001001,99,01100011
48,00110000,29,00011101,77,01001101
116,01110100,43,00101011,159,10011111
10,00001010,127,01111111,137,10001001
38,00100110,105,01101001,143,10001111
58,00111010,22,00010110,80,01010000
16,00010000,84,01010100,100,01100100
101,01100101,44,00101100,145,10010001
27,00011011,10,00001010,37,00100101
109,01101101,39,00100111,148,10010100
45,00101101,44,00101100,89,01011001
41,00101001,93,01011101,134,10000110
123,01111011,125,01111101,248,11111000
5,00000101,2,00000010,7,00000111
48,00110000,18,00010010,66,01000010
100,01100100,102,01100110,202,11001010
95,01011111,48,00110000,143,10001111
55,00110111,61,00111101,116,01110100
8,00001000,86,01010110,94,01011110
38,00100110,19,00010011,57,00111001
122,01111010,87,01010111,209,11010001
5,00000101,62,00111110,67,01000011
28,00011100,119,01110111,147,10010011
33,00100001,65,01000001,98,01100010
58,00111010,67,01000011,125,01111101
49,00110001,84,01010100,133,10000101
78,01001110,6,00000110,84,01010100
43,00101011,117,01110101,160,10100000
107,01101011,60,00111100,167,10100111
27,00011011,18,00010010,45,00101101
93,01011101,49,00110001,142,10001110
1,00000001,75,01001011,76,01001100
93,01011101,54,00110110,147,10010011
45,00101101,127,01111111,172,10101100
119,01110111,11,00001011,130,10000010
28,00011100,27,00011011,55,00110111
55,00110111,22,00010110,77,01001101
26,00011010,117,01110101,143,10001111
35,00100011,110,01101110,145,10010001
86,01010110,88,01011000,174,10101110
88,01011000,77,01001101,165,10100101
102,01100110,71,01000111,173,10101101
77,01001101,14,00001110,91,01011011
27,00011011,71,01000111,98,01100010
85,01010101,116,01110100,201,11001001
71,01000111,24,00011000,95,01011111
47,00101111,85,01010101,132,10000100
122,01111010,89,01011001,211,11010011
125,01111101,115,01110011,240,11110000
37,00100101,48,00110000,85,01010101
73,01001001,58,00111010,131,10000011
52,00110100,7,00000111,59,00111011
1,00000001,43,00101011,44,00101100
121,01111001,3,00000011,124,01111100
103,01100111,31,00011111,134,10000110
20,00010100,85,01010101,105,01101001
16,00010000,76,01001100,92,01011100
59,00111011,21,00010101,80,01010000
70,01000110,119,01110111,189,10111101
9,00001001,38,00100110,47,00101111
74,01001010,48,00110000,122,01111010
30,00011110,24,00011000,54,00110110
41,00101001,50,00110010,91,01011011
72,01001000,111,01101111,183,10110111
39,00100111,122,01111010,161,10100001
65,01000001,75,01001011,140,10001100
115,01110011,60,00111100,175,10101111
91,01011011,104,01101000,195,11000011
37,00100101,33,00100001,70,01000110
32,00100000,77,01001101,109,01101101
4,00000100,99,01100011,103,01100111
49,00110001,29,00011101,78,01001110
1,00000001,62,00111110,63,00111111
53,00110101,10,00001010,63,00111111
70,01000110,90,01011010,160,10100000
41,00101001,123,01111011,164,10100100
30,00011110,116,01110100,146,10010010
76,01001100,5,00000101,81,01010001
23,00010111,118,01110110,141,10001101
96,01100000,63,00111111,159,10011111
32,00100000,69,01000101,101,01100101
98,01100010,24,00011000,122,01111010
25,00011001,7,00000111,32,00100000
81,01010001,88,01011000,169,10101001
78,01001110,17,00010001,95,01011111
52,00110100,5,00000101,57,00111001
43,00101011,33,00100001,76,01001100
44,00101100,37,00100101,81,01010001
20,00010100,101,01100101,121,01111001
1,00000001,12,00001100,13,00001101
37,00100101,107,01101011,144,10010000
80,01010000,46,00101110,126,01111110
106,01101010,100,01100100,206,11001110
98,01100010,64,01000000,162,10100010
35,00100011,50,00110010,85,01010101
14,00001110,89,01011001,103,01100111
44,00101100,46,00101110,90,01011010
5,00000101,61,00111101,66,01000010
28,00011100,76,01001100,104,01101000
48,00110000,102,01100110,150,10010110
71,01000111,83,01010011,154,10011010
41,00101001,85,01010101,126,01111110
40,00101000,127,01111111,167,10100111
25,00011001,64,01000000,89,01011001
86,01010110,43,00101011,129,10000001
38,00100110,117,01110101,155,10011011
25,00011001,127,01111111,152,10011000
56,00111000,44,00101100,100,01100100
92,01011100,1,00000001,93,01011101
66,01000010,54,00110110,120,01111000
10,00001010,109,01101101,119,01110111
109,01101101,54,00110110,163,10100011
43,00101011,13,00001101,56,00111000
92,01011100,109,01101101,201,11001001
1,00000001,127,01111111,128,10000000
124,01111100,117,01110101,241,11110001
37,00100101,100,01100100,137,10001001
102,01100110,50,00110010,152,10011000
121,01111001,98,01100010,219,11011011
104,01101000,40,00101000,144,10010000
98,01100010,111,01101111,209,11010001
26,00011010,107,01101011,133,10000101
89,01011001,89,01011001,178,10110010
57,00111001,62,00111110,119,01110111
6,00000110,15,00001111,21,00010101
58,00111010,119,01110111,177,10110001
46,00101110,94,01011110,140,10001100
7,00000111,77,01001101,84,01010100
87,01010111,108,01101100,195,11000011
27,00011011,74,01001010,101,01100101
58,00111010,36,00100100,94,01011110
25,00011001,118,01110110,143,10001111
78,01001110,97,01100001,175,10101111
120,01111000,41,00101001,161,10100001
55,00110111,103,01100111,158,10011110
102,01100110,31,00011111,133,10000101
121,01111001,83,01010011,204,11001100
10,00001010,55,00110111,65,01000001
25,00011001,38,00100110,63,00111111
72,01001000,38,00100110,110,01101110
8,00001000,92,01011100,100,01100100
52,00110100,67,01000011,119,01110111
72,01001000,92,01011100,164,10100100
42,00101010,105,01101001,147,10010011
62,00111110,14,00001110,76,01001100
17,00010001,105,01101001,122,01111010
17,00010001,10,00001010,27,00011011
68,01000100,127,01111111,195,11000011
93,01011101,32,00100000,125,01111101
102,01100110,56,00111000,158,10011110
99,01100011,77,01001101,176,10110000
29,00011101,62,00111110,91,01011011
83,01010011,108,01101100,191,10111111
11,00001011,37,00100101,48,00110000
99,01100011,3,00000011,102,01100110
66,01000010,122,01111010,188,10111100
17,00010001,65,01000001,82,01010010
54,00110110,1,00000001,55,00110111
51,00110011,11,00001011,62,00111110
29,00011101,2,00000010,31,00011111
24,00011000,55,00110111,79,01001111
28,00011100,29,00011101,57,00111001
44,00101100,68,01000100,112,01110000
61,00111101,30,00011110,91,01011011
24,00011000,39,00100111,63,00111111
93,01011101,20,00010100,113,01110001
116,01110100,86,01010110,202,11001010
23,00010111,11,00001011,34,00100010
52,00110100,93,01011101,145,10010001
12,00001100,110,01101110,122,01111010
33,00100001,3,00000011,36,00100100
71,01000111,58,00111010,129,10000001
43,00101011,101,01100101,144,10010000
12,00001100,24,00011000,36,00100100
113,01110001,90,01011010,203,11001011
117,01110101,15,00001111,132,10000100
117,01110101,22,00010110,139,10001011
99,01100011,97,01100001,196,11000100
122,01111010,80,01010000,202,11001010
108,01101100,125,01111101,233,11101001
119,01110111,64,01000000,183,10110111
118,01110110,68,01000100,186,10111010
6,00000110,50,00110010,56,00111000
121,01111001,30,00011110,151,10010111
122,01111010,83,01010011,205,11001101
16,00010000,81,01010001,97,01100001
29,00011101,109,01101101,138,10001010
76,01001100,74,01001010,150,10010110
17,00010001,117,01110101,134,10000110
54,00110110,98,01100010,152,10011000
40,00101000,88,01011000,128,10000000
27,00011011,34,00100010,61,00111101
58,00111010,14,00001110,72,01001000
8,00001000,52,00110100,60,00111100
44,00101100,18,00010010,62,00111110
91,01011011,90,01011010,181,10110101
114,01110010,87,01010111,201,11001001
71,01000111,74,01001010,145,10010001
66,01000010,21,00010101,87,01010111
76,01001100,102,01100110,178,10110010
11,00001011,22,00010110,33,00100001
60,00111100,39,00100111,99,01100011
77,01001101,121,01111001,198,11000110
33,00100001,105,01101001,138,10001010
88,01011000,117,01110101,205,11001101
123,01111011,55,00110111,178,10110010
87,01010111,87,01010111,174,10101110
92,01011100,14,00001110,106,01101010
93,01011101,61,00111101,154,10011010
43,00101011,39,00100111,82,01010010
65,01000001,92,01011100,157,10011101
117,01110101,48,00110000,165,10100101
62,00111110,114,01110010,176,10110000
118,01110110,94,01011110,212,11010100
15,00001111,95,01011111,110,01101110
28,00011100,8,00001000,36,00100100
100,01100100,108,01101100,208,11010000
83,01010011,15,00001111,98,01100010
118,01110110,82,01010010,200,11001000
105,01101001,59,00111011,164,10100100
64,01000000,64,01000000,128,10000000
55,00110111,49,00110001,104,01101000
61,00111101,65,01000001,126,01111110
74,01001010,94,01011110,168,10101000
10,00001010,35,00100011,45,00101101
2,00000010,1,00000001,3,00000011
73,01001001,118,01110110,191,10111111
42,00101010,112,01110000,154,10011010
116,01110100,67,01000011,183,10110111
110,01101110,107,01101011,217,11011001
36,00100100,13,00001101,49,00110001
35,00100011,117,01110101,152,10011000
15,00001111,50,00110010,65,01000001
110,01101110,73,01001001,183,10110111
103,01100111,82,01010010,185,10111001
66,01000010,45,00101101,111,01101111
41,00101001,4,00000100,45,00101101
124,01111100,108,01101100,232,11101000
78,01001110,15,00001111,93,01011101
108,01101100,84,01010100,192,11000000
89,01011001,42,00101010,131,10000011
82,01010010,86,01010110,168,10101000
20,00010100,126,01111110,146,10010010
107,01101011,117,01110101,224,11100000
46,00101110,60,00111100,106,01101010
106,01101010,50,00110010,156,10011100
66,01000010,71,01000111,137,10001001
48,00110000,18,00010010,66,01000010
77,01001101,65,01000001,142,10001110
51,00110011,116,01110100,167,10100111
96,01100000,67,01000011,163,10100011
118,01110110,100,01100100,218,11011010
48,00110000,112,01110000,160,10100000
29,00011101,67,01000011,96,01100000
69,01000101,27,00011011,96,01100000
10,00001010,52,00110100,62,00111110
110,01101110,6,00000110,116,01110100
12,00001100,65,01000001,77,01001101
67,01000011,63,00111111,130,10000010
8,00001000,100,01100100,108,01101100
11,00001011,81,01010001,92,01011100
104,01101000,34,00100010,138,10001010
3,00000011,33,00100001,36,00100100
19,00010011,3,00000011,22,00010110
109,01101101,93,01011101,202,11001010
26,00011010,91,01011011,117,01110101
103,01100111,115,01110011,218,11011010
112,01110000,69,01000101,181,10110101
22,00010110,84,01010100,106,01101010
77,01001101,90,01011010,167,10100111
31,00011111,114,01110010,145,10010001
38,00100110,5,00000101,43,00101011
49,00110001,102,01100110,151,10010111
9,00001001,103,01100111,112,01110000
93,01011101,108,01101100,201,11001001
56,00111000,61,00111101,117,01110101
8,00001000,96,01100000,104,01101000
50,00110010,16,00010000,66,01000010
21,00010101,95,01011111,116,01110100
107,01101011,120,01111000,227,11100011
120,01111000,42,00101010,162,10100010
69,01000101,114,01110010,183,10110111
3,00000011,59,00111011,62,00111110
88,01011000,94,01011110,182,10110110
11,00001011,121,01111001,132,10000100
108,01101100,41,00101001,149,10010101
35,00100011,119,01110111,154,10011010
26,00011010,115,01110011,141,10001101
48,00110000,2,00000010,50,00110010
6,00000110,49,00110001,55,00110111
111,01101111,11,00001011,122,01111010
42,00101010,21,00010101,63,00111111
126,01111110,21,00010101,147,10010011
80,01010000,8,00001000,88,01011000
87,01010111,103,01100111,190,10111110
112,01110000,85,01010101,197,11000101
64,01000000,101,01100101,165,10100101
111,01101111,11,00001011,122,01111010
35,00100011,98,01100010,133,10000101
90,01011010,32,00100000,122,01111010
97,01100001,107,01101011,204,11001100
124,01111100,86,01010110,210,11010010
19,00010011,104,01101000,123,01111011
102,01100110,53,00110101,155,10011011
104,01101000,56,00111000,160,10100000
125,01111101,61,00111101,186,10111010
57,00111001,66,01000010,123,01111011
92,01011100,32,00100000,124,01111100
7,00000111,125,01111101,132,10000100
15,00001111,107,01101011,122,01111010
95,01011111,113,01110001,208,11010000
94,01011110,44,00101100,138,10001010
85,01010101,81,01010001,166,10100110
77,01001101,98,01100010,175,10101111
48,00110000,91,01011011,139,10001011
72,01001000,36,00100100,108,01101100
84,01010100,100,01100100,184,10111000
26,00011010,55,00110111,81,01010001
37,00100101,50,00110010,87,01010111
108,01101100,34,00100010,142,10001110
10,00001010,95,01011111,105,01101001
84,01010100,15,00001111,99,01100011
107,01101011,45,00101101,152,10011000
121,01111001,42,00101010,163,10100011
23,00010111,60,00111100,83,01010011
46,00101110,11,00001011,57,00111001
21,00010101,10,00001010,31,00011111
65,01000001,67,01000011,132,10000100
51,00110011,121,01111001,172,10101100
36,00100100,49,00110001,85,01010101
97,01100001,124,01111100,221,11011101
68,01000100,72,01001000,140,10001100
67,01000011,99,01100011,166,10100110
79,01001111,52,00110100,131,10000011
94,01011110,40,00101000,134,10000110
127,01111111,81,01010001,208,11010000
33,00100001,18,00010010,51,00110011
127,01111111,67,01000011,194,11000010
121,01111001,21,00010101,142,10001110
56,00111000,51,00110011,107,01101011
116,01110100,109,01101101,225,11100001
86,01010110,80,01010000,166,10100110
78,01001110,89,01011001,167,10100111
13,00001101,3,00000011,16,00010000
89,01011001,122,01111010,211,11010011
81,01010001,76,01001100,157,10011101
29,00011101,46,00101110,75,01001011
45,00101101,89,01011001,134,10000110
69,01000101,108,01101100,177,10110001
8,00001000,46,00101110,54,00110110
121,01111001,48,00110000,169,10101001
122,01111010,64,01000000,186,10111010
66,01000010,61,00111101,127,01111111
9,00001001,11,00001011,20,00010100
63,00111111,31,00011111,94,01011110
22,00010110,33,00100001,55,00110111
63,00111111,47,00101111,110,01101110
84,01010100,73,01001001,157,10011101
86,01010110,91,01011011,177,10110001
73,01001001,19,00010011,92,01011100
87,01010111,57,00111001,144,10010000
55,00110111,52,00110100,107,01101011
124,01111100,88,01011000,212,11010100
116,01110100,89,01011001,205,11001101
114,01110010,70,01000110,184,10111000
51,00110011,35,00100011,86,01010110
80,01010000,95,01011111,175,10101111
33,00100001,5,00000101,38,00100110
60,00111100,13,00001101,73,01001001
11,00001011,107,01101011,118,01110110
43,00101011,69,01000101,112,01110000
74,01001010,82,01010010,156,10011100
66,01000010,62,00111110,128,10000000
119,01110111,16,00010000,135,10000111
0,00000000,13,00001101,13,00001101
48,00110000,22,00010110,70,01000110
33,00100001,0,00000000,33,00100001
106,01101010,73,01001001,179,10110011
25,00011001,104,01101000,129,10000001
57,00111001,58,00111010,115,01110011
66,01000010,14,00001110,80,01010000
118,01110110,58,00111010,176,10110000
28,00011100,85,01010101,113,01110001
66,01000010,22,00010110,88,01011000
125,01111101,72,01001000,197,11000101
111,01101111,80,01010000,191,10111111
35,00100011,109,01101101,144,10010000
27,00011011,98,01100010,125,01111101
57,00111001,7,00000111,64,01000000
29,00011101,10,00001010,39,00100111
93,01011101,71,01000111,164,10100100
112,01110000,7,00000111,119,01110111
65,01000001,25,00011001,90,01011010
13,00001101,77,01001101,90,01011010
64,01000000,41,00101001,105,01101001
44,00101100,19,00010011,63,00111111
67,01000011,121,01111001,188,10111100
39,00100111,117,01110101,156,10011100
65,01000001,81,01010001,146,10010010
59,00111011,118,01110110,177,10110001
98,01100010,106,01101010,204,11001100
5,00000101,66,01000010,71,01000111
75,01001011,63,00111111,138,10001010
107,01101011,69,01000101,176,10110000
74,01001010,116,01110100,190,10111110
4,00000100,45,00101101,49,00110001
127,01111111,32,00100000,159,10011111
52,00110100,48,00110000,100,01100100
83,01010011,86,01010110,169,10101001
68,01000100,21,00010101,89,01011001
99,01100011,76,01001100,175,10101111
31,00011111,96,01100000,127,01111111
91,01011011,61,00111101,152,10011000
77,01001101,30,00011110,107,01101011
82,01010010,75,01001011,157,10011101
96,01100000,54,00110110,150,10010110
114,01110010,11,00001011,125,01111101
82,01010010,113,01110001,195,11000011
112,01110000,92,01011100,204,11001100
107,01101011,18,00010010,125,01111101
85,01010101,67,01000011,152,10011000
29,00011101,33,00100001,62,00111110
45,00101101,120,01111000,165,10100101
42,00101010,93,01011101,135,10000111
75,01001011,83,01010011,158,10011110
115,01110011,56,00111000,171,10101011
82,01010010,35,00100011,117,01110101
45,00101101,102,01100110,147,10010011
47,00101111,2,00000010,49,00110001
3,00000011,58,00111010,61,00111101
3,00000011,84,01010100,87,01010111
38,00100110,16,00010000,54,00110110
95,01011111,13,00001101,108,01101100
111,01101111,11,00001011,122,01111010
97,01100001,93,01011101,190,10111110
82,01010010,74,01001010,156,10011100
109,01101101,88,01011000,197,11000101
112,01110000,20,00010100,132,10000100
66,01000010,81,01010001,147,10010011
74,01001010,28,00011100,102,01100110
92,01011100,115,01110011,207,11001111
101,01100101,73,01001001,174,10101110
4,00000100,79,01001111,83,01010011
55,00110111,92,01011100,147,10010011
44,00101100,12,00001100,56,00111000
66,01000010,95,01011111,161,10100001
40,00101000,63,00111111,103,01100111
116,01110100,59,00111011,175,10101111
98,01100010,17,00010001,115,01110011
72,01001000,98,01100010,170,10101010
30,00011110,72,01001000,102,01100110
14,00001110,25,00011001,39,00100111
13,00001101,41,00101001,54,00110110
22,00010110,100,01100100,122,01111010
100,01100100,81,01010001,181,10110101
68,01000100,0,00000000,68,01000100
22,00010110,36,00100100,58,00111010
97,01100001,11,00001011,108,01101100
124,01111100,52,00110100,176,10110000
118,01110110,4,00000100,122,01111010
114,01110010,108,01101100,222,11011110
71,01000111,66,01000010,137,10001001
76,01001100,127,01111111,203,11001011
15,00001111,24,00011000,39,00100111
2,00000010,97,01100001,99,01100011
123,01111011,81,01010001,204,11001100
112,01110000,35,00100011,147,10010011
14,00001110,123,01111011,137,10001001
74,01001010,49,00110001,123,01111011
53,00110101,106,01101010,159,10011111
111,01101111,126,01111110,237,11101101
48,00110000,104,01101000,152,10011000
71,01000111,74,01001010,145,10010001
125,01111101,61,00111101,186,10111010
31,00011111,79,01001111,110,01101110
88,01011000,17,00010001,105,01101001
118,01110110,59,00111011,177,10110001
16,00010000,88,01011000,104,01101000
86,01010110,44,00101100,130,10000010
74,01001010,102,01100110,176,10110000
21,00010101,121,01111001,142,10001110
55,00110111,64,01000000,119,01110111
70,01000110,111,01101111,181,10110101
116,01110100,58,00111010,174,10101110
48,00110000,51,00110011,99,01100011
92,01011100,80,01010000,172,10101100
51,00110011,61,00111101,112,01110000
7,00000111,110,01101110,117,01110101
69,01000101,1,00000001,70,01000110
0,00000000,99,01100011,99,01100011
69,01000101,11,00001011,80,01010000
71,01000111,112,01110000,183,10110111
66,01000010,51,00110011,117,01110101
63,00111111,81,01010001,144,10010000
97,01100001,124,01111100,221,11011101
47,00101111,75,01001011,122,01111010
55,00110111,108,01101100,163,10100011
51,00110011,79,01001111,130,10000010
33,00100001,92,01011100,125,01111101
52,00110100,107,01101011,159,10011111
22,00010110,117,01110101,139,10001011
14,00001110,4,00000100,18,00010010
95,01011111,38,00100110,133,10000101
45,00101101,97,01100001,142,10001110
71,01000111,125,01111101,196,11000100
100,01100100,68,01000100,168,10101000
116,01110100,102,01100110,218,11011010
121,01111001,42,00101010,163,10100011
29,00011101,127,01111111,156,10011100
116,01110100,59,00111011,175,10101111
9,00001001,95,01011111,104,01101000
52,00110100,53,00110101,105,01101001
105,01101001,6,00000110,111,01101111
104,01101000,103,01100111,207,11001111
22,00010110,114,01110010,136,10001000
16,00010000,92,01011100,108,01101100
15,00001111,38,00100110,53,00110101
9,00001001,28,00011100,37,00100101
52,00110100,13,00001101,65,01000001
71,01000111,55,00110111,126,01111110
54,00110110,43,00101011,97,01100001
58,00111010,87,01010111,145,10010001
107,01101011,54,00110110,161,10100001
106,01101010,113,01110001,219,11011011
122,01111010,82,01010010,204,11001100
123,01111011,118,01110110,241,11110001
65,01000001,95,01011111,160,10100000
101,01100101,50,00110010,151,10010111
90,01011010,48,00110000,138,10001010
106,01101010,100,01100100,206,11001110
44,00101100,29,00011101,73,01001001
107,01101011,34,00100010,141,10001101
97,01100001,109,01101101,206,11001110
16,00010000,101,01100101,117,01110101
93,01011101,0,00000000,93,01011101
3,00000011,51,00110011,54,00110110
82,01010010,11,00001011,93,01011101
101,01100101,69,01000101,170,10101010
96,01100000,104,01101000,200,11001000
108,01101100,35,00100011,143,10001111
123,01111011,101,01100101,224,11100000
69,01000101,40,00101000,109,01101101
50,00110010,88,01011000,138,10001010
74,01001010,106,01101010,180,10110100
75,01001011,115,01110011,190,10111110
63,00111111,98,01100010,161,10100001
116,01110100,25,00011001,141,10001101
105,01101001,37,00100101,142,10001110
99,01100011,27,00011011,126,01111110
69,01000101,110,01101110,179,10110011
99,01100011,75,01001011,174,10101110
102,01100110,82,01010010,184,10111000
59,00111011,15,00001111,74,01001010
118,01110110,90,01011010,208,11010000
10,00001010,12,00001100,22,00010110
80,01010000,99,01100011,179,10110011
94,01011110,45,00101101,139,10001011
0,00000000,74,01001010,74,01001010
4,00000100,0,00000000,4,00000100
76,01001100,50,00110010,126,01111110
125,01111101,53,00110101,178,10110010
127,01111111,111,01101111,238,11101110
75,01001011,72,01001000,147,10010011
75,01001011,32,00100000,107,01101011
31,00011111,125,01111101,156,10011100
15,00001111,39,00100111,54,00110110
85,01010101,110,01101110,195,11000011
50,00110010,123,01111011,173,10101101
13,00001101,16,00010000,29,00011101
91,01011011,78,01001110,169,10101001
7,00000111,19,00010011,26,00011010
38,00100110,115,01110011,153,10011001
62,00111110,51,00110011,113,01110001
121,01111001,5,00000101,126,01111110
89,01011001,86,01010110,175,10101111
68,01000100,30,00011110,98,01100010
31,00011111,88,01011000,119,01110111
6,00000110,4,00000100,10,00001010
65,01000001,73,01001001,138,10001010
108,01101100,80,01010000,188,10111100
68,01000100,68,01000100,136,10001000
0,00000000,22,00010110,22,00010110
12,00001100,18,00010010,30,00011110
99,01100011,14,00001110,113,01110001
109,01101101,45,00101101,154,10011010
85,01010101,38,00100110,123,01111011
9,00001001,115,01110011,124,01111100
41,00101001,48,00110000,89,01011001
117,01110101,67,01000011,184,10111000
13,00001101,119,01110111,132,10000100
78,01001110,55,00110111,133,10000101
7,00000111,57,00111001,64,01000000
25,00011001,102,01100110,127,01111111
57,00111001,15,00001111,72,01001000
122,01111010,102,01100110,224,11100000
0,00000000,36,00100100,36,00100100
67,01000011,118,01110110,185,10111001
104,01101000,35,00100011,139,10001011
74,01001010,5,00000101,79,01001111
76,01001100,30,00011110,106,01101010
116,01110100,105,01101001,221,11011101
67,01000011,107,01101011,174,10101110
50,00110010,57,00111001,107,01101011
79,01001111,78,01001110,157,10011101
49,00110001,43,00101011,92,01011100
55,00110111,64,01000000,119,01110111
109,01101101,19,00010011,128,10000000
27,00011011,119,01110111,146,10010010
88,01011000,115,01110011,203,11001011
112,01110000,58,00111010,170,10101010
104,01101000,40,00101000,144,10010000
125,01111101,13,00001101,138,10001010
20,00010100,23,00010111,43,00101011
17,00010001,119,01110111,136,10001000
127,01111111,33,00100001,160,10100000
18,00010010,36,00100100,54,00110110
103,01100111,58,00111010,161,10100001
105,01101001,94,01011110,199,11000111
2,00000010,35,00100011,37,00100101
36,00100100,55,00110111,91,01011011
19,00010011,8,00001000,27,00011011
114,01110010,23,00010111,137,10001001
43,00101011,2,00000010,45,00101101
7,00000111,20,00010100,27,00011011
114,01110010,7,00000111,121,01111001
115,01110011,120,01111000,235,11101011
127,01111111,56,00111000,183,10110111
48,00110000,123,01111011,171,10101011
10,00001010,54,00110110,64,01000000
80,01010000,126,01111110,206,11001110
64,01000000,67,01000011,131,10000011
39,00100111,79,01001111,118,01110110
31,00011111,64,01000000,95,01011111
62,00111110,106,01101010,168,10101000
104,01101000,43,00101011,147,10010011
105,01101001,47,00101111,152,10011000
37,00100101,76,01001100,113,01110001
20,00010100,42,00101010,62,00111110
96,01100000,94,01011110,190,10111110
57,00111001,41,00101001,98,01100010
84,01010100,76,01001100,160,10100000
74,01001010,7,00000111,81,01010001
75,01001011,69,01000101,144,10010000
6,00000110,105,01101001,111,01101111
42,00101010,91,01011011,133,10000101
108,01101100,89,01011001,197,11000101
36,00100100,120,01111000,156,10011100
68,01000100,43,00101011,111,01101111
48,00110000,4,00000100,52,00110100
125,01111101,107,01101011,232,11101000
37,00100101,69,01000101,106,01101010
72,01001000,78,01001110,150,10010110
86,01010110,88,01011000,174,10101110
57,00111001,75,01001011,132,10000100
11,00001011,36,00100100,47,00101111
118,01110110,127,01111111,245,11110101
73,01001001,47,00101111,120,01111000
52,00110100,39,00100111,91,01011011
64,01000000,69,01000101,133,10000101
79,01001111,117,01110101,196,11000100
87,01010111,18,00010010,105,01101001
121,01111001,117,01110101,238,11101110
54,00110110,9,00001001,63,00111111
22,00010110,41,00101001,63,00111111
17,00010001,16,00010000,33,00100001
122,01111010,85,01010101,207,11001111
43,00101011,50,00110010,93,01011101
55,00110111,33,00100001,88,01011000
85,01010101,74,01001010,159,10011111
49,00110001,79,01001111,128,10000000
112,01110000,24,00011000,136,10001000
31,00011111,36,00100100,67,01000011
20,00010100,52,00110100,72,01001000
63,00111111,125,01111101,188,10111100
52,00110100,58,00111010,110,01101110
99,01100011,6,00000110,105,01101001
43,00101011,83,01010011,126,01111110
76,01001100,116,01110100,192,11000000
31,00011111,2,00000010,33,00100001
24,00011000,43,00101011,67,01000011
62,00111110,65,01000001,127,01111111
29,00011101,30,00011110,59,00111011
26,00011010,5,00000101,31,00011111
98,01100010,56,00111000,154,10011010
73,01001001,8,00001000,81,01010001
120,01111000,106,01101010,226,11100010
57,00111001,77,01001101,134,10000110
126,01111110,106,01101010,232,11101000
95,01011111,48,00110000,143,10001111
87,01010111,121,01111001,208,11010000
40,00101000,13,00001101,53,00110101
66,01000010,114,01110010,180,10110100
86,01010110,44,00101100,130,10000010
53,00110101,121,01111001,174,10101110
17,00010001,69,01000101,86,01010110
61,00111101,79,01001111,140,10001100
57,00111001,46,00101110,103,01100111
88,01011000,19,00010011,107,01101011
4,00000100,103,01100111,107,01101011
0,00000000,64,01000000,64,01000000
103,01100111,107,01101011,210,11010010
74,01001010,120,01111000,194,11000010
93,01011101,88,01011000,181,10110101
9,00001001,11,00001011,20,00010100
84,01010100,60,00111100,144,10010000
65,01000001,11,00001011,76,01001100
5,00000101,90,01011010,95,01011111
13,00001101,3,00000011,16,00010000
96,01100000,96,01100000,192,11000000
4,00000100,108,01101100,112,01110000
100,01100100,36,00100100,136,10001000
65,01000001,33,00100001,98,01100010
121,01111001,91,01011011,212,11010100
56,00111000,118,01110110,174,10101110
107,01101011,119,01110111,226,11100010
43,00101011,90,01011010,133,10000101
21,00010101,40,00101000,61,00111101
22,00010110,99,01100011,121,01111001
78,01001110,75,01001011,153,10011001
84,01010100,55,00110111,139,10001011
15,00001111,66,01000010,81,01010001
82,01010010,73,01001001,155,10011011
94,01011110,87,01010111,181,10110101
54,00110110,49,00110001,103,01100111
56,00111000,25,00011001,81,01010001
7,00000111,118,01110110,125,01111101
10,00001010,87,01010111,97,01100001
38,00100110,68,01000100,106,01101010
52,00110100,16,00010000,68,01000100
77,01001101,113,01110001,190,10111110
126,01111110,32,00100000,158,10011110
71,01000111,110,01101110,181,10110101
97,01100001,31,00011111,128,10000000
98,01100010,28,00011100,126,01111110
109,01101101,126,01111110,235,11101011
58,00111010,45,00101101,103,01100111
80,01010000,7,00000111,87,01010111
54,00110110,90,01011010,144,10010000
115,01110011,25,00011001,140,10001100
87,01010111,6,00000110,93,01011101
30,00011110,11,00001011,41,00101001
113,01110001,23,00010111,136,10001000
84,01010100,71,01000111,155,10011011
64,01000000,110,01101110,174,10101110
123,01111011,78,01001110,201,11001001
74,01001010,6,00000110,80,01010000
83,01010011,67,01000011,150,10010110
92,01011100,95,01011111,187,10111011
3,00000011,37,00100101,40,00101000
101,01100101,71,01000111,172,10101100
72,01001000,113,01110001,185,10111001
44,00101100,112,01110000,156,10011100
4,00000100,69,01000101,73,01001001
11,00001011,19,00010011,30,00011110
32,00100000,118,01110110,150,10010110
80,01010000,41,00101001,121,01111001
112,01110000,45,00101101,157,10011101
70,01000110,86,01010110,156,10011100
98,01100010,65,01000001,163,10100011
122,01111010,30,00011110,152,10011000
47,00101111,124,01111100,171,10101011
117,01110101,97,01100001,214,11010110
65,01000001,33,00100001,98,01100010
106,01101010,65,01000001,171,10101011
125,01111101,46,00101110,171,10101011
18,00010010,57,00111001,75,01001011
77,01001101,23,00010111,100,01100100
63,00111111,16,00010000,79,01001111
7,00000111,98,01100010,105,01101001
106,01101010,106,01101010,212,11010100
34,00100010,34,00100010,68,01000100
4,00000100,92,01011100,96,01100000
61,00111101,107,01101011,168,10101000
40,00101000,111,01101111,151,10010111
80,01010000,122,01111010,202,11001010
20,00010100,73,01001001,93,01011101
59,00111011,37,00100101,96,01100000
35,00100011,125,01111101,160,10100000
94,01011110,121,01111001,215,11010111
37,00100101,124,01111100,161,10100001
50,00110010,37,00100101,87,01010111
17,00010001,111,01101111,128,10000000
50,00110010,102,01100110,152,10011000
48,00110000,57,00111001,105,01101001
53,00110101,35,00100011,88,01011000
49,00110001,14,00001110,63,00111111
40,00101000,5,00000101,45,00101101
38,00100110,92,01011100,130,10000010
90,01011010,65,01000001,155,10011011
59,00111011,102,01100110,161,10100001
117,01110101,89,01011001,206,11001110
84,01010100,10,00001010,94,01011110
69,01000101,62,00111110,131,10000011
102,01100110,56,00111000,158,10011110
65,01000001,112,01110000,177,10110001
59,00111011,106,01101010,165,10100101
45,00101101,4,00000100,49,00110001
34,00100010,35,00100011,69,01000101
48,00110000,79,01001111,127,01111111
41,00101001,104,01101000,145,10010001
48,00110000,67,01000011,115,01110011
115,01110011,76,01001100,191,10111111
70,01000110,124,01111100,194,11000010
83,01010011,118,01110110,201,11001001
66,01000010,0,00000000,66,01000010
73,01001001,81,01010001,154,10011010
21,00010101,71,01000111,92,01011100
49,00110001,11,00001011,60,00111100
84,01010100,120,01111000,204,11001100
114,01110010,11,00001011,125,01111101
79,01001111,62,00111110,141,10001101
87,01010111,63,00111111,150,10010110
79,01001111,118,01110110,197,11000101
19,00010011,102,01100110,121,01111001
19,00010011,33,00100001,52,00110100
111,01101111,127,01111111,238,11101110
20,00010100,85,01010101,105,01101001
79,01001111,109,01101101,188,10111100
42,00101010,7,00000111,49,00110001
34,00100010,13,00001101,47,00101111
111,01101111,111,01101111,222,11011110
23,00010111,102,01100110,125,01111101
91,01011011,35,00100011,126,01111110
49,00110001,70,01000110,119,01110111
126,01111110,114,01110010,240,11110000
88,01011000,79,01001111,167,10100111
68,01000100,6,00000110,74,01001010
71,01000111,65,01000001,136,10001000
85,01010101,68,01000100,153,10011001
100,01100100,76,01001100,176,10110000
43,00101011,47,00101111,90,01011010
52,00110100,30,00011110,82,01010010
75,01001011,22,00010110,97,01100001
3,00000011,119,01110111,122,01111010
93,01011101,108,01101100,201,11001001
3,00000011,49,00110001,52,00110100
22,00010110,66,01000010,88,01011000
37,00100101,18,00010010,55,00110111
123,01111011,56,00111000,179,10110011
85,01010101,59,00111011,144,10010000
67,01000011,39,00100111,106,01101010
4,00000100,76,01001100,80,01010000
52,00110100,49,00110001,101,01100101
96,01100000,82,01010010,178,10110010
120,01111000,59,00111011,179,10110011
35,00100011,70,01000110,105,01101001
92,01011100,87,01010111,179,10110011
24,00011000,91,01011011,115,01110011
18,00010010,16,00010000,34,00100010
121,01111001,36,00100100,157,10011101
48,00110000,105,01101001,153,10011001
48,00110000,63,00111111,111,01101111
1,00000001,52,00110100,53,00110101
14,00001110,27,00011011,41,00101001
13,00001101,118,01110110,131,10000011
50,00110010,77,01001101,127,01111111
108,01101100,26,00011010,134,10000110
20,00010100,122,01111010,142,10001110
14,00001110,83,01010011,97,01100001
103,01100111,90,01011010,193,11000001
17,00010001,85,01010101,102,01100110
32,00100000,88,01011000,120,01111000
102,01100110,71,01000111,173,10101101
91,01011011,72,01001000,163,10100011
46,00101110,86,01010110,132,10000100
13,00001101,109,01101101,122,01111010
47,00101111,30,00011110,77,01001101
2,00000010,111,01101111,113,01110001
25,00011001,104,01101000,129,10000001
123,01111011,103,01100111,226,11100010
109,01101101,116,01110100,225,11100001
123,01111011,77,01001101,200,11001000
94,01011110,39,00100111,133,10000101
94,01011110,45,00101101,139,10001011
64,01000000,35,00100011,99,01100011
46,00101110,3,00000011,49,00110001
45,00101101,77,01001101,122,01111010
124,01111100,9,00001001,133,10000101
23,00010111,72,01001000,95,01011111
45,00101101,111,01101111,156,10011100
58,00111010,16,00010000,74,01001010
60,00111100,37,00100101,97,01100001
102,01100110,45,00101101,147,10010011
117,01110101,121,01111001,238,11101110
34,00100010,108,01101100,142,10001110
7,00000111,122,01111010,129,10000001
95,01011111,70,01000110,165,10100101
107,01101011,73,01001001,180,10110100
27,00011011,74,01001010,101,01100101
7,00000111,107,01101011,114,01110010
88,01011000,15,00001111,103,01100111
124,01111100,31,00011111,155,10011011
99,01100011,99,01100011,198,11000110
62,00111110,102,01100110,164,10100100
89,01011001,73,01001001,162,10100010
46,00101110,39,00100111,85,01010101
123,01111011,63,00111111,186,10111010
30,00011110,29,00011101,59,00111011
19,00010011,33,00100001,52,00110100
78,01001110,71,01000111,149,10010101
101,01100101,16,00010000,117,01110101
105,01101001,126,01111110,231,11100111
118,01110110,124,01111100,242,11110010
75,01001011,90,01011010,165,10100101
28,00011100,6,00000110,34,00100010
23,00010111,81,01010001,104,01101000
92,01011100,63,00111111,155,10011011
110,01101110,40,00101000,150,10010110
35,00100011,92,01011100,127,01111111
51,00110011,17,00010001,68,01000100
50,00110010,50,00110010,100,01100100
29,00011101,76,01001100,105,01101001
125,01111101,85,01010101,210,11010010
110,01101110,5,00000101,115,01110011
42,00101010,4,00000100,46,00101110
42,00101010,121,01111001,163,10100011
24,00011000,7,00000111,31,00011111
25,00011001,39,00100111,64,01000000
78,01001110,44,00101100,122,01111010
17,00010001,67,01000011,84,01010100
29,00011101,54,00110110,83,01010011
45,00101101,99,01100011,144,10010000
97,01100001,60,00111100,157,10011101
127,01111111,84,01010100,211,11010011
22,00010110,50,00110010,72,01001000
46,00101110,90,01011010,136,10001000
56,00111000,2,00000010,58,00111010
107,01101011,107,01101011,214,11010110
44,00101100,46,00101110,90,01011010
18,00010010,2,00000010,20,00010100
112,01110000,1,00000001,113,01110001
58,00111010,82,01010010,140,10001100
64,01000000,113,01110001,177,10110001
15,00001111,14,00001110,29,00011101
81,01010001,106,01101010,187,10111011
50,00110010,60,00111100,110,01101110
45,00101101,10,00001010,55,00110111
80,01010000,108,01101100,188,10111100
106,01101010,68,01000100,174,10101110
104,01101000,10,00001010,114,01110010
100,01100100,54,00110110,154,10011010
118,01110110,55,00110111,173,10101101
52,00110100,90,01011010,142,10001110
110,01101110,75,01001011,185,10111001
48,00110000,54,00110110,102,01100110
32,00100000,75,01001011,107,01101011
44,00101100,127,01111111,171,10101011
1,00000001,72,01001000,73,01001001
70,01000110,62,00111110,132,10000100
35,00100011,77,01001101,112,01110000
28,00011100,106,01101010,134,10000110
89,01011001,63,00111111,152,10011000
27,00011011,82,01010010,109,01101101
126,01111110,22,00010110,148,10010100
106,01101010,10,00001010,116,01110100
57,00111001,23,00010111,80,01010000
107,01101011,57,00111001,164,10100100
30,00011110,46,00101110,76,01001100
3,00000011,6,00000110,9,00001001
3,00000011,100,01100100,103,01100111
80,01010000,80,01010000,160,10100000
35,00100011,121,01111001,156,10011100
124,01111100,82,01010010,206,11001110
42,00101010,103,01100111,145,10010001
127,01111111,105,01101001,232,11101000
111,01101111,106,01101010,217,11011001
90,01011010,86,01010110,176,10110000
95,01011111,126,01111110,221,11011101
100,01100100,44,00101100,144,10010000
14,00001110,101,01100101,115,01110011
13,00001101,62,00111110,75,01001011
27,00011011,27,00011011,54,00110110
112,01110000,119,01110111,231,11100111
111,01101111,85,01010101,196,11000100
127,01111111,49,00110001,176,10110000
29,00011101,109,01101101,138,10001010
50,00110010,74,01001010,124,01111100
49,00110001,42,00101010,91,01011011
49,00110001,106,01101010,155,10011011
97,01100001,100,01100100,197,11000101
97,01100001,23,00010111,120,01111000
55,00110111,74,01001010,129,10000001
119,01110111,86,01010110,205,11001101
29,00011101,2,00000010,31,00011111
124,01111100,99,01100011,223,11011111
126,01111110,24,00011000,150,10010110
9,00001001,98,01100010,107,01101011
32,00100000,105,01101001,137,10001001
49,00110001,87,01010111,136,10001000
126,01111110,31,00011111,157,10011101
64,01000000,58,00111010,122,01111010
69,01000101,17,00010001,86,01010110
60,00111100,127,01111111,187,10111011
127,01111111,99,01100011,226,11100010
110,01101110,116,01110100,226,11100010
52,00110100,2,00000010,54,00110110
28,00011100,127,01111111,155,10011011
50,00110010,43,00101011,93,01011101
14,00001110,80,01010000,94,01011110
92,01011100,72,01001000,164,10100100
47,00101111,63,00111111,110,01101110
121,01111001,71,01000111,192,11000000
113,01110001,114,01110010,227,11100011
92,01011100,23,00010111,115,01110011
8,00001000,76,01001100,84,01010100
53,00110101,20,00010100,73,01001001
122,01111010,117,01110101,239,11101111
89,01011001,30,00011110,119,01110111
95,01011111,21,00010101,116,01110100
30,00011110,67,01000011,97,01100001
22,00010110,13,00001101,35,00100011
112,01110000,107,01101011,219,11011011
119,01110111,66,01000010,185,10111001
28,00011100,52,00110100,80,01010000
93,01011101,34,00100010,127,01111111
25,00011001,85,01010101,110,01101110
53,00110101,71,01000111,124,01111100
2,00000010,111,01101111,113,01110001
80,01010000,16,00010000,96,01100000
109,01101101,30,00011110,139,10001011
35,00100011,1,00000001,36,00100100
41,00101001,90,01011010,131,10000011
48,00110000,57,00111001,105,01101001
120,01111000,42,00101010,162,10100010
42,00101010,14,00001110,56,00111000
120,01111000,64,01000000,184,10111000
45,00101101,103,01100111,148,10010100
44,00101100,53,00110101,97,01100001
27,00011011,13,00001101,40,00101000
33,00100001,63,00111111,96,01100000
87,01010111,95,01011111,182,10110110
37,00100101,18,00010010,55,00110111
79,01001111,90,01011010,169,10101001
121,01111001,67,01000011,188,10111100
7,00000111,53,00110101,60,00111100
123,01111011,11,00001011,134,10000110
97,01100001,8,00001000,105,01101001
68,01000100,44,00101100,112,01110000
24,00011000,74,01001010,98,01100010
28,00011100,52,00110100,80,01010000
96,01100000,14,00001110,110,01101110
43,00101011,72,01001000,115,01110011
9,00001001,50,00110010,59,00111011
110,01101110,99,01100011,209,11010001
2,00000010,63,00111111,65,01000001
106,01101010,93,01011101,199,11000111
104,01101000,29,00011101,133,10000101
120,01111000,73,01001001,193,11000001
96,01100000,69,01000101,165,10100101
100,01100100,25,00011001,125,01111101
42,00101010,98,01100010,140,10001100
1,00000001,123,01111011,124,01111100
59,00111011,105,01101001,164,10100100
78,01001110,0,00000000,78,01001110
15,00001111,73,01001001,88,01011000
119,01110111,96,01100000,215,11010111
13,00001101,80,01010000,93,01011101
67,01000011,102,01100110,169,10101001
53,00110101,11,00001011,64,01000000
109,01101101,80,01010000,189,10111101
57,00111001,78,01001110,135,10000111
113,01110001,100,01100100,213,11010101
62,00111110,101,01100101,163,10100011
27,00011011,65,01000001,92,01011100
66,01000010,65,01000001,131,10000011
1,00000001,36,00100100,37,00100101
100,01100100,34,00100010,134,10000110
69,01000101,101,01100101,170,10101010
99,01100011,78,01001110,177,10110001
120,01111000,10,00001010,130,10000010
116,01110100,72,01001000,188,10111100
19,00010011,22,00010110,41,00101001
74,01001010,80,01010000,154,10011010
93,01011101,59,00111011,152,10011000
54,00110110,120,01111000,174,10101110
47,00101111,71,01000111,118,01110110
29,00011101,72,01001000,101,01100101
90,01011010,94,01011110,184,10111000
64,01000000,76,01001100,140,10001100
69,01000101,118,01110110,187,10111011
112,01110000,86,01010110,198,11000110
106,01101010,41,00101001,147,10010011
98,01100010,103,01100111,201,11001001
89,01011001,58,00111010,147,10010011
76,01001100,107,01101011,183,10110111
82,01010010,43,00101011,125,01111101
44,00101100,83,01010011,127,01111111
117,01110101,90,01011010,207,11001111
86,01010110,75,01001011,161,10100001
61,00111101,125,01111101,186,10111010
120,01111000,88,01011000,208,11010000
7,00000111,22,00010110,29,00011101
42,00101010,76,01001100,118,01110110
117,01110101,36,00100100,153,10011001
97,01100001,106,01101010,203,11001011
43,00101011,60,00111100,103,01100111
66,01000010,72,01001000,138,10001010
98,01100010,124,01111100,222,11011110
125,01111101,63,00111111,188,10111100
95,01011111,44,00101100,139,10001011
97,01100001,11,00001011,108,01101100
58,00111010,68,01000100,126,01111110
57,00111001,21,00010101,78,01001110
53,00110101,6,00000110,59,00111011
103,01100111,25,00011001,128,10000000
35,00100011,20,00010100,55,00110111
51,00110011,119,01110111,170,10101010
10,00001010,85,01010101,95,01011111
29,00011101,32,00100000,61,00111101
121,01111001,98,01100010,219,11011011
4,00000100,114,01110010,118,01110110
84,01010100,30,00011110,114,01110010
46,00101110,14,00001110,60,00111100
124,01111100,91,01011011,215,11010111
54,00110110,101,01100101,155,10011011
51,00110011,77,01001101,128,10000000
82,01010010,94,01011110,176,10110000
124,01111100,33,00100001,157,10011101
125,01111101,79,01001111,204,11001100
101,01100101,42,00101010,143,10001111
53,00110101,48,00110000,101,01100101
4,00000100,62,00111110,66,01000010
22,00010110,77,01001101,99,01100011
71,01000111,74,01001010,145,10010001
107,01101011,48,00110000,155,10011011
64,01000000,67,01000011,131,10000011
87,01010111,12,00001100,99,01100011
49,00110001,32,00100000,81,01010001
82,01010010,119,01110111,201,11001001
56,00111000,77,01001101,133,10000101
81,01010001,25,00011001,106,01101010
31,00011111,30,00011110,61,00111101
24,00011000,118,01110110,142,10001110
111,01101111,125,01111101,236,11101100
48,00110000,8,00001000,56,00111000
84,01010100,47,00101111,131,10000011
118,01110110,1,00000001,119,01110111
75,01001011,122,01111010,197,11000101
97,01100001,10,00001010,107,01101011
122,01111010,35,00100011,157,10011101
43,00101011,106,01101010,149,10010101
7,00000111,126,01111110,133,10000101
69,01000101,14,00001110,83,01010011
24,00011000,20,00010100,44,00101100
42,00101010,5,00000101,47,00101111
47,00101111,61,00111101,108,01101100
35,00100011,79,01001111,114,01110010
64,01000000,15,00001111,79,01001111
70,01000110,94,01011110,164,10100100
118,01110110,118,01110110,236,11101100
13,00001101,99,01100011,112,01110000
8,00001000,52,00110100,60,00111100
95,01011111,100,01100100,195,11000011
37,00100101,28,00011100,65,01000001
77,01001101,113,01110001,190,10111110
113,01110001,77,01001101,190,10111110
93,01011101,15,00001111,108,01101100
110,01101110,107,01101011,217,11011001
28,00011100,17,00010001,45,00101101
36,00100100,16,00010000,52,00110100
123,01111011,117,01110101,240,11110000
50,00110010,4,00000100,54,00110110
107,01101011,76,01001100,183,10110111
79,01001111,10,00001010,89,01011001
31,00011111,110,01101110,141,10001101
11,00001011,92,01011100,103,01100111
26,00011010,83,01010011,109,01101101
3,00000011,101,01100101,104,01101000
67,01000011,104,01101000,171,10101011
78,01001110,85,01010101,163,10100011
14,00001110,40,00101000,54,00110110
24,00011000,4,00000100,28,00011100
73,01001001,123,01111011,196,11000100
20,00010100,23,00010111,43,00101011
114,01110010,121,01111001,235,11101011
112,01110000,45,00101101,157,10011101
114,01110010,7,00000111,121,01111001
24,00011000,93,01011101,117,01110101
2,00000010,116,01110100,118,01110110
114,01110010,41,00101001,155,10011011
71,01000111,50,00110010,121,01111001
7,00000111,4,00000100,11,00001011
31,00011111,119,01110111,150,10010110
47,00101111,27,00011011,74,01001010
11,00001011,71,01000111,82,01010010
1,00000001,45,00101101,46,00101110
55,00110111,86,01010110,141,10001101
21,00010101,30,00011110,51,00110011
117,01110101,104,01101000,221,11011101
27,00011011,28,00011100,55,00110111
60,00111100,47,00101111,107,01101011
84,01010100,65,01000001,149,10010101
52,00110100,95,01011111,147,10010011
77,01001101,109,01101101,186,10111010
69,01000101,49,00110001,118,01110110
42,00101010,56,00111000,98,01100010
10,00001010,10,00001010,20,00010100
49,00110001,56,00111000,105,01101001
42,00101010,125,01111101,167,10100111
40,00101000,78,01001110,118,01110110
96,01100000,51,00110011,147,10010011
113,01110001,4,00000100,117,01110101
52,00110100,90,01011010,142,10001110
40,00101000,22,00010110,62,00111110
6,00000110,48,00110000,54,00110110
63,00111111,70,01000110,133,10000101
112,01110000,120,01111000,232,11101000
6,00000110,109,01101101,115,01110011
125,01111101,39,00100111,164,10100100
52,00110100,112,01110000,164,10100100
67,01000011,118,01110110,185,10111001
87,01010111,114,01110010,201,11001001
66,01000010,55,00110111,121,01111001
5,00000101,83,01010011,88,01011000
5,00000101,115,01110011,120,01111000
75,01001011,28,00011100,103,01100111
86,01010110,22,00010110,108,01101100
121,01111001,30,00011110,151,10010111
104,01101000,37,00100101,141,10001101
118,01110110,102,01100110,220,11011100
110,01101110,15,00001111,125,01111101
24,00011000,26,00011010,50,00110010
101,01100101,33,00100001,134,10000110
21,00010101,50,00110010,71,01000111
70,01000110,19,00010011,89,01011001
9,00001001,108,01101100,117,01110101
84,01010100,11,00001011,95,01011111
27,00011011,24,00011000,51,00110011
106,01101010,56,00111000,162,10100010
79,01001111,32,00100000,111,01101111
124,01111100,45,00101101,169,10101001
111,01101111,103,01100111,214,11010110
84,01010100,34,00100010,118,01110110
67,01000011,98,01100010,165,10100101
98,01100010,10,00001010,108,01101100
72,01001000,69,01000101,141,10001101
19,00010011,55,00110111,74,01001010
66,01000010,53,00110101,119,01110111
55,00110111,8,00001000,63,00111111
123,01111011,61,00111101,184,10111000
59,00111011,48,00110000,107,01101011
44,00101100,118,01110110,162,10100010
45,00101101,42,00101010,87,01010111
49,00110001,5,00000101,54,00110110
94,01011110,78,01001110,172,10101100
12,00001100,35,00100011,47,00101111
73,01001001,58,00111010,131,10000011
48,00110000,107,01101011,155,10011011
107,01101011,23,00010111,130,10000010
61,00111101,77,01001101,138,10001010
76,01001100,81,01010001,157,10011101
72,01001000,20,00010100,92,01011100
81,01010001,100,01100100,181,10110101
89,01011001,49,00110001,138,10001010
117,01110101,42,00101010,159,10011111
10,00001010,35,00100011,45,00101101
65,01000001,9,00001001,74,01001010
46,00101110,70,01000110,116,01110100
14,00001110,71,01000111,85,01010101
86,01010110,89,01011001,175,10101111
5,00000101,71,01000111,76,01001100
90,01011010,108,01101100,198,11000110
1,00000001,116,01110100,117,01110101
71,01000111,37,00100101,108,01101100
36,00100100,10,00001010,46,00101110
2,00000010,107,01101011,109,01101101
25,00011001,111,01101111,136,10001000
44,00101100,94,01011110,138,10001010
114,01110010,71,01000111,185,10111001
34,00100010,60,00111100,94,01011110
9,00001001,102,01100110,111,01101111
13,00001101,37,00100101,50,00110010
118,01110110,53,00110101,171,10101011
61,00111101,85,01010101,146,10010010
19,00010011,122,01111010,141,10001101
80,01010000,107,01101011,187,10111011
11,00001011,89,01011001,100,01100100
7,00000111,98,01100010,105,01101001
50,00110010,26,00011010,76,01001100
93,01011101,73,01001001,166,10100110
9,00001001,54,00110110,63,00111111
50,00110010,10,00001010,60,00111100
77,01001101,114,01110010,191,10111111
107,01101011,110,01101110,217,11011001
52,00110100,52,00110100,104,01101000
49,00110001,87,01010111,136,10001000
105,01101001,92,01011100,197,11000101
77,01001101,86,01010110,163,10100011
119,01110111,110,01101110,229,11100101
98,01100010,106,01101010,204,11001100
99,01100011,87,01010111,186,10111010
78,01001110,23,00010111,101,01100101
112,01110000,37,00100101,149,10010101
30,00011110,46,00101110,76,01001100
95,01011111,35,00100011,130,10000010
43,00101011,7,00000111,50,00110010
18,00010010,31,00011111,49,00110001
6,00000110,79,01001111,85,01010101
99,01100011,57,00111001,156,10011100
101,01100101,127,01111111,228,11100100
54,00110110,16,00010000,70,01000110
118,01110110,61,00111101,179,10110011
43,00101011,65,01000001,108,01101100
38,00100110,73,01001001,111,01101111
121,01111001,67,01000011,188,10111100
87,01010111,69,01000101,156,10011100
64,01000000,70,01000110,134,10000110
66,01000010,71,01000111,137,10001001
119,01110111,113,01110001,232,11101000
23,00010111,112,01110000,135,10000111
96,01100000,100,01100100,196,11000100
63,00111111,122,01111010,185,10111001
39,00100111,70,01000110,109,01101101
8,00001000,82,01010010,90,01011010
120,01111000,6,00000110,126,01111110
32,00100000,111,01101111,143,10001111
51,00110011,127,01111111,178,10110010
14,00001110,106,01101010,120,01111000
31,00011111,99,01100011,130,10000010
122,01111010,89,01011001,211,11010011
115,01110011,12,00001100,127,01111111
24,00011000,52,00110100,76,01001100
111,01101111,61,00111101,172,10101100
50,00110010,78,01001110,128,10000000
9,00001001,22,00010110,31,00011111
76,01001100,37,00100101,113,01110001
97,01100001,68,01000100,165,10100101
126,01111110,45,00101101,171,10101011
46,00101110,19,00010011,65,01000001
40,00101000,68,01000100,108,01101100
10,00001010,11,00001011,21,00010101
116,01110100,55,00110111,171,10101011
11,00001011,113,01110001,124,01111100
1,00000001,101,01100101,102,01100110
68,01000100,73,01001001,141,10001101
110,01101110,114,01110010,224,11100000
91,01011011,111,01101111,202,11001010
95,01011111,52,00110100,147,10010011
46,00101110,116,01110100,162,10100010
84,01010100,19,00010011,103,01100111
37,00100101,27,00011011,64,01000000
54,00110110,22,00010110,76,01001100
31,00011111,27,00011011,58,00111010
2,00000010,53,00110101,55,00110111
113,01110001,34,00100010,147,10010011
80,01010000,18,00010010,98,01100010
41,00101001,38,00100110,79,01001111
67,01000011,33,00100001,100,01100100
71,01000111,18,00010010,89,01011001
115,01110011,115,01110011,230,11100110
70,01000110,6,00000110,76,01001100
46,00101110,87,01010111,133,10000101
88,01011000,64,01000000,152,10011000
100,01100100,35,00100011,135,10000111
2,00000010,124,01111100,126,01111110
60,00111100,49,00110001,109,01101101
21,00010101,62,00111110,83,01010011
116,01110100,46,00101110,162,10100010
73,01001001,21,00010101,94,01011110
64,01000000,59,00111011,123,01111011
0,00000000,41,00101001,41,00101001
107,01101011,62,00111110,169,10101001
35,00100011,115,01110011,150,10010110
117,01110101,31,00011111,148,10010100
68,01000100,72,01001000,140,10001100
112,01110000,40,00101000,152,10011000
70,01000110,79,01001111,149,10010101
116,01110100,124,01111100,240,11110000
100,01100100,22,00010110,122,01111010
85,01010101,45,00101101,130,10000010
19,00010011,56,00111000,75,01001011
22,00010110,71,01000111,93,01011101
75,01001011,118,01110110,193,11000001
15,00001111,75,01001011,90,01011010
46,00101110,49,00110001,95,01011111
9,00001001,96,01100000,105,01101001
35,00100011,49,00110001,84,01010100
34,00100010,4,00000100,38,00100110
74,01001010,48,00110000,122,01111010
50,00110010,53,00110101,103,01100111
19,00010011,38,00100110,57,00111001
88,01011000,93,01011101,181,10110101
117,01110101,9,00001001,126,01111110
113,01110001,62,00111110,175,10101111
55,00110111,8,00001000,63,00111111
55,00110111,84,01010100,139,10001011
117,01110101,10,00001010,127,01111111
41,00101001,110,01101110,151,10010111
69,01000101,78,01001110,147,10010011
89,01011001,38,00100110,127,01111111
117,01110101,46,00101110,163,10100011
4,00000100,82,01010010,86,01010110
74,01001010,119,01110111,193,11000001
102,01100110,32,00100000,134,10000110
48,00110000,33,00100001,81,01010001
94,01011110,81,01010001,175,10101111
5,00000101,5,00000101,10,00001010
51,00110011,110,01101110,161,10100001
72,01001000,39,00100111,111,01101111
15,00001111,31,00011111,46,00101110
54,00110110,88,01011000,142,10001110
99,01100011,36,00100100,135,10000111
36,00100100,115,01110011,151,10010111
122,01111010,71,01000111,193,11000001
80,01010000,66,01000010,146,10010010
50,00110010,68,01000100,118,01110110
121,01111001,114,01110010,235,11101011
97,01100001,4,00000100,101,01100101
95,01011111,8,00001000,103,01100111
11,00001011,57,00111001,68,01000100
7,00000111,29,00011101,36,00100100
79,01001111,53,00110101,132,10000100
32,00100000,17,00010001,49,00110001
13,00001101,4,00000100,17,00010001
40,00101000,37,00100101,77,01001101
96,01100000,72,01001000,168,10101000
83,01010011,66,01000010,149,10010101
70,01000110,47,00101111,117,01110101
112,01110000,63,00111111,175,10101111
48,00110000,73,01001001,121,01111001
63,00111111,52,00110100,115,01110011
125,01111101,83,01010011,208,11010000
22,00010110,106,01101010,128,10000000
70,01000110,16,00010000,86,01010110
107,01101011,13,00001101,120,01111000
111,01101111,16,00010000,127,01111111
67,01000011,80,01010000,147,10010011
66,01000010,54,00110110,120,01111000
49,00110001,11,00001011,60,00111100
112,01110000,13,00001101,125,01111101
17,00010001,42,00101010,59,00111011
7,00000111,61,00111101,68,01000100
127,01111111,55,00110111,182,10110110
49,00110001,79,01001111,128,10000000
86,01010110,58,00111010,144,10010000
65,01000001,57,00111001,122,01111010
75,01001011,31,00011111,106,01101010
34,00100010,1,00000001,35,00100011
104,01101000,84,01010100,188,10111100
21,00010101,113,01110001,134,10000110
4,00000100,50,00110010,54,00110110
23,00010111,86,01010110,109,01101101
98,01100010,0,00000000,98,01100010
3,00000011,61,00111101,64,01000000
63,00111111,83,01010011,146,10010010
59,00111011,35,00100011,94,01011110
75,01001011,38,00100110,113,01110001
91,01011011,126,01111110,217,11011001
51,00110011,82,01010010,133,10000101
88,01011000,74,01001010,162,10100010
33,00100001,17,00010001,50,00110010
83,01010011,47,00101111,130,10000010
99,01100011,50,00110010,149,10010101
53,00110101,51,00110011,104,01101000
95,01011111,71,01000111,166,10100110
103,01100111,103,01100111,206,11001110
75,01001011,102,01100110,177,10110001
67,01000011,58,00111010,125,01111101
17,00010001,46,00101110,63,00111111
33,00100001,65,01000001,98,01100010
94,01011110,92,01011100,186,10111010
103,01100111,116,01110100,219,11011011
118,01110110,118,01110110,236,11101100
112,01110000,65,01000001,177,10110001
60,00111100,105,01101001,165,10100101
39,00100111,107,01101011,146,10010010
43,00101011,111,01101111,154,10011010
37,00100101,2,00000010,39,00100111
70,01000110,40,00101000,110,01101110
28,00011100,24,00011000,52,00110100
19,00010011,40,00101000,59,00111011
15,00001111,26,00011010,41,00101001
51,00110011,27,00011011,78,01001110
106,01101010,60,00111100,166,10100110
57,00111001,113,01110001,170,10101010
64,01000000,106,01101010,170,10101010
27,00011011,41,00101001,68,01000100
32,00100000,122,01111010,154,10011010
92,01011100,72,01001000,164,10100100
105,01101001,11,00001011,116,01110100
51,00110011,71,01000111,122,01111010
48,00110000,124,01111100,172,10101100
110,01101110,17,00010001,127,01111111
98,01100010,71,01000111,169,10101001
88,01011000,12,00001100,100,01100100
80,01010000,23,00010111,103,01100111
21,00010101,75,01001011,96,01100000
106,01101010,95,01011111,201,11001001
77,01001101,27,00011011,104,01101000
36,00100100,53,00110101,89,01011001
125,01111101,78,01001110,203,11001011
66,01000010,10,00001010,76,01001100
36,00100100,86,01010110,122,01111010
40,00101000,59,00111011,99,01100011
72,01001000,39,00100111,111,01101111
106,01101010,93,01011101,199,11000111
92,01011100,19,00010011,111,01101111
20,00010100,92,01011100,112,01110000
5,00000101,44,00101100,49,00110001
89,01011001,49,00110001,138,10001010
76,01001100,53,00110101,129,10000001
105,01101001,85,01010101,190,10111110
96,01100000,125,01111101,221,11011101
51,00110011,3,00000011,54,00110110
50,00110010,91,01011011,141,10001101
121,01111001,93,01011101,214,11010110
115,01110011,9,00001001,124,01111100
33,00100001,71,01000111,104,01101000
48,00110000,124,01111100,172,10101100
3,00000011,27,00011011,30,00011110
125,01111101,1,00000001,126,01111110
86,01010110,30,00011110,116,01110100
26,00011010,1,00000001,27,00011011
27,00011011,55,00110111,82,01010010
100,01100100,63,00111111,163,10100011
73,01001001,72,01001000,145,10010001
119,01110111,53,00110101,172,10101100
31,00011111,29,00011101,60,00111100
23,00010111,74,01001010,97,01100001
21,00010101,66,01000010,87,01010111
2,00000010,77,01001101,79,01001111
26,00011010,81,01010001,107,01101011
62,00111110,98,01100010,160,10100000
116,01110100,106,01101010,222,11011110
12,00001100,60,00111100,72,01001000
57,00111001,113,01110001,170,10101010
114,01110010,30,00011110,144,10010000
43,00101011,5,00000101,48,00110000
14,00001110,21,00010101,35,00100011
29,00011101,63,00111111,92,01011100
53,00110101,13,00001101,66,01000010
93,01011101,49,00110001,142,10001110
67,01000011,105,01101001,172,10101100
59,00111011,100,01100100,159,10011111
120,01111000,23,00010111,143,10001111
25,00011001,103,01100111,128,10000000
32,00100000,102,01100110,134,10000110
1,00000001,51,00110011,52,00110100
16,00010000,78,01001110,94,01011110
4,00000100,96,01100000,100,01100100
8,00001000,86,01010110,94,01011110
5,00000101,64,01000000,69,01000101
106,01101010,85,01010101,191,10111111
57,00111001,13,00001101,70,01000110
63,00111111,99,01100011,162,10100010
62,00111110,120,01111000,182,10110110
99,01100011,32,00100000,131,10000011
114,01110010,123,01111011,237,11101101
87,01010111,52,00110100,139,10001011
86,01010110,28,00011100,114,01110010
127,01111111,12,00001100,139,10001011
10,00001010,39,00100111,49,00110001
19,00010011,75,01001011,94,01011110
107,01101011,97,01100001,204,11001100
113,01110001,21,00010101,134,10000110
28,00011100,22,00010110,50,00110010
31,00011111,6,00000110,37,00100101
5,00000101,26,00011010,31,00011111
57,00111001,93,01011101,150,10010110
19,00010011,85,01010101,104,01101000
43,00101011,13,00001101,56,00111000
116,01110100,95,01011111,211,11010011
14,00001110,11,00001011,25,00011001
119,01110111,110,01101110,229,11100101
72,01001000,37,00100101,109,01101101
113,01110001,105,01101001,218,11011010
84,01010100,17,00010001,101,01100101
18,00010010,52,00110100,70,01000110
97,01100001,16,00010000,113,01110001
47,00101111,104,01101000,151,10010111
123,01111011,92,01011100,215,11010111
83,01010011,119,01110111,202,11001010
95,01011111,113,01110001,208,11010000
30,00011110,65,01000001,95,01011111
18,00010010,48,00110000,66,01000010
55,00110111,60,00111100,115,01110011
35,00100011,113,01110001,148,10010100
126,01111110,24,00011000,150,10010110
81,01010001,87,01010111,168,10101000
71,01000111,119,01110111,190,10111110
78,01001110,12,00001100,90,01011010
73,01001001,20,00010100,93,01011101
108,01101100,48,00110000,156,10011100
6,00000110,80,01010000,86,01010110
116,01110100,110,01101110,226,11100010
19,00010011,97,01100001,116,01110100
15,00001111,17,00010001,32,00100000
115,01110011,109,01101101,224,11100000
113,01110001,104,01101000,217,11011001
98,01100010,93,01011101,191,10111111
62,00111110,58,00111010,120,01111000
120,01111000,87,01010111,207,11001111
99,01100011,12,00001100,111,01101111
50,00110010,7,00000111,57,00111001
23,00010111,20,00010100,43,00101011
67,01000011,56,00111000,123,01111011
38,00100110,111,01101111,149,10010101
5,00000101,127,01111111,132,10000100
112,01110000,45,00101101,157,10011101
40,00101000,0,00000000,40,00101000
45,00101101,25,00011001,70,01000110
45,00101101,61,00111101,106,01101010
123,01111011,53,00110101,176,10110000
35,00100011,112,01110000,147,10010011
11,00001011,77,01001101,88,01011000
14,00001110,35,00100011,49,00110001
119,01110111,24,00011000,143,10001111
36,00100100,23,00010111,59,00111011
121,01111001,18,00010010,139,10001011
90,01011010,21,00010101,111,01101111
13,00001101,65,01000001,78,01001110
98,01100010,111,01101111,209,11010001
87,01010111,125,01111101,212,11010100
44,00101100,86,01010110,130,10000010
13,00001101,46,00101110,59,00111011
117,01110101,110,01101110,227,11100011
126,01111110,64,01000000,190,10111110
94,01011110,18,00010010,112,01110000
58,00111010,40,00101000,98,01100010
58,00111010,7,00000111,65,01000001
38,00100110,89,01011001,127,01111111
10,00001010,98,01100010,108,01101100
55,00110111,105,01101001,160,10100000
90,01011010,51,00110011,141,10001101
43,00101011,26,00011010,69,01000101
71,01000111,30,00011110,101,01100101
105,01101001,46,00101110,151,10010111
55,00110111,79,01001111,134,10000110
41,00101001,99,01100011,140,10001100
84,01010100,96,01100000,180,10110100
24,00011000,111,01101111,135,10000111
34,00100010,59,00111011,93,01011101
42,00101010,7,00000111,49,00110001
96,01100000,122,01111010,218,11011010
24,00011000,15,00001111,39,00100111
61,00111101,108,01101100,169,10101001
43,00101011,39,00100111,82,01010010
18,00010010,80,01010000,98,01100010
63,00111111,45,00101101,108,01101100
36,00100100,113,01110001,149,10010101
99,01100011,119,01110111,218,11011010
74,01001010,94,01011110,168,10101000
60,00111100,125,01111101,185,10111001
38,00100110,82,01010010,120,01111000
75,01001011,31,00011111,106,01101010
20,00010100,14,00001110,34,00100010
39,00100111,69,01000101,108,01101100
22,00010110,12,00001100,34,00100010
117,01110101,85,01010101,202,11001010
82,01010010,65,01000001,147,10010011
116,01110100,38,00100110,154,10011010
23,00010111,18,00010010,41,00101001
27,00011011,48,00110000,75,01001011
52,00110100,52,00110100,104,01101000
113,01110001,29,00011101,142,10001110
23,00010111,68,01000100,91,01011011
20,00010100,47,00101111,67,01000011
104,01101000,75,01001011,179,10110011
62,00111110,5,00000101,67,01000011
47,00101111,2,00000010,49,00110001
85,01010101,19,00010011,104,01101000
122,01111010,107,01101011,229,11100101
29,00011101,96,01100000,125,01111101
17,00010001,123,01111011,140,10001100
49,00110001,120,01111000,169,10101001
57,00111001,126,01111110,183,10110111
78,01001110,97,01100001,175,10101111
62,00111110,85,01010101,147,10010011
10,00001010,19,00010011,29,00011101
80,01010000,62,00111110,142,10001110
28,00011100,38,00100110,66,01000010
16,00010000,40,00101000,56,00111000
2,00000010,12,00001100,14,00001110
66,01000010,16,00010000,82,01010010
101,01100101,85,01010101,186,10111010
102,01100110,39,00100111,141,10001101
127,01111111,9,00001001,136,10001000
25,00011001,48,00110000,73,01001001
78,01001110,77,01001101,155,10011011
115,01110011,50,00110010,165,10100101
46,00101110,111,01101111,157,10011101
9,00001001,62,00111110,71,01000111
90,01011010,112,01110000,202,11001010
116,01110100,83,01010011,199,11000111
104,01101000,7,00000111,111,01101111
77,01001101,13,00001101,90,01011010
26,00011010,66,01000010,92,01011100
76,01001100,10,00001010,86,01010110
123,01111011,55,00110111,178,10110010
1,00000001,71,01000111,72,01001000
127,01111111,49,00110001,176,10110000
13,00001101,84,01010100,97,01100001
77,01001101,43,00101011,120,01111000
116,01110100,97,01100001,213,11010101
87,01010111,110,01101110,197,11000101
50,00110010,92,01011100,142,10001110
35,00100011,111,01101111,146,10010010
106,01101010,55,00110111,161,10100001
52,00110100,110,01101110,162,10100010
99,01100011,126,01111110,225,11100001
26,00011010,15,00001111,41,00101001
41,00101001,49,00110001,90,01011010
125,01111101,114,01110010,239,11101111
107,01101011,25,00011001,132,10000100
108,01101100,96,01100000,204,11001100
92,01011100,9,00001001,101,01100101
43,00101011,65,01000001,108,01101100
104,01101000,41,00101001,145,10010001
124,01111100,17,00010001,141,10001101
36,00100100,31,00011111,67,01000011
103,01100111,8,00001000,111,01101111
75,01001011,75,01001011,150,10010110
47,00101111,81,01010001,128,10000000
108,01101100,119,01110111,227,11100011
101,01100101,115,01110011,216,11011000
116,01110100,61,00111101,177,10110001
51,00110011,69,01000101,120,01111000
65,01000001,78,01001110,143,10001111
8,00001000,2,00000010,10,00001010
80,01010000,19,00010011,99,01100011
56,00111000,21,00010101,77,01001101
47,00101111,48,00110000,95,01011111
95,01011111,73,01001001,168,10101000
70,01000110,125,01111101,195,11000011
32,00100000,65,01000001,97,01100001
43,00101011,51,00110011,94,01011110
93,01011101,28,00011100,121,01111001
94,01011110,70,01000110,164,10100100
97,01100001,102,01100110,199,11000111
64,01000000,57,00111001,121,01111001
53,00110101,20,00010100,73,01001001
109,01101101,61,00111101,170,10101010
122,01111010,97,01100001,219,11011011
65,01000001,102,01100110,167,10100111
82,01010010,79,01001111,161,10100001
57,00111001,18,00010010,75,01001011
33,00100001,66,01000010,99,01100011
102,01100110,1,00000001,103,01100111
106,01101010,91,01011011,197,11000101
79,01001111,4,00000100,83,01010011
35,00100011,75,01001011,110,01101110
3,00000011,11,00001011,14,00001110
114,01110010,91,01011011,205,11001101
108,01101100,94,01011110,202,11001010
53,00110101,41,00101001,94,01011110
114,01110010,30,00011110,144,10010000
111,01101111,110,01101110,221,11011101
14,00001110,101,01100101,115,01110011
14,00001110,48,00110000,62,00111110
7,00000111,90,01011010,97,01100001
81,01010001,96,01100000,177,10110001
92,01011100,106,01101010,198,11000110
102,01100110,54,00110110,156,10011100
95,01011111,97,01100001,192,11000000
66,01000010,12,00001100,78,01001110
54,00110110,44,00101100,98,01100010
46,00101110,68,01000100,114,01110010
108,01101100,27,00011011,135,10000111
82,01010010,86,01010110,168,10101000
126,01111110,31,00011111,157,10011101
44,00101100,92,01011100,136,10001000
0,00000000,10,00001010,10,00001010
73,01001001,22,00010110,95,01011111
100,01100100,57,00111001,157,10011101
6,00000110,80,01010000,86,01010110
52,00110100,122,01111010,174,10101110
114,01110010,108,01101100,222,11011110
124,01111100,82,01010010,206,11001110
36,00100100,71,01000111,107,01101011
124,01111100,76,01001100,200,11001000
43,00101011,101,01100101,144,10010000
2,00000010,5,00000101,7,00000111
118,01110110,40,00101000,158,10011110
97,01100001,49,00110001,146,10010010
11,00001011,63,00111111,74,01001010
125,01111101,124,01111100,249,11111001
10,00001010,10,00001010,20,00010100
40,00101000,35,00100011,75,01001011
116,01110100,113,01110001,229,11100101
12,00001100,41,00101001,53,00110101
126,01111110,55,00110111,181,10110101
35,00100011,119,01110111,154,10011010
75,01001011,91,01011011,166,10100110
16,00010000,0,00000000,16,00010000
28,00011100,112,01110000,140,10001100
48,00110000,111,01101111,159,10011111
122,01111010,76,01001100,198,11000110
117,01110101,125,01111101,242,11110010
101,01100101,23,00010111,124,01111100
38,00100110,34,00100010,72,01001000
1,00000001,118,01110110,119,01110111
58,00111010,56,00111000,114,01110010
46,00101110,3,00000011,49,00110001
40,00101000,12,00001100,52,00110100
21,00010101,64,01000000,85,01010101
59,00111011,19,00010011,78,01001110
116,01110100,96,01100000,212,11010100
45,00101101,0,00000000,45,00101101
18,00010010,63,00111111,81,01010001
55,00110111,81,01010001,136,10001000
25,00011001,49,00110001,74,01001010
5,00000101,8,00001000,13,00001101
66,01000010,102,01100110,168,10101000
71,01000111,58,00111010,129,10000001
33,00100001,112,01110000,145,10010001
22,00010110,9,00001001,31,00011111
101,01100101,83,01010011,184,10111000
54,00110110,98,01100010,152,10011000
124,01111100,82,01010010,206,11001110
69,01000101,71,01000111,140,10001100
82,01010010,9,00001001,91,01011011
80,01010000,1,00000001,81,01010001
94,01011110,89,01011001,183,10110111
37,00100101,56,00111000,93,01011101
61,00111101,54,00110110,115,01110011
77,01001101,89,01011001,166,10100110
31,00011111,68,01000100,99,01100011
98,01100010,116,01110100,214,11010110
126,01111110,72,01001000,198,11000110
0,00000000,11,00001011,11,00001011
17,00010001,41,00101001,58,00111010
39,00100111,123,01111011,162,10100010
53,00110101,111,01101111,164,10100100
11,00001011,93,01011101,104,01101000
33,00100001,61,00111101,94,01011110
37,00100101,127,01111111,164,10100100
101,01100101,117,01110101,218,11011010
47,00101111,17,00010001,64,01000000
38,00100110,89,01011001,127,01111111
70,01000110,42,00101010,112,01110000
40,00101000,86,01010110,126,01111110
2,00000010,36,00100100,38,00100110
18,00010010,92,01011100,110,01101110
66,01000010,1,00000001,67,01000011
82,01010010,18,00010010,100,01100100
108,01101100,2,00000010,110,01101110
20,00010100,116,01110100,136,10001000
79,01001111,27,00011011,106,01101010
120,01111000,58,00111010,178,10110010
87,01010111,73,01001001,160,10100000
51,00110011,84,01010100,135,10000111
72,01001000,26,00011010,98,01100010
119,01110111,68,01000100,187,10111011
107,01101011,127,01111111,234,11101010
35,00100011,9,00001001,44,00101100
10,00001010,24,00011000,34,00100010
41,00101001,82,01010010,123,01111011
81,01010001,26,00011010,107,01101011
35,00100011,20,00010100,55,00110111
88,01011000,41,00101001,129,10000001
102,01100110,67,01000011,169,10101001
118,01110110,31,00011111,149,10010101
121,01111001,30,00011110,151,10010111
57,00111001,69,01000101,126,01111110
113,01110001,102,01100110,215,11010111
22,00010110,107,01101011,129,10000001
93,01011101,54,00110110,147,10010011
106,01101010,111,01101111,217,11011001
125,01111101,111,01101111,236,11101100
56,00111000,121,01111001,177,10110001
105,01101001,93,01011101,198,11000110
55,00110111,5,00000101,60,00111100
124,01111100,55,00110111,179,10110011
45,00101101,44,00101100,89,01011001
76,01001100,48,00110000,124,01111100
44,00101100,72,01001000,116,01110100
78,01001110,104,01101000,182,10110110
52,00110100,18,00010010,70,01000110
93,01011101,106,01101010,199,11000111
38,00100110,26,00011010,64,01000000
82,01010010,10,00001010,92,01011100
89,01011001,2,00000010,91,01011011
55,00110111,94,01011110,149,10010101
98,01100010,25,00011001,123,01111011
118,01110110,6,00000110,124,01111100
103,01100111,111,01101111,214,11010110
34,00100010,67,01000011,101,01100101
12,00001100,16,00010000,28,00011100
20,00010100,33,00100001,53,00110101
75,01001011,113,01110001,188,10111100
28,00011100,89,01011001,117,01110101
103,01100111,19,00010011,122,01111010
102,01100110,92,01011100,194,11000010
42,00101010,54,00110110,96,01100000
30,00011110,52,00110100,82,01010010
75,01001011,76,01001100,151,10010111
108,01101100,122,01111010,230,11100110
32,00100000,27,00011011,59,00111011
44,00101100,47,00101111,91,01011011
110,01101110,46,00101110,156,10011100
81,01010001,78,01001110,159,10011111
111,01101111,67,01000011,178,10110010
113,01110001,56,00111000,169,10101001
123,01111011,65,01000001,188,10111100
78,01001110,37,00100101,115,01110011
67,01000011,125,01111101,192,11000000
26,00011010,37,00100101,63,00111111
80,01010000,121,01111001,201,11001001
24,00011000,71,01000111,95,01011111
112,01110000,74,01001010,186,10111010
118,01110110,105,01101001,223,11011111
61,00111101,91,01011011,152,10011000
127,01111111,82,01010010,209,11010001
71,01000111,78,01001110,149,10010101
11,00001011,97,01100001,108,01101100
40,00101000,75,01001011,115,01110011
79,01001111,13,00001101,92,01011100
14,00001110,2,00000010,16,00010000
102,01100110,15,00001111,117,01110101
13,00001101,104,01101000,117,01110101
41,00101001,10,00001010,51,00110011
32,00100000,110,01101110,142,10001110
39,00100111,39,00100111,78,01001110
21,00010101,46,00101110,67,01000011
117,01110101,21,00010101,138,10001010
85,01010101,53,00110101,138,10001010
104,01101000,103,01100111,207,11001111
84,01010100,113,01110001,197,11000101
76,01001100,112,01110000,188,10111100
79,01001111,106,01101010,185,10111001
103,01100111,107,01101011,210,11010010
60,00111100,67,01000011,127,01111111
76,01001100,5,00000101,81,01010001
42,00101010,38,00100110,80,01010000
111,01101111,24,00011000,135,10000111
127,01111111,99,01100011,226,11100010
31,00011111,83,01010011,114,01110010
115,01110011,91,01011011,206,11001110
16,00010000,75,01001011,91,01011011
104,01101000,125,01111101,229,11100101
127,01111111,24,00011000,151,10010111
112,01110000,108,01101100,220,11011100
107,01101011,83,01010011,190,10111110
46,00101110,20,00010100,66,01000010
40,00101000,5,00000101,45,00101101
10,00001010,115,01110011,125,01111101
22,00010110,30,00011110,52,00110100
99,01100011,39,00100111,138,10001010
42,00101010,81,01010001,123,01111011
3,00000011,48,00110000,51,00110011
37,00100101,35,00100011,72,01001000
66,01000010,112,01110000,178,10110010
4,00000100,56,00111000,60,00111100
100,01100100,20,00010100,120,01111000
49,00110001,61,00111101,110,01101110
20,00010100,93,01011101,113,01110001
120,01111000,79,01001111,199,11000111
44,00101100,82,01010010,126,01111110
44,00101100,36,00100100,80,01010000
65,01000001,99,01100011,164,10100100
12,00001100,64,01000000,76,01001100
9,00001001,14,00001110,23,00010111
62,00111110,98,01100010,160,10100000
78,01001110,47,00101111,125,01111101
118,01110110,59,00111011,177,10110001
8,00001000,53,00110101,61,00111101
5,00000101,42,00101010,47,00101111
33,00100001,5,00000101,38,00100110
106,01101010,35,00100011,141,10001101
7,00000111,36,00100100,43,00101011
59,00111011,19,00010011,78,01001110
98,01100010,79,01001111,177,10110001
29,00011101,48,00110000,77,01001101
87,01010111,119,01110111,206,11001110
51,00110011,93,01011101,144,10010000
90,01011010,71,01000111,161,10100001
86,01010110,50,00110010,136,10001000
85,01010101,101,01100101,186,10111010
5,00000101,29,00011101,34,00100010
28,00011100,86,01010110,114,01110010
1,00000001,125,01111101,126,01111110
68,01000100,119,01110111,187,10111011
50,00110010,86,01010110,136,10001000
68,01000100,110,01101110,178,10110010
12,00001100,75,01001011,87,01010111
39,00100111,94,01011110,133,10000101
108,01101100,23,00010111,131,10000011
14,00001110,114,01110010,128,10000000
29,00011101,62,00111110,91,01011011
46,00101110,91,01011011,137,10001001
59,00111011,9,00001001,68,01000100
94,01011110,71,01000111,165,10100101
108,01101100,77,01001101,185,10111001
120,01111000,30,00011110,150,10010110
17,00010001,67,01000011,84,01010100
78,01001110,62,00111110,140,10001100
110,01101110,88,01011000,198,11000110
16,00010000,113,01110001,129,10000001
31,00011111,0,00000000,31,00011111
36,00100100,121,01111001,157,10011101
37,00100101,6,00000110,43,00101011
115,01110011,10,00001010,125,01111101
68,01000100,125,01111101,193,11000001
93,01011101,107,01101011,200,11001000
125,01111101,49,00110001,174,10101110
108,01101100,87,01010111,195,11000011
0,00000000,56,00111000,56,00111000
92,01011100,92,01011100,184,10111000
105,01101001,10,00001010,115,01110011
55,00110111,117,01110101,172,10101100
120,01111000,2,00000010,122,01111010
28,00011100,108,01101100,136,10001000
84,01010100,97,01100001,181,10110101
69,01000101,11,00001011,80,01010000
60,00111100,17,00010001,77,01001101
63,00111111,122,01111010,185,10111001
51,00110011,75,01001011,126,01111110
50,00110010,87,01010111,137,10001001
82,01010010,101,01100101,183,10110111
15,00001111,40,00101000,55,00110111
124,01111100,5,00000101,129,10000001
100,01100100,98,01100010,198,11000110
18,00010010,61,00111101,79,01001111
54,00110110,68,01000100,122,01111010
20,00010100,2,00000010,22,00010110
109,01101101,19,00010011,128,10000000
2,00000010,108,01101100,110,01101110
113,01110001,47,00101111,160,10100000
121,01111001,94,01011110,215,11010111
97,01100001,63,00111111,160,10100000
9,00001001,11,00001011,20,00010100
6,00000110,51,00110011,57,00111001
78,01001110,18,00010010,96,01100000
69,01000101,92,01011100,161,10100001
124,01111100,60,00111100,184,10111000
96,01100000,111,01101111,207,11001111
2,00000010,108,01101100,110,01101110
37,00100101,35,00100011,72,01001000
67,01000011,74,01001010,141,10001101
91,01011011,93,01011101,184,10111000
67,01000011,63,00111111,130,10000010
93,01011101,68,01000100,161,10100001
33,00100001,121,01111001,154,10011010
92,01011100,71,01000111,163,10100011
64,01000000,105,01101001,169,10101001
43,00101011,11,00001011,54,00110110
113,01110001,51,00110011,164,10100100
11,00001011,86,01010110,97,01100001
56,00111000,36,00100100,92,01011100
11,00001011,83,01010011,94,01011110
14,00001110,100,01100100,114,01110010
23,00010111,110,01101110,133,10000101
101,01100101,82,01010010,183,10110111
30,00011110,98,01100010,128,10000000
127,01111111,1,00000001,128,10000000
37,00100101,79,01001111,116,01110100
42,00101010,102,01100110,144,10010000
114,01110010,43,00101011,157,10011101
57,00111001,32,00100000,89,01011001
109,01101101,31,00011111,140,10001100
83,01010011,79,01001111,162,10100010
106,01101010,9,00001001,115,01110011
7,00000111,125,01111101,132,10000100
40,00101000,91,01011011,131,10000011
3,00000011,60,00111100,63,00111111
91,01011011,19,00010011,110,01101110
117,01110101,23,00010111,140,10001100
41,00101001,107,01101011,148,10010100
51,00110011,67,01000011,118,01110110
13,00001101,4,00000100,17,00010001
17,00010001,8,00001000,25,00011001
58,00111010,125,01111101,183,10110111
22,00010110,4,00000100,26,00011010
68,01000100,36,00100100,104,01101000
49,00110001,63,00111111,112,01110000
87,01010111,121,01111001,208,11010000
85,01010101,124,01111100,209,11010001
25,00011001,27,00011011,52,00110100
37,00100101,73,01001001,110,01101110
108,01101100,54,00110110,162,10100010
57,00111001,43,00101011,100,01100100
0,00000000,26,00011010,26,00011010
71,01000111,107,01101011,178,10110010
20,00010100,0,00000000,20,00010100
26,00011010,83,01010011,109,01101101
20,00010100,5,00000101,25,00011001
99,01100011,69,01000101,168,10101000
108,01101100,98,01100010,206,11001110
102,01100110,20,00010100,122,01111010
21,00010101,92,01011100,113,01110001
20,00010100,45,00101101,65,01000001
120,01111000,44,00101100,164,10100100
109,01101101,4,00000100,113,01110001
93,01011101,64,01000000,157,10011101
54,00110110,126,01111110,180,10110100
36,00100100,71,01000111,107,01101011
24,00011000,98,01100010,122,01111010
81,01010001,33,00100001,114,01110010
67,01000011,64,01000000,131,10000011
116,01110100,40,00101000,156,10011100
78,01001110,6,00000110,84,01010100
22,00010110,69,01000101,91,01011011
68,01000100,115,01110011,183,10110111
30,00011110,83,01010011,113,01110001
103,01100111,15,00001111,118,01110110
125,01111101,58,00111010,183,10110111
89,01011001,97,01100001,186,10111010
111,01101111,21,00010101,132,10000100
43,00101011,62,00111110,105,01101001
78,01001110,50,00110010,128,10000000
109,01101101,65,01000001,174,10101110
104,01101000,114,01110010,218,11011010
64,01000000,59,00111011,123,01111011
12,00001100,53,00110101,65,01000001
104,01101000,68,01000100,172,10101100
48,00110000,122,01111010,170,10101010
70,01000110,121,01111001,191,10111111
44,00101100,77,01001101,121,01111001
120,01111000,121,01111001,241,11110001
55,00110111,95,01011111,150,10010110
30,00011110,105,01101001,135,10000111
71,01000111,100,01100100,171,10101011
59,00111011,22,00010110,81,01010001
18,00010010,111,01101111,129,10000001
73,01001001,100,01100100,173,10101101
27,00011011,18,00010010,45,00101101
99,01100011,22,00010110,121,01111001
82,01010010,44,00101100,126,01111110
49,00110001,106,01101010,155,10011011
102,01100110,5,00000101,107,01101011
51,00110011,48,00110000,99,01100011
114,01110010,27,00011011,141,10001101
2,00000010,78,01001110,80,01010000
48,00110000,89,01011001,137,10001001
65,01000001,31,00011111,96,01100000
99,01100011,118,01110110,217,11011001
21,00010101,96,01100000,117,01110101
71,01000111,46,00101110,117,01110101
57,00111001,74,01001010,131,10000011
9,00001001,48,00110000,57,00111001
54,00110110,27,00011011,81,01010001
123,01111011,32,00100000,155,10011011
14,00001110,97,01100001,111,01101111
7,00000111,101,01100101,108,01101100
126,01111110,37,00100101,163,10100011
15,00001111,99,01100011,114,01110010
82,01010010,77,01001101,159,10011111
98,01100010,15,00001111,113,01110001
108,01101100,87,01010111,195,11000011
31,00011111,42,00101010,73,01001001
51,00110011,126,01111110,177,10110001
15,00001111,58,00111010,73,01001001
38,00100110,35,00100011,73,01001001
10,00001010,41,00101001,51,00110011
87,01010111,67,01000011,154,10011010
122,01111010,45,00101101,167,10100111
99,01100011,122,01111010,221,11011101
41,00101001,114,01110010,155,10011011
2,00000010,60,00111100,62,00111110
18,00010010,101,01100101,119,01110111
99,01100011,77,01001101,176,10110000
27,00011011,127,01111111,154,10011010
64,01000000,23,00010111,87,01010111
22,00010110,79,01001111,101,01100101
22,00010110,61,00111101,83,01010011
124,01111100,107,01101011,231,11100111
13,00001101,82,01010010,95,01011111
107,01101011,24,00011000,131,10000011
96,01100000,37,00100101,133,10000101
93,01011101,92,01011100,185,10111001
89,01011001,69,01000101,158,10011110
39,00100111,60,00111100,99,01100011
62,00111110,101,01100101,163,10100011
107,01101011,47,00101111,154,10011010
123,01111011,80,01010000,203,11001011
35,00100011,105,01101001,140,10001100
92,01011100,7,00000111,99,01100011
2,00000010,88,01011000,90,01011010
95,01011111,9,00001001,104,01101000
123,01111011,43,00101011,166,10100110
122,01111010,49,00110001,171,10101011
40,00101000,56,00111000,96,01100000
85,01010101,52,00110100,137,10001001
66,01000010,93,01011101,159,10011111
20,00010100,51,00110011,71,01000111
110,01101110,62,00111110,172,10101100
98,01100010,78,01001110,176,10110000
44,00101100,4,00000100,48,00110000
28,00011100,99,01100011,127,01111111
34,00100010,119,01110111,153,10011001
51,00110011,68,01000100,119,01110111
21,00010101,33,00100001,54,00110110
79,01001111,81,01010001,160,10100000
34,00100010,34,00100010,68,01000100
118,01110110,100,01100100,218,11011010
86,01010110,76,01001100,162,10100010
90,01011010,112,01110000,202,11001010
32,00100000,2,00000010,34,00100010
32,00100000,33,00100001,65,01000001
9,00001001,71,01000111,80,01010000
23,00010111,71,01000111,94,01011110
11,00001011,86,01010110,97,01100001
35,00100011,24,00011000,59,00111011
73,01001001,85,01010101,158,10011110
46,00101110,23,00010111,69,01000101
43,00101011,23,00010111,66,01000010
88,01011000,6,00000110,94,01011110
20,00010100,100,01100100,120,01111000
46,00101110,32,00100000,78,01001110
42,00101010,19,00010011,61,00111101
64,01000000,62,00111110,126,01111110
4,00000100,85,01010101,89,01011001
56,00111000,31,00011111,87,01010111
48,00110000,71,01000111,119,01110111
49,00110001,112,01110000,161,10100001
112,01110000,12,00001100,124,01111100
17,00010001,29,00011101,46,00101110
120,01111000,51,00110011,171,10101011
3,00000011,30,00011110,33,00100001
90,01011010,45,00101101,135,10000111
23,00010111,121,01111001,144,10010000
97,01100001,81,01010001,178,10110010
18,00010010,93,01011101,111,01101111
66,01000010,20,00010100,86,01010110
48,00110000,21,00010101,69,01000101
62,00111110,100,01100100,162,10100010
29,00011101,68,01000100,97,01100001
41,00101001,61,00111101,102,01100110
30,00011110,114,01110010,144,10010000
107,01101011,106,01101010,213,11010101
2,00000010,8,00001000,10,00001010
123,01111011,76,01001100,199,11000111
121,01111001,6,00000110,127,01111111
42,00101010,45,00101101,87,01010111
51,00110011,89,01011001,140,10001100
36,00100100,23,00010111,59,00111011
0,00000000,112,01110000,112,01110000
1,00000001,42,00101010,43,00101011
26,00011010,48,00110000,74,01001010
48,00110000,72,01001000,120,01111000
18,00010010,18,00010010,36,00100100
13,00001101,7,00000111,20,00010100
108,01101100,101,01100101,209,11010001
3,00000011,20,00010100,23,00010111
54,00110110,106,01101010,160,10100000
50,00110010,66,01000010,116,01110100
56,00111000,106,01101010,162,10100010
122,01111010,80,01010000,202,11001010
122,01111010,78,01001110,200,11001000
107,01101011,111,01101111,218,11011010
57,00111001,116,01110100,173,10101101
12,00001100,40,00101000,52,00110100
115,01110011,105,01101001,220,11011100
57,00111001,82,01010010,139,10001011
19,00010011,66,01000010,85,01010101
68,01000100,87,01010111,155,10011011
22,00010110,41,00101001,63,00111111
105,01101001,60,00111100,165,10100101
12,00001100,127,01111111,139,10001011
105,01101001,103,01100111,208,11010000
65,01000001,18,00010010,83,01010011
82,01010010,3,00000011,85,01010101
63,00111111,21,00010101,84,01010100
39,00100111,8,00001000,47,00101111
65,01000001,117,01110101,182,10110110
101,01100101,41,00101001,142,10001110
32,00100000,54,00110110,86,01010110
48,00110000,18,00010010,66,01000010
31,00011111,98,01100010,129,10000001
100,01100100,119,01110111,219,11011011
51,00110011,119,01110111,170,10101010
60,00111100,98,01100010,158,10011110
15,00001111,20,00010100,35,00100011
17,00010001,39,00100111,56,00111000
66,01000010,77,01001101,143,10001111
62,00111110,100,01100100,162,10100010
12,00001100,47,00101111,59,00111011
110,01101110,34,00100010,144,10010000
113,01110001,93,01011101,206,11001110
119,01110111,19,00010011,138,10001010
48,00110000,9,00001001,57,00111001
27,00011011,69,01000101,96,01100000
37,00100101,87,01010111,124,01111100
62,00111110,126,01111110,188,10111100
115,01110011,24,00011000,139,10001011
57,00111001,10,00001010,67,01000011
120,01111000,74,01001010,194,11000010
8,00001000,3,00000011,11,00001011
80,01010000,28,00011100,108,01101100
53,00110101,108,01101100,161,10100001
107,01101011,38,00100110,145,10010001
25,00011001,36,00100100,61,00111101
8,00001000,124,01111100,132,10000100
56,00111000,94,01011110,150,10010110
118,01110110,10,00001010,128,10000000
36,00100100,85,01010101,121,01111001
39,00100111,28,00011100,67,01000011
109,01101101,49,00110001,158,10011110
99,01100011,33,00100001,132,10000100
112,01110000,123,01111011,235,11101011
43,00101011,91,01011011,134,10000110
127,01111111,28,00011100,155,10011011
65,01000001,94,01011110,159,10011111
46,00101110,30,00011110,76,01001100
112,01110000,78,01001110,190,10111110
65,01000001,115,01110011,180,10110100
32,00100000,110,01101110,142,10001110
10,00001010,121,01111001,131,10000011
90,01011010,104,01101000,194,11000010
13,00001101,10,00001010,23,00010111
60,00111100,61,00111101,121,01111001
21,00010101,48,00110000,69,01000101
87,01010111,76,01001100,163,10100011
35,00100011,109,01101101,144,10010000
93,01011101,16,00010000,109,01101101
117,01110101,107,01101011,224,11100000
9,00001001,125,01111101,134,10000110
108,01101100,12,00001100,120,01111000
127,01111111,14,00001110,141,10001101
44,00101100,13,00001101,57,00111001
92,01011100,10,00001010,102,01100110
26,00011010,92,01011100,118,01110110
62,00111110,0,00000000,62,00111110
114,01110010,91,01011011,205,11001101
115,01110011,71,01000111,186,10111010
45,00101101,51,00110011,96,01100000
52,00110100,119,01110111,171,10101011
69,01000101,11,00001011,80,01010000
65,01000001,50,00110010,115,01110011
84,01010100,95,01011111,179,10110011
29,00011101,61,00111101,90,01011010
8,00001000,96,01100000,104,01101000
27,00011011,125,01111101,152,10011000
121,01111001,32,00100000,153,10011001
45,00101101,46,00101110,91,01011011
94,01011110,53,00110101,147,10010011
74,01001010,52,00110100,126,01111110
91,01011011,47,00101111,138,10001010
68,01000100,10,00001010,78,01001110
112,01110000,88,01011000,200,11001000
43,00101011,100,01100100,143,10001111
0,00000000,53,00110101,53,00110101
25,00011001,4,00000100,29,00011101
6,00000110,26,00011010,32,00100000
5,00000101,95,01011111,100,01100100
105,01101001,48,00110000,153,10011001
52,00110100,42,00101010,94,01011110
58,00111010,16,00010000,74,01001010
58,00111010,18,00010010,76,01001100
63,00111111,62,00111110,125,01111101
9,00001001,104,01101000,113,01110001
41,00101001,92,01011100,133,10000101
2,00000010,94,01011110,96,01100000
90,01011010,72,01001000,162,10100010
21,00010101,90,01011010,111,01101111
27,00011011,39,00100111,66,01000010
44,00101100,121,01111001,165,10100101
126,01111110,127,01111111,253,11111101
7,00000111,109,01101101,116,01110100
62,00111110,105,01101001,167,10100111
67,01000011,109,01101101,176,10110000
100,01100100,35,00100011,135,10000111
24,00011000,17,00010001,41,00101001
41,00101001,25,00011001,66,01000010
90,01011010,121,01111001,211,11010011
99,01100011,86,01010110,185,10111001
16,00010000,11,00001011,27,00011011
87,01010111,52,00110100,139,10001011
0,00000000,50,00110010,50,00110010
86,01010110,77,01001101,163,10100011
48,00110000,2,00000010,50,00110010
35,00100011,65,01000001,100,01100100
0,00000000,45,00101101,45,00101101
21,00010101,10,00001010,31,00011111
70,01000110,94,01011110,164,10100100
52,00110100,100,01100100,152,10011000
119,01110111,97,01100001,216,11011000
43,00101011,69,01000101,112,01110000
79,01001111,34,00100010,113,01110001
112,01110000,9,00001001,121,01111001
108,01101100,106,01101010,214,11010110
28,00011100,107,01101011,135,10000111
110,01101110,41,00101001,151,10010111
101,01100101,86,01010110,187,10111011
3,00000011,2,00000010,5,00000101
88,01011000,70,01000110,158,10011110
5,00000101,55,00110111,60,00111100
45,00101101,123,01111011,168,10101000
109,01101101,66,01000010,175,10101111
78,01001110,6,00000110,84,01010100
68,01000100,13,00001101,81,01010001
18,00010010,34,00100010,52,00110100
112,01110000,52,00110100,164,10100100
43,00101011,43,00101011,86,01010110
86,01010110,105,01101001,191,10111111
95,01011111,100,01100100,195,11000011
29,00011101,60,00111100,89,01011001
5,00000101,96,01100000,101,01100101
27,00011011,38,00100110,65,01000001
38,00100110,21,00010101,59,00111011
61,00111101,27,00011011,88,01011000
26,00011010,27,00011011,53,00110101
28,00011100,117,01110101,145,10010001
22,00010110,108,01101100,130,10000010
89,01011001,123,01111011,212,11010100
97,01100001,117,01110101,214,11010110
70,01000110,92,01011100,162,10100010
78,01001110,114,01110010,192,11000000
8,00001000,39,00100111,47,00101111
54,00110110,53,00110101,107,01101011
78,01001110,119,01110111,197,11000101
10,00001010,35,00100011,45,00101101
19,00010011,33,00100001,52,00110100
15,00001111,126,01111110,141,10001101
80,01010000,53,00110101,133,10000101
105,01101001,70,01000110,175,10101111
44,00101100,16,00010000,60,00111100
17,00010001,108,01101100,125,01111101
58,00111010,93,01011101,151,10010111
24,00011000,31,00011111,55,00110111
99,01100011,100,01100100,199,11000111
112,01110000,14,00001110,126,01111110
74,01001010,28,00011100,102,01100110
7,00000111,56,00111000,63,00111111
90,01011010,62,00111110,152,10011000
39,00100111,29,00011101,68,01000100
12,00001100,100,01100100,112,01110000
76,01001100,100,01100100,176,10110000
105,01101001,65,01000001,170,10101010
17,00010001,99,01100011,116,01110100
109,01101101,33,00100001,142,10001110
92,01011100,116,01110100,208,11010000
29,00011101,57,00111001,86,01010110
122,01111010,88,01011000,210,11010010
90,01011010,33,00100001,123,01111011
125,01111101,113,01110001,238,11101110
72,01001000,41,00101001,113,01110001
56,00111000,85,01010101,141,10001101
18,00010010,55,00110111,73,01001001
72,01001000,51,00110011,123,01111011
17,00010001,19,00010011,36,00100100
66,01000010,39,00100111,105,01101001
59,00111011,19,00010011,78,01001110
37,00100101,52,00110100,89,01011001
13,00001101,27,00011011,40,00101000
121,01111001,126,01111110,247,11110111
80,01010000,17,00010001,97,01100001
78,01001110,125,01111101,203,11001011
23,00010111,26,00011010,49,00110001
92,01011100,23,00010111,115,01110011
100,01100100,1,00000001,101,01100101
60,00111100,87,01010111,147,10010011
77,01001101,103,01100111,180,10110100
75,01001011,14,00001110,89,01011001
1,00000001,49,00110001,50,00110010
17,00010001,42,00101010,59,00111011
9,00001001,16,00010000,25,00011001
11,00001011,75,01001011,86,01010110
38,00100110,6,00000110,44,00101100
69,01000101,56,00111000,125,01111101
28,00011100,106,01101010,134,10000110
73,01001001,46,00101110,119,01110111
42,00101010,57,00111001,99,01100011
121,01111001,39,00100111,160,10100000
110,01101110,123,01111011,233,11101001
107,01101011,36,00100100,143,10001111
9,00001001,4,00000100,13,00001101
87,01010111,103,01100111,190,10111110
109,01101101,96,01100000,205,11001101
117,01110101,13,00001101,130,10000010
111,01101111,32,00100000,143,10001111
67,01000011,113,01110001,180,10110100
47,00101111,93,01011101,140,10001100
81,01010001,24,00011000,105,01101001
72,01001000,4,00000100,76,01001100
7,00000111,94,01011110,101,01100101
19,00010011,75,01001011,94,01011110
4,00000100,67,01000011,71,01000111
53,00110101,105,01101001,158,10011110
66,01000010,9,00001001,75,01001011
81,01010001,28,00011100,109,01101101
111,01101111,96,01100000,207,11001111
94,01011110,35,00100011,129,10000001
68,01000100,20,00010100,88,01011000
125,01111101,47,00101111,172,10101100
100,01100100,94,01011110,194,11000010
106,01101010,29,00011101,135,10000111
36,00100100,59,00111011,95,01011111
36,00100100,88,01011000,124,01111100
9,00001001,78,01001110,87,01010111
51,00110011,4,00000100,55,00110111
79,01001111,120,01111000,199,11000111
9,00001001,95,01011111,104,01101000
53,00110101,111,01101111,164,10100100
91,01011011,19,00010011,110,01101110
37,00100101,107,01101011,144,10010000
83,01010011,17,00010001,100,01100100
10,00001010,105,01101001,115,01110011
59,00111011,14,00001110,73,01001001
60,00111100,48,00110000,108,01101100
127,01111111,27,00011011,154,10011010
82,01010010,5,00000101,87,01010111
45,00101101,4,00000100,49,00110001
40,00101000,98,01100010,138,10001010
69,01000101,9,00001001,78,01001110
33,00100001,84,01010100,117,01110101
40,00101000,87,01010111,127,01111111
43,00101011,52,00110100,95,01011111
79,01001111,7,00000111,86,01010110
117,01110101,45,00101101,162,10100010
38,00100110,48,00110000,86,01010110
24,00011000,87,01010111,111,01101111
69,01000101,125,01111101,194,11000010
76,01001100,84,01010100,160,10100000
126,01111110,12,00001100,138,10001010
92,01011100,35,00100011,127,01111111
85,01010101,5,00000101,90,01011010
38,00100110,52,00110100,90,01011010
81,01010001,55,00110111,136,10001000
124,01111100,116,01110100,240,11110000
65,01000001,51,00110011,116,01110100
12,00001100,8,00001000,20,00010100
67,01000011,61,00111101,128,10000000
36,00100100,13,00001101,49,00110001
87,01010111,71,01000111,158,10011110
39,00100111,53,00110101,92,01011100
94,01011110,36,00100100,130,10000010
46,00101110,72,01001000,118,01110110
74,01001010,5,00000101,79,01001111
39,00100111,2,00000010,41,00101001
19,00010011,57,00111001,76,01001100
3,00000011,122,01111010,125,01111101
55,00110111,88,01011000,143,10001111
74,01001010,86,01010110,160,10100000
1,00000001,19,00010011,20,00010100
28,00011100,123,01111011,151,10010111
114,01110010,29,00011101,143,10001111
97,01100001,22,00010110,119,01110111
7,00000111,8,00001000,15,00001111
110,01101110,112,01110000,222,11011110
41,00101001,93,01011101,134,10000110
83,01010011,22,00010110,105,01101001
105,01101001,72,01001000,177,10110001
49,00110001,71,01000111,120,01111000
64,01000000,28,00011100,92,01011100
69,01000101,19,00010011,88,01011000
113,01110001,7,00000111,120,01111000
60,00111100,59,00111011,119,01110111
38,00100110,104,01101000,142,10001110
89,01011001,5,00000101,94,01011110
35,00100011,88,01011000,123,01111011
118,01110110,10,00001010,128,10000000
60,00111100,107,01101011,167,10100111
73,01001001,36,00100100,109,01101101
58,00111010,21,00010101,79,01001111
16,00010000,45,00101101,61,00111101
115,01110011,100,01100100,215,11010111
80,01010000,106,01101010,186,10111010
6,00000110,53,00110101,59,00111011
41,00101001,25,00011001,66,01000010
116,01110100,34,00100010,150,10010110
67,01000011,123,01111011,190,10111110
22,00010110,93,01011101,115,01110011
52,00110100,24,00011000,76,01001100
49,00110001,33,00100001,82,01010010
99,01100011,88,01011000,187,10111011
38,00100110,75,01001011,113,01110001
62,00111110,106,01101010,168,10101000
35,00100011,88,01011000,123,01111011
57,00111001,113,01110001,170,10101010
7,00000111,100,01100100,107,01101011
11,00001011,0,00000000,11,00001011
36,00100100,5,00000101,41,00101001
9,00001001,121,01111001,130,10000010
69,01000101,42,00101010,111,01101111
14,00001110,86,01010110,100,01100100
38,00100110,33,00100001,71,01000111
35,00100011,8,00001000,43,00101011
95,01011111,2,00000010,97,01100001
55,00110111,36,00100100,91,01011011
60,00111100,20,00010100,80,01010000
19,00010011,109,01101101,128,10000000
30,00011110,73,01001001,103,01100111
20,00010100,33,00100001,53,00110101
103,01100111,98,01100010,201,11001001
90,01011010,82,01010010,172,10101100
100,01100100,50,00110010,150,10010110
35,00100011,62,00111110,97,01100001
105,01101001,74,01001010,179,10110011
75,01001011,69,01000101,144,10010000
58,00111010,120,01111000,178,10110010
92,01011100,100,01100100,192,11000000
75,01001011,102,01100110,177,10110001
54,00110110,80,01010000,134,10000110
35,00100011,84,01010100,119,01110111
98,01100010,76,01001100,174,10101110
3,00000011,61,00111101,64,01000000
125,01111101,38,00100110,163,10100011
105,01101001,124,01111100,229,11100101
71,01000111,111,01101111,182,10110110
11,00001011,85,01010101,96,01100000
117,01110101,85,01010101,202,11001010
78,01001110,11,00001011,89,01011001
1,00000001,12,00001100,13,00001101
42,00101010,23,00010111,65,01000001
69,01000101,48,00110000,117,01110101
111,01101111,37,00100101,148,10010100
12,00001100,51,00110011,63,00111111
82,01010010,24,00011000,106,01101010
20,00010100,16,00010000,36,00100100
15,00001111,14,00001110,29,00011101
101,01100101,36,00100100,137,10001001
124,01111100,87,01010111,211,11010011
35,00100011,20,00010100,55,00110111
54,00110110,106,01101010,160,10100000
127,01111111,119,01110111,246,11110110
10,00001010,71,01000111,81,01010001
61,00111101,116,01110100,177,10110001
39,00100111,21,00010101,60,00111100
65,01000001,116,01110100,181,10110101
10,00001010,93,01011101,103,01100111
27,00011011,52,00110100,79,01001111
99,01100011,109,01101101,208,11010000
32,00100000,7,00000111,39,00100111
38,00100110,121,01111001,159,10011111
46,00101110,54,00110110,100,01100100
22,00010110,104,01101000,126,01111110
20,00010100,68,01000100,88,01011000
126,01111110,86,01010110,212,11010100
100,01100100,32,00100000,132,10000100
64,01000000,83,01010011,147,10010011
16,00010000,43,00101011,59,00111011
73,01001001,67,01000011,140,10001100
80,01010000,113,01110001,193,11000001
118,01110110,79,01001111,197,11000101
81,01010001,76,01001100,157,10011101
34,00100010,43,00101011,77,01001101
56,00111000,24,00011000,80,01010000
64,01000000,48,00110000,112,01110000
32,00100000,8,00001000,40,00101000
99,01100011,15,00001111,114,01110010
112,01110000,34,00100010,146,10010010
122,01111010,101,01100101,223,11011111
119,01110111,24,00011000,143,10001111
84,01010100,44,00101100,128,10000000
87,01010111,47,00101111,134,10000110
82,01010010,5,00000101,87,01010111
116,01110100,53,00110101,169,10101001
66,01000010,108,01101100,174,10101110
112,01110000,52,00110100,164,10100100
21,00010101,100,01100100,121,01111001
91,01011011,75,01001011,166,10100110
76,01001100,111,01101111,187,10111011
119,01110111,121,01111001,240,11110000
62,00111110,104,01101000,166,10100110
46,00101110,13,00001101,59,00111011
26,00011010,43,00101011,69,01000101
97,01100001,41,00101001,138,10001010
12,00001100,38,00100110,50,00110010
18,00010010,41,00101001,59,00111011
27,00011011,5,00000101,32,00100000
60,00111100,10,00001010,70,01000110
95,01011111,65,01000001,160,10100000
26,00011010,21,00010101,47,00101111
23,00010111,53,00110101,76,01001100
85,01010101,127,01111111,212,11010100
79,01001111,48,00110000,127,01111111
36,00100100,1,00000001,37,00100101
55,00110111,86,01010110,141,10001101
71,01000111,61,00111101,132,10000100
46,00101110,113,01110001,159,10011111
73,01001001,72,01001000,145,10010001
12,00001100,60,00111100,72,01001000
91,01011011,3,00000011,94,01011110
21,00010101,77,01001101,98,01100010
53,00110101,38,00100110,91,01011011
100,01100100,58,00111010,158,10011110
52,00110100,99,01100011,151,10010111
65,01000001,107,01101011,172,10101100
52,00110100,80,01010000,132,10000100
74,01001010,13,00001101,87,01010111
8,00001000,114,01110010,122,01111010
69,01000101,104,01101000,173,10101101
54,00110110,83,01010011,137,10001001
113,01110001,111,01101111,224,11100000
123,01111011,50,00110010,173,10101101
34,00100010,95,01011111,129,10000001
38,00100110,82,01010010,120,01111000
70,01000110,107,01101011,177,10110001
14,00001110,31,00011111,45,00101101
118,01110110,112,01110000,230,11100110
44,00101100,32,00100000,76,01001100
31,00011111,81,01010001,112,01110000
64,01000000,123,01111011,187,10111011
20,00010100,10,00001010,30,00011110
82,01010010,35,00100011,117,01110101
95,01011111,54,00110110,149,10010101
116,01110100,29,00011101,145,10010001
96,01100000,44,00101100,140,10001100
14,00001110,80,01010000,94,01011110
32,00100000,92,01011100,124,01111100
54,00110110,113,01110001,167,10100111
78,01001110,39,00100111,117,01110101
116,01110100,51,00110011,167,10100111
57,00111001,24,00011000,81,01010001
111,01101111,16,00010000,127,01111111
117,01110101,106,01101010,223,11011111
21,00010101,109,01101101,130,10000010
11,00001011,37,00100101,48,00110000
34,00100010,33,00100001,67,01000011
22,00010110,102,01100110,124,01111100
16,00010000,117,01110101,133,10000101
36,00100100,64,01000000,100,01100100
26,00011010,77,01001101,103,01100111
89,01011001,126,01111110,215,11010111
78,01001110,31,00011111,109,01101101
32,00100000,25,00011001,57,00111001
112,01110000,116,01110100,228,11100100
7,00000111,63,00111111,70,01000110
76,01001100,16,00010000,92,01011100
40,00101000,5,00000101,45,00101101
115,01110011,41,00101001,156,10011100
45,00101101,85,01010101,130,10000010
26,00011010,73,01001001,99,01100011
125,01111101,54,00110110,179,10110011
72,01001000,69,01000101,141,10001101
92,01011100,18,00010010,110,01101110
28,00011100,36,00100100,64,01000000
43,00101011,90,01011010,133,10000101
4,00000100,101,01100101,105,01101001
68,01000100,71,01000111,139,10001011
56,00111000,116,01110100,172,10101100
66,01000010,10,00001010,76,01001100
105,01101001,103,01100111,208,11010000
93,01011101,58,00111010,151,10010111
8,00001000,110,01101110,118,01110110
25,00011001,38,00100110,63,00111111
16,00010000,15,00001111,31,00011111
42,00101010,3,00000011,45,00101101
54,00110110,20,00010100,74,01001010
30,00011110,90,01011010,120,01111000
106,01101010,51,00110011,157,10011101
18,00010010,71,01000111,89,01011001
28,00011100,103,01100111,131,10000011
116,01110100,83,01010011,199,11000111
118,01110110,30,00011110,148,10010100
115,01110011,65,01000001,180,10110100
85,01010101,98,01100010,183,10110111
69,01000101,68,01000100,137,10001001
34,00100010,54,00110110,88,01011000
90,01011010,108,01101100,198,11000110
105,01101001,49,00110001,154,10011010
23,00010111,103,01100111,126,01111110
5,00000101,30,00011110,35,00100011
110,01101110,24,00011000,134,10000110
33,00100001,105,01101001,138,10001010
28,00011100,8,00001000,36,00100100
115,01110011,59,00111011,174,10101110
96,01100000,110,01101110,206,11001110
89,01011001,8,00001000,97,01100001
9,00001001,26,00011010,35,00100011
70,01000110,108,01101100,178,10110010
115,01110011,118,01110110,233,11101001
87,01010111,42,00101010,129,10000001
31,00011111,28,00011100,59,00111011
79,01001111,68,01000100,147,10010011
95,01011111,120,01111000,215,11010111
85,01010101,77,01001101,162,10100010
24,00011000,62,00111110,86,01010110
60,00111100,96,01100000,156,10011100
88,01011000,68,01000100,156,10011100
26,00011010,100,01100100,126,01111110
53,00110101,121,01111001,174,10101110
117,01110101,19,00010011,136,10001000
66,01000010,112,01110000,178,10110010
85,01010101,69,01000101,154,10011010
30,00011110,4,00000100,34,00100010
26,00011010,94,01011110,120,01111000
15,00001111,11,00001011,26,00011010
89,01011001,38,00100110,127,01111111
53,00110101,110,01101110,163,10100011
106,01101010,122,01111010,228,11100100
73,01001001,24,00011000,97,01100001
89,01011001,54,00110110,143,10001111
67,01000011,105,01101001,172,10101100
54,00110110,90,01011010,144,10010000
34,00100010,23,00010111,57,00111001
95,01011111,66,01000010,161,10100001
72,01001000,75,01001011,147,10010011
109,01101101,98,01100010,207,11001111
99,01100011,73,01001001,172,10101100
57,00111001,58,00111010,115,01110011
77,01001101,41,00101001,118,01110110
103,01100111,63,00111111,166,10100110
107,01101011,14,00001110,121,01111001
7,00000111,79,01001111,86,01010110
35,00100011,54,00110110,89,01011001
29,00011101,123,01111011,152,10011000
45,00101101,66,01000010,111,01101111
56,00111000,18,00010010,74,01001010
105,01101001,96,01100000,201,11001001
75,01001011,32,00100000,107,01101011
61,00111101,52,00110100,113,01110001
6,00000110,114,01110010,120,01111000
105,01101001,9,00001001,114,01110010
106,01101010,102,01100110,208,11010000
44,00101100,11,00001011,55,00110111
100,01100100,110,01101110,210,11010010
41,00101001,96,01100000,137,10001001
85,01010101,83,01010011,168,10101000
26,00011010,108,01101100,134,10000110
89,01011001,113,01110001,202,11001010
104,01101000,63,00111111,167,10100111
39,00100111,41,00101001,80,01010000
62,00111110,32,00100000,94,01011110
126,01111110,57,00111001,183,10110111
5,00000101,90,01011010,95,01011111
25,00011001,32,00100000,57,00111001
108,01101100,81,01010001,189,10111101
4,00000100,69,01000101,73,01001001
100,01100100,51,00110011,151,10010111
17,00010001,50,00110010,67,01000011
127,01111111,115,01110011,242,11110010
12,00001100,12,00001100,24,00011000
1,00000001,50,00110010,51,00110011
101,01100101,56,00111000,157,10011101
114,01110010,0,00000000,114,01110010
87,01010111,6,00000110,93,01011101
10,00001010,111,01101111,121,01111001
73,01001001,48,00110000,121,01111001
85,01010101,120,01111000,205,11001101
91,01011011,55,00110111,146,10010010
118,01110110,80,01010000,198,11000110
102,01100110,91,01011011,193,11000001
121,01111001,125,01111101,246,11110110
38,00100110,78,01001110,116,01110100
43,00101011,44,00101100,87,01010111
74,01001010,114,01110010,188,10111100
117,01110101,29,00011101,146,10010010
101,01100101,27,00011011,128,10000000
28,00011100,86,01010110,114,01110010
103,01100111,84,01010100,187,10111011
96,01100000,117,01110101,213,11010101
76,01001100,57,00111001,133,10000101
116,01110100,29,00011101,145,10010001
122,01111010,49,00110001,171,10101011
67,01000011,47,00101111,114,01110010
75,01001011,22,00010110,97,01100001
73,01001001,55,00110111,128,10000000
92,01011100,108,01101100,200,11001000
17,00010001,22,00010110,39,00100111
70,01000110,79,01001111,149,10010101
103,01100111,19,00010011,122,01111010
90,01011010,87,01010111,177,10110001
107,01101011,59,00111011,166,10100110
79,01001111,114,01110010,193,11000001
84,01010100,49,00110001,133,10000101
53,00110101,45,00101101,98,01100010
44,00101100,94,01011110,138,10001010
43,00101011,97,01100001,140,10001100
0,00000000,79,01001111,79,01001111
106,01101010,95,01011111,201,11001001
92,01011100,7,00000111,99,01100011
93,01011101,13,00001101,106,01101010
90,01011010,102,01100110,192,11000000
68,01000100,109,01101101,177,10110001
99,01100011,97,01100001,196,11000100
46,00101110,9,00001001,55,00110111
70,01000110,37,00100101,107,01101011
35,00100011,14,00001110,49,00110001
18,00010010,52,00110100,70,01000110
31,00011111,13,00001101,44,00101100
116,01110100,69,01000101,185,10111001
83,01010011,45,00101101,128,10000000
44,00101100,77,01001101,121,01111001
62,00111110,116,01110100,178,10110010
113,01110001,53,00110101,166,10100110
27,00011011,24,00011000,51,00110011
33,00100001,4,00000100,37,00100101
54,00110110,121,01111001,175,10101111
44,00101100,76,01001100,120,01111000
27,00011011,77,01001101,104,01101000
78,01001110,65,01000001,143,10001111
70,01000110,23,00010111,93,01011101
6,00000110,100,01100100,106,01101010
58,00111010,67,01000011,125,01111101
3,00000011,51,00110011,54,00110110
3,00000011,60,00111100,63,00111111
102,01100110,108,01101100,210,11010010
68,01000100,59,00111011,127,01111111
30,00011110,10,00001010,40,00101000
70,01000110,102,01100110,172,10101100
31,00011111,47,00101111,78,01001110
120,01111000,96,01100000,216,11011000
40,00101000,63,00111111,103,01100111
24,00011000,53,00110101,77,01001101
25,00011001,90,01011010,115,01110011
93,01011101,118,01110110,211,11010011
69,01000101,76,01001100,145,10010001
3,00000011,83,01010011,86,01010110
100,01100100,1,00000001,101,01100101
5,00000101,43,00101011,48,00110000
107,01101011,15,00001111,122,01111010
12,00001100,55,00110111,67,01000011
123,01111011,121,01111001,244,11110100
53,00110101,43,00101011,96,01100000
8,00001000,102,01100110,110,01101110
53,00110101,95,01011111,148,10010100
70,01000110,41,00101001,111,01101111
120,01111000,7,00000111,127,01111111
48,00110000,53,00110101,101,01100101
103,01100111,77,01001101,180,10110100
8,00001000,45,00101101,53,00110101
85,01010101,6,00000110,91,01011011
123,01111011,11,00001011,134,10000110
73,01001001,33,00100001,106,01101010
12,00001100,115,01110011,127,01111111
111,01101111,114,01110010,225,11100001
127,01111111,36,00100100,163,10100011
2,00000010,91,01011011,93,01011101
27,00011011,119,01110111,146,10010010
100,01100100,120,01111000,220,11011100
58,00111010,15,00001111,73,01001001
41,00101001,38,00100110,79,01001111
40,00101000,21,00010101,61,00111101
114,01110010,113,01110001,227,11100011
95,01011111,8,00001000,103,01100111
44,00101100,98,01100010,142,10001110
72,01001000,66,01000010,138,10001010
16,00010000,40,00101000,56,00111000
11,00001011,74,01001010,85,01010101
12,00001100,18,00010010,30,00011110
117,01110101,115,01110011,232,11101000
25,00011001,68,01000100,93,01011101
52,00110100,1,00000001,53,00110101
5,00000101,66,01000010,71,01000111
2,00000010,44,00101100,46,00101110
117,01110101,107,01101011,224,11100000
39,00100111,49,00110001,88,01011000
18,00010010,80,01010000,98,01100010
17,00010001,111,01101111,128,10000000
53,00110101,84,01010100,137,10001001
108,01101100,78,01001110,186,10111010
84,01010100,33,00100001,117,01110101
73,01001001,8,00001000,81,01010001
113,01110001,88,01011000,201,11001001
25,00011001,34,00100010,59,00111011
95,01011111,99,01100011,194,11000010
18,00010010,123,01111011,141,10001101
126,01111110,5,00000101,131,10000011
44,00101100,23,00010111,67,01000011
56,00111000,33,00100001,89,01011001
112,01110000,94,01011110,206,11001110
34,00100010,29,00011101,63,00111111
126,01111110,12,00001100,138,10001010
42,00101010,71,01000111,113,01110001
115,01110011,68,01000100,183,10110111
107,01101011,43,00101011,150,10010110
64,01000000,64,01000000,128,10000000
38,00100110,49,00110001,87,01010111
73,01001001,84,01010100,157,10011101
72,01001000,48,00110000,120,01111000
70,01000110,116,01110100,186,10111010
55,00110111,20,00010100,75,01001011
108,01101100,57,00111001,165,10100101
1,00000001,105,01101001,106,01101010
4,00000100,92,01011100,96,01100000
65,01000001,83,01010011,148,10010100
46,00101110,94,01011110,140,10001100
66,01000010,16,00010000,82,01010010
47,00101111,78,01001110,125,01111101
86,01010110,120,01111000,206,11001110
16,00010000,75,01001011,91,01011011
78,01001110,20,00010100,98,01100010
31,00011111,74,01001010,105,01101001
104,01101000,121,01111001,225,11100001
14,00001110,38,00100110,52,00110100
11,00001011,13,00001101,24,00011000
46,00101110,123,01111011,169,10101001
0,00000000,40,00101000,40,00101000
7,00000111,12,00001100,19,00010011
124,01111100,1,00000001,125,01111101
18,00010010,44,00101100,62,00111110
67,01000011,46,00101110,113,01110001
66,01000010,22,00010110,88,01011000
124,01111100,117,01110101,241,11110001
26,00011010,61,00111101,87,01010111
18,00010010,34,00100010,52,00110100
73,01001001,122,01111010,195,11000011
51,00110011,107,01101011,158,10011110
67,01000011,76,01001100,143,10001111
41,00101001,38,00100110,79,01001111
112,01110000,111,01101111,223,11011111
29,00011101,85,01010101,114,01110010
65,01000001,90,01011010,155,10011011
52,00110100,31,00011111,83,01010011
27,00011011,127,01111111,154,10011010
8,00001000,17,00010001,25,00011001
24,00011000,6,00000110,30,00011110
110,01101110,6,00000110,116,01110100
90,01011010,11,00001011,101,01100101
60,00111100,87,01010111,147,10010011
111,01101111,76,01001100,187,10111011
95,01011111,95,01011111,190,10111110
80,01010000,103,01100111,183,10110111
29,00011101,111,01101111,140,10001100
87,01010111,109,01101101,196,11000100
36,00100100,112,01110000,148,10010100
89,01011001,89,01011001,178,10110010
101,01100101,17,00010001,118,01110110
18,00010010,45,00101101,63,00111111
118,01110110,22,00010110,140,10001100
59,00111011,2,00000010,61,00111101
101,01100101,46,00101110,147,10010011
90,01011010,9,00001001,99,01100011
40,00101000,50,00110010,90,01011010
65,01000001,27,00011011,92,01011100
99,01100011,44,00101100,143,10001111
106,01101010,45,00101101,151,10010111
76,01001100,6,00000110,82,01010010
111,01101111,80,01010000,191,10111111
83,01010011,52,00110100,135,10000111
40,00101000,47,00101111,87,01010111
113,01110001,31,00011111,144,10010000
63,00111111,66,01000010,129,10000001
120,01111000,78,01001110,198,11000110
12,00001100,72,01001000,84,01010100
24,00011000,115,01110011,139,10001011
13,00001101,9,00001001,22,00010110
102,01100110,82,01010010,184,10111000
73,01001001,41,00101001,114,01110010
110,01101110,99,01100011,209,11010001
66,01000010,57,00111001,123,01111011
40,00101000,87,01010111,127,01111111
54,00110110,100,01100100,154,10011010
76,01001100,98,01100010,174,10101110
92,01011100,112,01110000,204,11001100
13,00001101,36,00100100,49,00110001
107,01101011,74,01001010,181,10110101
79,01001111,42,00101010,121,01111001
100,01100100,38,00100110,138,10001010
94,01011110,43,00101011,137,10001001
21,00010101,67,01000011,88,01011000
76,01001100,18,00010010,94,01011110
17,00010001,94,01011110,111,01101111
58,00111010,38,00100110,96,01100000
84,01010100,81,01010001,165,10100101
45,00101101,49,00110001,94,01011110
32,00100000,114,01110010,146,10010010
61,00111101,4,00000100,65,01000001
35,00100011,86,01010110,121,01111001
51,00110011,3,00000011,54,00110110
39,00100111,52,00110100,91,01011011
27,00011011,21,00010101,48,00110000
103,01100111,58,00111010,161,10100001
21,00010101,18,00010010,39,00100111
23,00010111,114,01110010,137,10001001
79,01001111,127,01111111,206,11001110
25,00011001,54,00110110,79,01001111
78,01001110,32,00100000,110,01101110
24,00011000,124,01111100,148,10010100
4,00000100,126,01111110,130,10000010
80,01010000,105,01101001,185,10111001
99,01100011,82,01010010,181,10110101
4,00000100,119,01110111,123,01111011
87,01010111,118,01110110,205,11001101
114,01110010,89,01011001,203,11001011
40,00101000,92,01011100,132,10000100
77,01001101,15,00001111,92,01011100
50,00110010,72,01001000,122,01111010
51,00110011,59,00111011,110,01101110
92,01011100,67,01000011,159,10011111
0,00000000,17,00010001,17,00010001
109,01101101,111,01101111,220,11011100
77,01001101,9,00001001,86,01010110
12,00001100,8,00001000,20,00010100
122,01111010,62,00111110,184,10111000
83,01010011,68,01000100,151,10010111
109,01101101,11,00001011,120,01111000
29,00011101,31,00011111,60,00111100
25,00011001,104,01101000,129,10000001
32,00100000,106,01101010,138,10001010
93,01011101,120,01111000,213,11010101
5,00000101,0,00000000,5,00000101
13,00001101,119,01110111,132,10000100
74,01001010,91,01011011,165,10100101
28,00011100,68,01000100,96,01100000
47,00101111,50,00110010,97,01100001
117,01110101,37,00100101,154,10011010
31,00011111,96,01100000,127,01111111
17,00010001,120,01111000,137,10001001
41,00101001,50,00110010,91,01011011
120,01111000,115,01110011,235,11101011
48,00110000,0,00000000,48,00110000
70,01000110,127,01111111,197,11000101
105,01101001,90,01011010,195,11000011
76,01001100,122,01111010,198,11000110
43,00101011,25,00011001,68,01000100
86,01010110,44,00101100,130,10000010
98,01100010,33,00100001,131,10000011
33,00100001,76,01001100,109,01101101
86,01010110,34,00100010,120,01111000
124,01111100,85,01010101,209,11010001
10,00001010,66,01000010,76,01001100
60,00111100,74,01001010,134,10000110
33,00100001,30,00011110,63,00111111
112,01110000,71,01000111,183,10110111
111,01101111,28,00011100,139,10001011
95,01011111,124,01111100,219,11011011
10,00001010,6,00000110,16,00010000
56,00111000,99,01100011,155,10011011
87,01010111,3,00000011,90,01011010
113,01110001,12,00001100,125,01111101
92,01011100,3,00000011,95,01011111
40,00101000,124,01111100,164,10100100
87,01010111,3,00000011,90,01011010
86,01010110,32,00100000,118,01110110
23,00010111,34,00100010,57,00111001
109,01101101,125,01111101,234,11101010
121,01111001,20,00010100,141,10001101
64,01000000,115,01110011,179,10110011
103,01100111,31,00011111,134,10000110
103,01100111,16,00010000,119,01110111
60,00111100,86,01010110,146,10010010
92,01011100,107,01101011,199,11000111
46,00101110,114,01110010,160,10100000
126,01111110,91,01011011,217,11011001
73,01001001,44,00101100,117,01110101
95,01011111,53,00110101,148,10010100
15,00001111,37,00100101,52,00110100
118,01110110,65,01000001,183,10110111
100,01100100,15,00001111,115,01110011
116,01110100,126,01111110,242,11110010
23,00010111,69,01000101,92,01011100
19,00010011,95,01011111,114,01110010
1,00000001,59,00111011,60,00111100
20,00010100,75,01001011,95,01011111
109,01101101,6,00000110,115,01110011
55,00110111,8,00001000,63,00111111
2,00000010,58,00111010,60,00111100
34,00100010,110,01101110,144,10010000
111,01101111,15,00001111,126,01111110
74,01001010,48,00110000,122,01111010
110,01101110,106,01101010,216,11011000
120,01111000,79,01001111,199,11000111
41,00101001,116,01110100,157,10011101
58,00111010,38,00100110,96,01100000
82,01010010,70,01000110,152,10011000
33,00100001,95,01011111,128,10000000
56,00111000,75,01001011,131,10000011
113,01110001,27,00011011,140,10001100
23,00010111,74,01001010,97,01100001
43,00101011,114,01110010,157,10011101
116,01110100,116,01110100,232,11101000
54,00110110,40,00101000,94,01011110
53,00110101,69,01000101,122,01111010
46,00101110,124,01111100,170,10101010
2,00000010,32,00100000,34,00100010
109,01101101,80,01010000,189,10111101
89,01011001,59,00111011,148,10010100
62,00111110,12,00001100,74,01001010
82,01010010,22,00010110,104,01101000
47,00101111,10,00001010,57,00111001
48,00110000,30,00011110,78,01001110
67,01000011,8,00001000,75,01001011
47,00101111,29,00011101,76,01001100
124,01111100,50,00110010,174,10101110
77,01001101,25,00011001,102,01100110
26,00011010,45,00101101,71,01000111
88,01011000,76,01001100,164,10100100
75,01001011,56,00111000,131,10000011
35,00100011,38,00100110,73,01001001
66,01000010,40,00101000,106,01101010
73,01001001,44,00101100,117,01110101
72,01001000,10,00001010,82,01010010
17,00010001,41,00101001,58,00111010
17,00010001,16,00010000,33,00100001
32,00100000,101,01100101,133,10000101
5,00000101,73,01001001,78,01001110
5,00000101,15,00001111,20,00010100
21,00010101,34,00100010,55,00110111
38,00100110,126,01111110,164,10100100
32,00100000,22,00010110,54,00110110
9,00001001,15,00001111,24,00011000
16,00010000,26,00011010,42,00101010
107,01101011,19,00010011,126,01111110
0,00000000,109,01101101,109,01101101
29,00011101,127,01111111,156,10011100
2,00000010,60,00111100,62,00111110
82,01010010,41,00101001,123,01111011
21,00010101,103,01100111,124,01111100
50,00110010,21,00010101,71,01000111
69,01000101,114,01110010,183,10110111
64,01000000,71,01000111,135,10000111
97,01100001,73,01001001,170,10101010
83,01010011,50,00110010,133,10000101
124,01111100,7,00000111,131,10000011
56,00111000,111,01101111,167,10100111
22,00010110,72,01001000,94,01011110
64,01000000,90,01011010,154,10011010
21,00010101,48,00110000,69,01000101
98,01100010,76,01001100,174,10101110
73,01001001,19,00010011,92,01011100
23,00010111,50,00110010,73,01001001
116,01110100,97,01100001,213,11010101
108,01101100,94,01011110,202,11001010
12,00001100,35,00100011,47,00101111
79,01001111,47,00101111,126,01111110
32,00100000,99,01100011,131,10000011
83,01010011,110,01101110,193,11000001
29,00011101,105,01101001,134,10000110
29,00011101,36,00100100,65,01000001
42,00101010,56,00111000,98,01100010
52,00110100,29,00011101,81,01010001
50,00110010,70,01000110,120,01111000
84,01010100,82,01010010,166,10100110
67,01000011,85,01010101,152,10011000
73,01001001,122,01111010,195,11000011
75,01001011,59,00111011,134,10000110
106,01101010,93,01011101,199,11000111
12,00001100,119,01110111,131,10000011
105,01101001,80,01010000,185,10111001
97,01100001,55,00110111,152,10011000
127,01111111,41,00101001,168,10101000
50,00110010,119,01110111,169,10101001
117,01110101,26,00011010,143,10001111
90,01011010,9,00001001,99,01100011
3,00000011,16,00010000,19,00010011
65,01000001,109,01101101,174,10101110
41,00101001,32,00100000,73,01001001
57,00111001,72,01001000,129,10000001
44,00101100,115,01110011,159,10011111
86,01010110,125,01111101,211,11010011
56,00111000,107,01101011,163,10100011
91,01011011,5,00000101,96,01100000
29,00011101,118,01110110,147,10010011
106,01101010,88,01011000,194,11000010
17,00010001,35,00100011,52,00110100
43,00101011,51,00110011,94,01011110
75,01001011,93,01011101,168,10101000
63,00111111,56,00111000,119,01110111
103,01100111,19,00010011,122,01111010
94,01011110,20,00010100,114,01110010
39,00100111,16,00010000,55,00110111
74,01001010,111,01101111,185,10111001
36,00100100,101,01100101,137,10001001
85,01010101,126,01111110,211,11010011
42,00101010,64,01000000,106,01101010
82,01010010,19,00010011,101,01100101
58,00111010,12,00001100,70,01000110
93,01011101,0,00000000,93,01011101
70,01000110,106,01101010,176,10110000
106,01101010,19,00010011,125,01111101
9,00001001,16,00010000,25,00011001
14,00001110,61,00111101,75,01001011
114,01110010,65,01000001,179,10110011
29,00011101,49,00110001,78,01001110
19,00010011,21,00010101,40,00101000
58,00111010,127,01111111,185,10111001
24,00011000,108,01101100,132,10000100
84,01010100,93,01011101,177,10110001
115,01110011,38,00100110,153,10011001
69,01000101,81,01010001,150,10010110
8,00001000,46,00101110,54,00110110
115,01110011,95,01011111,210,11010010
107,01101011,94,01011110,201,11001001
98,01100010,124,01111100,222,11011110
85,01010101,37,00100101,122,01111010
47,00101111,118,01110110,165,10100101
88,01011000,54,00110110,142,10001110
98,01100010,50,00110010,148,10010100
122,01111010,3,00000011,125,01111101
11,00001011,127,01111111,138,10001010
31,00011111,111,01101111,142,10001110
18,00010010,26,00011010,44,00101100
36,00100100,104,01101000,140,10001100
122,01111010,105,01101001,227,11100011
56,00111000,62,00111110,118,01110110
21,00010101,94,01011110,115,01110011
65,01000001,109,01101101,174,10101110
53,00110101,27,00011011,80,01010000
44,00101100,13,00001101,57,00111001
18,00010010,117,01110101,135,10000111
67,01000011,22,00010110,89,01011001
112,01110000,123,01111011,235,11101011
100,01100100,111,01101111,211,11010011
97,01100001,19,00010011,116,01110100
119,01110111,94,01011110,213,11010101
54,00110110,16,00010000,70,01000110
15,00001111,47,00101111,62,00111110
30,00011110,0,00000000,30,00011110
42,00101010,123,01111011,165,10100101
16,00010000,87,01010111,103,01100111
80,01010000,76,01001100,156,10011100
60,00111100,105,01101001,165,10100101
127,01111111,46,00101110,173,10101101
64,01000000,117,01110101,181,10110101
119,01110111,106,01101010,225,11100001
110,01101110,0,00000000,110,01101110
65,01000001,27,00011011,92,01011100
34,00100010,22,00010110,56,00111000
50,00110010,96,01100000,146,10010010
108,01101100,11,00001011,119,01110111
71,01000111,109,01101101,180,10110100
92,01011100,115,01110011,207,11001111
32,00100000,97,01100001,129,10000001
25,00011001,118,01110110,143,10001111
26,00011010,5,00000101,31,00011111
17,00010001,98,01100010,115,01110011
56,00111000,38,00100110,94,01011110
4,00000100,47,00101111,51,00110011
124,01111100,50,00110010,174,10101110
114,01110010,44,00101100,158,10011110
109,01101101,86,01010110,195,11000011
27,00011011,58,00111010,85,01010101
64,01000000,52,00110100,116,01110100
2,00000010,66,01000010,68,01000100
118,01110110,20,00010100,138,10001010
56,00111000,83,01010011,139,10001011
30,00011110,28,00011100,58,00111010
96,01100000,27,00011011,123,01111011
47,00101111,95,01011111,142,10001110
62,00111110,100,01100100,162,10100010
100,01100100,74,01001010,174,10101110
105,01101001,44,00101100,149,10010101
34,00100010,117,01110101,151,10010111
62,00111110,107,01101011,169,10101001
28,00011100,76,01001100,104,01101000
62,00111110,59,00111011,121,01111001
123,01111011,74,01001010,197,11000101
8,00001000,2,00000010,10,00001010
61,00111101,30,00011110,91,01011011
114,01110010,105,01101001,219,11011011
75,01001011,17,00010001,92,01011100
21,00010101,38,00100110,59,00111011
80,01010000,56,00111000,136,10001000
82,01010010,44,00101100,126,01111110
37,00100101,107,01101011,144,10010000
88,01011000,118,01110110,206,11001110
44,00101100,108,01101100,152,10011000
73,01001001,103,01100111,176,10110000
101,01100101,47,00101111,148,10010100
112,01110000,85,01010101,197,11000101
83,01010011,62,00111110,145,10010001
124,01111100,64,01000000,188,10111100
46,00101110,76,01001100,122,01111010
27,00011011,99,01100011,126,01111110
49,00110001,72,01001000,121,01111001
76,01001100,12,00001100,88,01011000
112,01110000,22,00010110,134,10000110
97,01100001,76,01001100,173,10101101
62,00111110,6,00000110,68,01000100
107,01101011,85,01010101,192,11000000
12,00001100,85,01010101,97,01100001
45,00101101,12,00001100,57,00111001
123,01111011,107,01101011,230,11100110
45,00101101,46,00101110,91,01011011
80,01010000,29,00011101,109,01101101
113,01110001,29,00011101,142,10001110
1,00000001,126,01111110,127,01111111
59,00111011,98,01100010,157,10011101
28,00011100,54,00110110,82,01010010
105,01101001,37,00100101,142,10001110
18,00010010,92,01011100,110,01101110
46,00101110,80,01010000,126,01111110
112,01110000,100,01100100,212,11010100
9,00001001,25,00011001,34,00100010
97,01100001,24,00011000,121,01111001
87,01010111,125,01111101,212,11010100
65,01000001,108,01101100,173,10101101
108,01101100,72,01001000,180,10110100
84,01010100,94,01011110,178,10110010
61,00111101,27,00011011,88,01011000
27,00011011,43,00101011,70,01000110
112,01110000,76,01001100,188,10111100
97,01100001,49,00110001,146,10010010
126,01111110,73,01001001,199,11000111
26,00011010,45,00101101,71,01000111
6,00000110,78,01001110,84,01010100
87,01010111,73,01001001,160,10100000
2,00000010,113,01110001,115,01110011
52,00110100,100,01100100,152,10011000
114,01110010,100,01100100,214,11010110
38,00100110,46,00101110,84,01010100
83,01010011,62,00111110,145,10010001
61,00111101,28,00011100,89,01011001
82,01010010,52,00110100,134,10000110
84,01010100,126,01111110,210,11010010
2,00000010,64,01000000,66,01000010
90,01011010,92,01011100,182,10110110
29,00011101,126,01111110,155,10011011
62,00111110,40,00101000,102,01100110
61,00111101,66,01000010,127,01111111
57,00111001,11,00001011,68,01000100
26,00011010,44,00101100,70,01000110
64,01000000,30,00011110,94,01011110
16,00010000,53,00110101,69,01000101
21,00010101,72,01001000,93,01011101
56,00111000,104,01101000,160,10100000
11,00001011,24,00011000,35,00100011
122,01111010,47,00101111,169,10101001
51,00110011,81,01010001,132,10000100
36,00100100,111,01101111,147,10010011
56,00111000,99,01100011,155,10011011
12,00001100,16,00010000,28,00011100
20,00010100,78,01001110,98,01100010
31,00011111,38,00100110,69,01000101
98,01100010,118,01110110,216,11011000
100,01100100,85,01010101,185,10111001
82,01010010,50,00110010,132,10000100
33,00100001,46,00101110,79,01001111
64,01000000,15,00001111,79,01001111
127,01111111,117,01110101,244,11110100
93,01011101,52,00110100,145,10010001
88,01011000,111,01101111,199,11000111
58,00111010,16,00010000,74,01001010
114,01110010,0,00000000,114,01110010
115,01110011,106,01101010,221,11011101
24,00011000,86,01010110,110,01101110
89,01011001,41,00101001,130,10000010
107,01101011,71,01000111,178,10110010
1,00000001,115,01110011,116,01110100
16,00010000,78,01001110,94,01011110
23,00010111,125,01111101,148,10010100
12,00001100,53,00110101,65,01000001
18,00010010,105,01101001,123,01111011
117,01110101,82,01010010,199,11000111
36,00100100,84,01010100,120,01111000
67,01000011,100,01100100,167,10100111
53,00110101,55,00110111,108,01101100
103,01100111,17,00010001,120,01111000
126,01111110,115,01110011,241,11110001
86,01010110,82,01010010,168,10101000
35,00100011,100,01100100,135,10000111
34,00100010,121,01111001,155,10011011
4,00000100,94,01011110,98,01100010
42,00101010,53,00110101,95,01011111
97,01100001,119,01110111,216,11011000
103,01100111,15,00001111,118,01110110
27,00011011,69,01000101,96,01100000
87,01010111,83,01010011,170,10101010
121,01111001,13,00001101,134,10000110
119,01110111,57,00111001,176,10110000
20,00010100,26,00011010,46,00101110
95,01011111,15,00001111,110,01101110
81,01010001,38,00100110,119,01110111
82,01010010,105,01101001,187,10111011
38,00100110,16,00010000,54,00110110
89,01011001,42,00101010,131,10000011
13,00001101,110,01101110,123,01111011
47,00101111,11,00001011,58,00111010
43,00101011,18,00010010,61,00111101
17,00010001,94,01011110,111,01101111
100,01100100,89,01011001,189,10111101
5,00000101,52,00110100,57,00111001
88,01011000,101,01100101,189,10111101
53,00110101,36,00100100,89,01011001
3,00000011,2,00000010,5,00000101
92,01011100,1,00000001,93,01011101
19,00010011,114,01110010,133,10000101
29,00011101,118,01110110,147,10010011
41,00101001,100,01100100,141,10001101
50,00110010,94,01011110,144,10010000
44,00101100,64,01000000,108,01101100
95,01011111,62,00111110,157,10011101
126,01111110,85,01010101,211,11010011
91,01011011,84,01010100,175,10101111
112,01110000,114,01110010,226,11100010
67,01000011,0,00000000,67,01000011
108,01101100,94,01011110,202,11001010
47,00101111,22,00010110,69,01000101
72,01001000,73,01001001,145,10010001
102,01100110,117,01110101,219,11011011
92,01011100,121,01111001,213,11010101
7,00000111,98,01100010,105,01101001
44,00101100,100,01100100,144,10010000
107,01101011,125,01111101,232,11101000
77,01001101,90,01011010,167,10100111
58,00111010,16,00010000,74,01001010
60,00111100,115,01110011,175,10101111
5,00000101,46,00101110,51,00110011
109,01101101,125,01111101,234,11101010
109,01101101,70,01000110,179,10110011
42,00101010,44,00101100,86,01010110
77,01001101,89,01011001,166,10100110
22,00010110,59,00111011,81,01010001
76,01001100,55,00110111,131,10000011
24,00011000,125,01111101,149,10010101
4,00000100,16,00010000,20,00010100
60,00111100,71,01000111,131,10000011
36,00100100,90,01011010,126,01111110
89,01011001,118,01110110,207,11001111
61,00111101,126,01111110,187,10111011
25,00011001,95,01011111,120,01111000
90,01011010,0,00000000,90,01011010
48,00110000,113,01110001,161,10100001
126,01111110,38,00100110,164,10100100
95,01011111,10,00001010,105,01101001
38,00100110,2,00000010,40,00101000
17,00010001,4,00000100,21,00010101
59,00111011,52,00110100,111,01101111
97,01100001,3,00000011,100,01100100
127,01111111,53,00110101,180,10110100
82,01010010,75,01001011,157,10011101
3,00000011,7,00000111,10,00001010
98,01100010,126,01111110,224,11100000
75,01001011,46,00101110,121,01111001
62,00111110,100,01100100,162,10100010
34,00100010,48,00110000,82,01010010
119,01110111,50,00110010,169,10101001
117,01110101,56,00111000,173,10101101
51,00110011,20,00010100,71,01000111
13,00001101,76,01001100,89,01011001
47,00101111,119,01110111,166,10100110
27,00011011,8,00001000,35,00100011
89,01011001,52,00110100,141,10001101
77,01001101,1,00000001,78,01001110
31,00011111,115,01110011,146,10010010
14,00001110,32,00100000,46,00101110
53,00110101,127,01111111,180,10110100
122,01111010,37,00100101,159,10011111
90,01011010,24,00011000,114,01110010
84,01010100,55,00110111,139,10001011
17,00010001,123,01111011,140,10001100
58,00111010,90,01011010,148,10010100
76,01001100,45,00101101,121,01111001
1,00000001,2,00000010,3,00000011
83,01010011,26,00011010,109,01101101
59,00111011,37,00100101,96,01100000
71,01000111,22,00010110,93,01011101
68,01000100,117,01110101,185,10111001
90,01011010,103,01100111,193,11000001
42,00101010,13,00001101,55,00110111
68,01000100,86,01010110,154,10011010
52,00110100,36,00100100,88,01011000
75,01001011,11,00001011,86,01010110
72,01001000,119,01110111,191,10111111
46,00101110,43,00101011,89,01011001
51,00110011,102,01100110,153,10011001
104,01101000,104,01101000,208,11010000
123,01111011,92,01011100,215,11010111
94,01011110,87,01010111,181,10110101
14,00001110,122,01111010,136,10001000
63,00111111,31,00011111,94,01011110
62,00111110,86,01010110,148,10010100
106,01101010,17,00010001,123,01111011
116,01110100,110,01101110,226,11100010
79,01001111,116,01110100,195,11000011
50,00110010,36,00100100,86,01010110
77,01001101,65,01000001,142,10001110
8,00001000,61,00111101,69,01000101
126,01111110,13,00001101,139,10001011
80,01010000,17,00010001,97,01100001
77,01001101,124,01111100,201,11001001
58,00111010,18,00010010,76,01001100
106,01101010,29,00011101,135,10000111
38,00100110,109,01101101,147,10010011
14,00001110,47,00101111,61,00111101
101,01100101,52,00110100,153,10011001
111,01101111,39,00100111,150,10010110
118,01110110,9,00001001,127,01111111
63,00111111,117,01110101,180,10110100
7,00000111,81,01010001,88,01011000
62,00111110,97,01100001,159,10011111
28,00011100,69,01000101,97,01100001
96,01100000,106,01101010,202,11001010
79,01001111,53,00110101,132,10000100
1,00000001,21,00010101,22,00010110
40,00101000,4,00000100,44,00101100
100,01100100,101,01100101,201,11001001
109,01101101,85,01010101,194,11000010
44,00101100,91,01011011,135,10000111
119,01110111,92,01011100,211,11010011
96,01100000,35,00100011,131,10000011
14,00001110,80,01010000,94,01011110
51,00110011,42,00101010,93,01011101
41,00101001,73,01001001,114,01110010
117,01110101,15,00001111,132,10000100
84,01010100,27,00011011,111,01101111
54,00110110,48,00110000,102,01100110
25,00011001,80,01010000,105,01101001
64,01000000,0,00000000,64,01000000
77,01001101,121,01111001,198,11000110
99,01100011,125,01111101,224,11100000
6,00000110,107,01101011,113,01110001
56,00111000,103,01100111,159,10011111
127,01111111,24,00011000,151,10010111
32,00100000,113,01110001,145,10010001
0,00000000,40,00101000,40,00101000
56,00111000,118,01110110,174,10101110
100,01100100,38,00100110,138,10001010
57,00111001,77,01001101,134,10000110
3,00000011,38,00100110,41,00101001
73,01001001,60,00111100,133,10000101
12,00001100,118,01110110,130,10000010
76,01001100,34,00100010,110,01101110
78,01001110,103,01100111,181,10110101
77,01001101,127,01111111,204,11001100
100,01100100,5,00000101,105,01101001
64,01000000,109,01101101,173,10101101
14,00001110,25,00011001,39,00100111
90,01011010,111,01101111,201,11001001
51,00110011,122,01111010,173,10101101
118,01110110,60,00111100,178,10110010
121,01111001,13,00001101,134,10000110
22,00010110,122,01111010,144,10010000
99,01100011,78,01001110,177,10110001
80,01010000,14,00001110,94,01011110
123,01111011,17,00010001,140,10001100
81,01010001,4,00000100,85,01010101
124,01111100,52,00110100,176,10110000
16,00010000,61,00111101,77,01001101
34,00100010,98,01100010,132,10000100
3,00000011,124,01111100,127,01111111
77,01001101,8,00001000,85,01010101
99,01100011,59,00111011,158,10011110
64,01000000,27,00011011,91,01011011
91,01011011,73,01001001,164,10100100
65,01000001,42,00101010,107,01101011
103,01100111,35,00100011,138,10001010
35,00100011,101,01100101,136,10001000
99,01100011,24,00011000,123,01111011
22,00010110,101,01100101,123,01111011
25,00011001,68,01000100,93,01011101
13,00001101,126,01111110,139,10001011
77,01001101,86,01010110,163,10100011
42,00101010,22,00010110,64,01000000
40,00101000,103,01100111,143,10001111
35,00100011,12,00001100,47,00101111
16,00010000,87,01010111,103,01100111
60,00111100,67,01000011,127,01111111
74,01001010,39,00100111,113,01110001
10,00001010,17,00010001,27,00011011
87,01010111,23,00010111,110,01101110
58,00111010,94,01011110,152,10011000
23,00010111,91,01011011,114,01110010
10,00001010,20,00010100,30,00011110
9,00001001,5,00000101,14,00001110
94,01011110,93,01011101,187,10111011
91,01011011,18,00010010,109,01101101
115,01110011,71,01000111,186,10111010
106,01101010,78,01001110,184,10111000
0,00000000,115,01110011,115,01110011
0,00000000,126,01111110,126,01111110
10,00001010,119,01110111,129,10000001
16,00010000,83,01010011,99,01100011
48,00110000,78,01001110,126,01111110
48,00110000,42,00101010,90,01011010
104,01101000,2,00000010,106,01101010
47,00101111,0,00000000,47,00101111
5,00000101,50,00110010,55,00110111
85,01010101,121,01111001,206,11001110
88,01011000,45,00101101,133,10000101
126,01111110,100,01100100,226,11100010
63,00111111,44,00101100,107,01101011
41,00101001,37,00100101,78,01001110
9,00001001,93,01011101,102,01100110
93,01011101,80,01010000,173,10101101
90,01011010,118,01110110,208,11010000
67,01000011,58,00111010,125,01111101
23,00010111,5,00000101,28,00011100
43,00101011,92,01011100,135,10000111
75,01001011,115,01110011,190,10111110
50,00110010,27,00011011,77,01001101
23,00010111,70,01000110,93,01011101
92,01011100,8,00001000,100,01100100
76,01001100,115,01110011,191,10111111
22,00010110,84,01010100,106,01101010
37,00100101,95,01011111,132,10000100
119,01110111,97,01100001,216,11011000
5,00000101,31,00011111,36,00100100
97,01100001,8,00001000,105,01101001
59,00111011,32,00100000,91,01011011
54,00110110,62,00111110,116,01110100
65,01000001,58,00111010,123,01111011
18,00010010,93,01011101,111,01101111
110,01101110,93,01011101,203,11001011
90,01011010,109,01101101,199,11000111
69,01000101,69,01000101,138,10001010
33,00100001,56,00111000,89,01011001
38,00100110,0,00000000,38,00100110
110,01101110,20,00010100,130,10000010
111,01101111,43,00101011,154,10011010
97,01100001,14,00001110,111,01101111
39,00100111,54,00110110,93,01011101
66,01000010,109,01101101,175,10101111
27,00011011,8,00001000,35,00100011
37,00100101,19,00010011,56,00111000
66,01000010,7,00000111,73,01001001
35,00100011,109,01101101,144,10010000
50,00110010,103,01100111,153,10011001
14,00001110,33,00100001,47,00101111
71,01000111,55,00110111,126,01111110
51,00110011,117,01110101,168,10101000
117,01110101,16,00010000,133,10000101
24,00011000,30,00011110,54,00110110
102,01100110,44,00101100,146,10010010
7,00000111,47,00101111,54,00110110
101,01100101,105,01101001,206,11001110
108,01101100,83,01010011,191,10111111
15,00001111,91,01011011,106,01101010
74,01001010,81,01010001,155,10011011
95,01011111,60,00111100,155,10011011
32,00100000,118,01110110,150,10010110
53,00110101,92,01011100,145,10010001
127,01111111,106,01101010,233,11101001
5,00000101,90,01011010,95,01011111
33,00100001,117,01110101,150,10010110
126,01111110,123,01111011,249,11111001
51,00110011,37,00100101,88,01011000
74,01001010,55,00110111,129,10000001
112,01110000,6,00000110,118,01110110
101,01100101,95,01011111,196,11000100
29,00011101,87,01010111,116,01110100
45,00101101,20,00010100,65,01000001
125,01111101,78,01001110,203,11001011
66,01000010,6,00000110,72,01001000
20,00010100,23,00010111,43,00101011
110,01101110,16,00010000,126,01111110
84,01010100,21,00010101,105,01101001
45,00101101,16,00010000,61,00111101
61,00111101,2,00000010,63,00111111
35,00100011,38,00100110,73,01001001
71,01000111,97,01100001,168,10101000
85,01010101,49,00110001,134,10000110
111,01101111,74,01001010,185,10111001
110,01101110,59,00111011,169,10101001
69,01000101,21,00010101,90,01011010
68,01000100,39,00100111,107,01101011
53,00110101,125,01111101,178,10110010
77,01001101,80,01010000,157,10011101
108,01101100,92,01011100,200,11001000
42,00101010,13,00001101,55,00110111
13,00001101,115,01110011,128,10000000
23,00010111,68,01000100,91,01011011
55,00110111,63,00111111,118,01110110
17,00010001,94,01011110,111,01101111
75,01001011,17,00010001,92,01011100
8,00001000,57,00111001,65,01000001
63,00111111,16,00010000,79,01001111
41,00101001,48,00110000,89,01011001
26,00011010,98,01100010,124,01111100
121,01111001,100,01100100,221,11011101
59,00111011,64,01000000,123,01111011
45,00101101,113,01110001,158,10011110
8,00001000,127,01111111,135,10000111
123,01111011,35,00100011,158,10011110
13,00001101,84,01010100,97,01100001
97,01100001,81,01010001,178,10110010
58,00111010,70,01000110,128,10000000
108,01101100,17,00010001,125,01111101
93,01011101,34,00100010,127,01111111
31,00011111,84,01010100,115,01110011
87,01010111,104,01101000,191,10111111
88,01011000,75,01001011,163,10100011
41,00101001,82,01010010,123,01111011
73,01001001,73,01001001,146,10010010
113,01110001,124,01111100,237,11101101
29,00011101,97,01100001,126,01111110
110,01101110,123,01111011,233,11101001
95,01011111,86,01010110,181,10110101
89,01011001,62,00111110,151,10010111
5,00000101,125,01111101,130,10000010
40,00101000,35,00100011,75,01001011
45,00101101,18,00010010,63,00111111
86,01010110,97,01100001,183,10110111
78,01001110,97,01100001,175,10101111
103,01100111,38,00100110,141,10001101
5,00000101,1,00000001,6,00000110
5,00000101,102,01100110,107,01101011
31,00011111,97,01100001,128,10000000
40,00101000,108,01101100,148,10010100
1,00000001,84,01010100,85,01010101
102,01100110,111,01101111,213,11010101
39,00100111,84,01010100,123,01111011
13,00001101,43,00101011,56,00111000
83,01010011,107,01101011,190,10111110
25,00011001,56,00111000,81,01010001
116,01110100,60,00111100,176,10110000
60,00111100,1,00000001,61,00111101
108,01101100,5,00000101,113,01110001
5,00000101,88,01011000,93,01011101
90,01011010,121,01111001,211,11010011
92,01011100,34,00100010,126,01111110
116,01110100,24,00011000,140,10001100
84,01010100,110,01101110,194,11000010
81,01010001,55,00110111,136,10001000
112,01110000,59,00111011,171,10101011
0,00000000,34,00100010,34,00100010
94,01011110,115,01110011,209,11010001
6,00000110,56,00111000,62,00111110
110,01101110,68,01000100,178,10110010
8,00001000,19,00010011,27,00011011
67,01000011,32,00100000,99,01100011
127,01111111,67,01000011,194,11000010
103,01100111,61,00111101,164,10100100
26,00011010,19,00010011,45,00101101
76,01001100,0,00000000,76,01001100
85,01010101,84,01010100,169,10101001
49,00110001,123,01111011,172,10101100
106,01101010,66,01000010,172,10101100
0,00000000,17,00010001,17,00010001
32,00100000,48,00110000,80,01010000
34,00100010,105,01101001,139,10001011
5,00000101,38,00100110,43,00101011
50,00110010,18,00010010,68,01000100
56,00111000,82,01010010,138,10001010
96,01100000,38,00100110,134,10000110
88,01011000,64,01000000,152,10011000
8,00001000,97,01100001,105,01101001
3,00000011,44,00101100,47,00101111
44,00101100,50,00110010,94,01011110
59,00111011,124,01111100,183,10110111
75,01001011,56,00111000,131,10000011
1,00000001,41,00101001,42,00101010
26,00011010,88,01011000,114,01110010
116,01110100,59,00111011,175,10101111
125,01111101,22,00010110,147,10010011
127,01111111,109,01101101,236,11101100
111,01101111,68,01000100,179,10110011
13,00001101,118,01110110,131,10000011
52,00110100,100,01100100,152,10011000
82,01010010,61,00111101,143,10001111
42,00101010,89,01011001,131,10000011
0,00000000,1,00000001,1,00000001
28,00011100,19,00010011,47,00101111
31,00011111,20,00010100,51,00110011
115,01110011,44,00101100,159,10011111
11,00001011,19,00010011,30,00011110
40,00101000,95,01011111,135,10000111
57,00111001,9,00001001,66,01000010
121,01111001,79,01001111,200,11001000
33,00100001,116,01110100,149,10010101
20,00010100,8,00001000,28,00011100
69,01000101,79,01001111,148,10010100
82,01010010,9,00001001,91,01011011
60,00111100,6,00000110,66,01000010
51,00110011,2,00000010,53,00110101
13,00001101,22,00010110,35,00100011
127,01111111,54,00110110,181,10110101
2,00000010,55,00110111,57,00111001
121,01111001,88,01011000,209,11010001
47,00101111,49,00110001,96,01100000
92,01011100,41,00101001,133,10000101
41,00101001,54,00110110,95,01011111
28,00011100,84,01010100,112,01110000
88,01011000,71,01000111,159,10011111
13,00001101,109,01101101,122,01111010
114,01110010,111,01101111,225,11100001
58,00111010,115,01110011,173,10101101
117,01110101,86,01010110,203,11001011
110,01101110,86,01010110,196,11000100
37,00100101,81,01010001,118,01110110
127,01111111,21,00010101,148,10010100
20,00010100,54,00110110,74,01001010
66,01000010,109,01101101,175,10101111
77,01001101,47,00101111,124,01111100
10,00001010,2,00000010,12,00001100
123,01111011,6,00000110,129,10000001
79,01001111,69,01000101,148,10010100
16,00010000,78,01001110,94,01011110
42,00101010,27,00011011,69,01000101
8,00001000,109,01101101,117,01110101
44,00101100,69,01000101,113,01110001
60,00111100,73,01001001,133,10000101
127,01111111,51,00110011,178,10110010
35,00100011,72,01001000,107,01101011
37,00100101,50,00110010,87,01010111
4,00000100,119,01110111,123,01111011
68,01000100,103,01100111,171,10101011
61,00111101,45,00101101,106,01101010
46,00101110,52,00110100,98,01100010
56,00111000,75,01001011,131,10000011
20,00010100,8,00001000,28,00011100
121,01111001,96,01100000,217,11011001
34,00100010,107,01101011,141,10001101
101,01100101,20,00010100,121,01111001
51,00110011,83,01010011,134,10000110
63,00111111,4,00000100,67,01000011
42,00101010,45,00101101,87,01010111
33,00100001,113,01110001,146,10010010
79,01001111,113,01110001,192,11000000
100,01100100,55,00110111,155,10011011
88,01011000,36,00100100,124,01111100
87,01010111,96,01100000,183,10110111
55,00110111,109,01101101,164,10100100
92,01011100,2,00000010,94,01011110
6,00000110,66,01000010,72,01001000
43,00101011,23,00010111,66,01000010
79,01001111,46,00101110,125,01111101
91,01011011,110,01101110,201,11001001
51,00110011,67,01000011,118,01110110
43,00101011,93,01011101,136,10001000
108,01101100,118,01110110,226,11100010
105,01101001,61,00111101,166,10100110
2,00000010,86,01010110,88,01011000
64,01000000,52,00110100,116,01110100
63,00111111,55,00110111,118,01110110
57,00111001,44,00101100,101,01100101
113,01110001,114,01110010,227,11100011
64,01000000,97,01100001,161,10100001
79,01001111,58,00111010,137,10001001
6,00000110,114,01110010,120,01111000
65,01000001,0,00000000,65,01000001
85,01010101,112,01110000,197,11000101
17,00010001,122,01111010,139,10001011
6,00000110,62,00111110,68,01000100
56,00111000,76,01001100,132,10000100
9,00001001,14,00001110,23,00010111
70,01000110,122,01111010,192,11000000
114,01110010,95,01011111,209,11010001
65,01000001,94,01011110,159,10011111
52,00110100,96,01100000,148,10010100
24,00011000,99,01100011,123,01111011
75,01001011,20,00010100,95,01011111
66,01000010,114,01110010,180,10110100
56,00111000,76,01001100,132,10000100
112,01110000,17,00010001,129,10000001
20,00010100,111,01101111,131,10000011
96,01100000,65,01000001,161,10100001
65,01000001,98,01100010,163,10100011
71,01000111,50,00110010,121,01111001
61,00111101,23,00010111,84,01010100
103,01100111,65,01000001,168,10101000
104,01101000,49,00110001,153,10011001
86,01010110,13,00001101,99,01100011
40,00101000,10,00001010,50,00110010
101,01100101,66,01000010,167,10100111
47,00101111,101,01100101,148,10010100
66,01000010,31,00011111,97,01100001
48,00110000,35,00100011,83,01010011
27,00011011,89,01011001,116,01110100
10,00001010,102,01100110,112,01110000
102,01100110,42,00101010,144,10010000
88,01011000,30,00011110,118,01110110
121,01111001,58,00111010,179,10110011
10,00001010,45,00101101,55,00110111
106,01101010,122,01111010,228,11100100
3,00000011,6,00000110,9,00001001
57,00111001,9,00001001,66,01000010
43,00101011,1,00000001,44,00101100
73,01001001,49,00110001,122,01111010
89,01011001,80,01010000,169,10101001
7,00000111,104,01101000,111,01101111
107,01101011,1,00000001,108,01101100
59,00111011,64,01000000,123,01111011
87,01010111,115,01110011,202,11001010
47,00101111,46,00101110,93,01011101
26,00011010,50,00110010,76,01001100
50,00110010,84,01010100,134,10000110
43,00101011,24,00011000,67,01000011
42,00101010,70,01000110,112,01110000
84,01010100,47,00101111,131,10000011
113,01110001,121,01111001,234,11101010
107,01101011,100,01100100,207,11001111
5,00000101,110,01101110,115,01110011
52,00110100,71,01000111,123,01111011
28,00011100,54,00110110,82,01010010
8,00001000,111,01101111,119,01110111
103,01100111,118,01110110,221,11011101
32,00100000,14,00001110,46,00101110
81,01010001,28,00011100,109,01101101
69,01000101,118,01110110,187,10111011
93,01011101,45,00101101,138,10001010
45,00101101,104,01101000,149,10010101
19,00010011,78,01001110,97,01100001
45,00101101,88,01011000,133,10000101
71,01000111,122,01111010,193,11000001
120,01111000,111,01101111,231,11100111
78,01001110,90,01011010,168,10101000
31,00011111,13,00001101,44,00101100
94,01011110,6,00000110,100,01100100
60,00111100,53,00110101,113,01110001
125,01111101,98,01100010,223,11011111
102,01100110,108,01101100,210,11010010
2,00000010,37,00100101,39,00100111
103,01100111,1,00000001,104,01101000
122,01111010,1,00000001,123,01111011
22,00010110,48,00110000,70,01000110
42,00101010,123,01111011,165,10100101
110,01101110,110,01101110,220,11011100
115,01110011,121,01111001,236,11101100
10,00001010,78,01001110,88,01011000
116,01110100,21,00010101,137,10001001
53,00110101,39,00100111,92,01011100
91,01011011,87,01010111,178,10110010
62,00111110,116,01110100,178,10110010
62,00111110,0,00000000,62,00111110
101,01100101,7,00000111,108,01101100
11,00001011,119,01110111,130,10000010
111,01101111,3,00000011,114,01110010
83,01010011,32,00100000,115,01110011
109,01101101,104,01101000,213,11010101
112,01110000,51,00110011,163,10100011
71,01000111,103,01100111,174,10101110
8,00001000,10,00001010,18,00010010
85,01010101,100,01100100,185,10111001
77,01001101,94,01011110,171,10101011
93,01011101,112,01110000,205,11001101
26,00011010,126,01111110,152,10011000
8,00001000,83,01010011,91,01011011
62,00111110,22,00010110,84,01010100
47,00101111,42,00101010,89,01011001
106,01101010,10,00001010,116,01110100
26,00011010,26,00011010,52,00110100
25,00011001,68,01000100,93,01011101
101,01100101,38,00100110,139,10001011
18,00010010,114,01110010,132,10000100
95,01011111,124,01111100,219,11011011
56,00111000,79,01001111,135,10000111
44,00101100,110,01101110,154,10011010
90,01011010,59,00111011,149,10010101
2,00000010,25,00011001,27,00011011
33,00100001,1,00000001,34,00100010
53,00110101,12,00001100,65,01000001
65,01000001,125,01111101,190,10111110
75,01001011,1,00000001,76,01001100
67,01000011,18,00010010,85,01010101
31,00011111,119,01110111,150,10010110
10,00001010,127,01111111,137,10001001
65,01000001,63,00111111,128,10000000
0,00000000,12,00001100,12,00001100
84,01010100,26,00011010,110,01101110
90,01011010,65,01000001,155,10011011
55,00110111,56,00111000,111,01101111
118,01110110,36,00100100,154,10011010
124,01111100,39,00100111,163,10100011
51,00110011,54,00110110,105,01101001
16,00010000,60,00111100,76,01001100
53,00110101,97,01100001,150,10010110
29,00011101,62,00111110,91,01011011
113,01110001,100,01100100,213,11010101
84,01010100,126,01111110,210,11010010
41,00101001,90,01011010,131,10000011
71,01000111,48,00110000,119,01110111
121,01111001,29,00011101,150,10010110
46,00101110,72,01001000,118,01110110
29,00011101,79,01001111,108,01101100
60,00111100,80,01010000,140,10001100
94,01011110,9,00001001,103,01100111
93,01011101,27,00011011,120,01111000
95,01011111,5,00000101,100,01100100
85,01010101,12,00001100,97,01100001
80,01010000,12,00001100,92,01011100
56,00111000,121,01111001,177,10110001
111,01101111,28,00011100,139,10001011
73,01001001,25,00011001,98,01100010
104,01101000,36,00100100,140,10001100
36,00100100,36,00100100,72,01001000
46,00101110,43,00101011,89,01011001
60,00111100,117,01110101,177,10110001
81,01010001,24,00011000,105,01101001
87,01010111,116,01110100,203,11001011
19,00010011,78,01001110,97,01100001
27,00011011,87,01010111,114,01110010
14,00001110,41,00101001,55,00110111
107,01101011,16,00010000,123,01111011
93,01011101,28,00011100,121,01111001
111,01101111,76,01001100,187,10111011
64,01000000,107,01101011,171,10101011
39,00100111,91,01011011,130,10000010
84,01010100,83,01010011,167,10100111
8,00001000,69,01000101,77,01001101
7,00000111,94,01011110,101,01100101
2,00000010,99,01100011,101,01100101
72,01001000,16,00010000,88,01011000
16,00010000,103,01100111,119,01110111
7,00000111,104,01101000,111,01101111
107,01101011,58,00111010,165,10100101
64,01000000,86,01010110,150,10010110
100,01100100,49,00110001,149,10010101
116,01110100,113,01110001,229,11100101
37,00100101,57,00111001,94,01011110
57,00111001,121,01111001,178,10110010
77,01001101,122,01111010,199,11000111
42,00101010,71,01000111,113,01110001
57,00111001,5,00000101,62,00111110
37,00100101,43,00101011,80,01010000
13,00001101,126,01111110,139,10001011
35,00100011,23,00010111,58,00111010
58,00111010,14,00001110,72,01001000
41,00101001,63,00111111,104,01101000
127,01111111,69,01000101,196,11000100
21,00010101,109,01101101,130,10000010
26,00011010,90,01011010,116,01110100
109,01101101,10,00001010,119,01110111
44,00101100,103,01100111,147,10010011
25,00011001,7,00000111,32,00100000
63,00111111,58,00111010,121,01111001
50,00110010,85,01010101,135,10000111
42,00101010,73,01001001,115,01110011
108,01101100,92,01011100,200,11001000
13,00001101,121,01111001,134,10000110
63,00111111,111,01101111,174,10101110
103,01100111,112,01110000,215,11010111
12,00001100,79,01001111,91,01011011
59,00111011,36,00100100,95,01011111
61,00111101,73,01001001,134,10000110
70,01000110,44,00101100,114,01110010
52,00110100,85,01010101,137,10001001
39,00100111,22,00010110,61,00111101
76,01001100,36,00100100,112,01110000
90,01011010,35,00100011,125,01111101
115,01110011,88,01011000,203,11001011
8,00001000,1,00000001,9,00001001
47,00101111,23,00010111,70,01000110
46,00101110,108,01101100,154,10011010
30,00011110,6,00000110,36,00100100
10,00001010,69,01000101,79,01001111
85,01010101,43,00101011,128,10000000
68,01000100,65,01000001,133,10000101
119,01110111,40,00101000,159,10011111
46,00101110,60,00111100,106,01101010
50,00110010,76,01001100,126,01111110
114,01110010,67,01000011,181,10110101
118,01110110,84,01010100,202,11001010
104,01101000,55,00110111,159,10011111
14,00001110,75,01001011,89,01011001
72,01001000,13,00001101,85,01010101
98,01100010,35,00100011,133,10000101
6,00000110,121,01111001,127,01111111
72,01001000,78,01001110,150,10010110
96,01100000,113,01110001,209,11010001
81,01010001,33,00100001,114,01110010
115,01110011,122,01111010,237,11101101
81,01010001,92,01011100,173,10101101
82,01010010,20,00010100,102,01100110
104,01101000,5,00000101,109,01101101
89,01011001,94,01011110,183,10110111
33,00100001,98,01100010,131,10000011
46,00101110,31,00011111,77,01001101
13,00001101,79,01001111,92,01011100
57,00111001,68,01000100,125,01111101
53,00110101,125,01111101,178,10110010
122,01111010,89,01011001,211,11010011
30,00011110,79,01001111,109,01101101
126,01111110,109,01101101,235,11101011
26,00011010,116,01110100,142,10001110
78,01001110,109,01101101,187,10111011
61,00111101,68,01000100,129,10000001
94,01011110,23,00010111,117,01110101
110,01101110,52,00110100,162,10100010
110,01101110,32,00100000,142,10001110
116,01110100,58,00111010,174,10101110
90,01011010,71,01000111,161,10100001
76,01001100,48,00110000,124,01111100
99,01100011,103,01100111,202,11001010
12,00001100,101,01100101,113,01110001
97,01100001,81,01010001,178,10110010
46,00101110,8,00001000,54,00110110
51,00110011,69,01000101,120,01111000
124,01111100,29,00011101,153,10011001
83,01010011,80,01010000,163,10100011
11,00001011,100,01100100,111,01101111
21,00010101,106,01101010,127,01111111
93,01011101,8,00001000,101,01100101
72,01001000,53,00110101,125,01111101
71,01000111,73,01001001,144,10010000
46,00101110,113,01110001,159,10011111
8,00001000,37,00100101,45,00101101
108,01101100,81,01010001,189,10111101
0,00000000,93,01011101,93,01011101
111,01101111,121,01111001,232,11101000
113,01110001,43,00101011,156,10011100
35,00100011,123,01111011,158,10011110
89,01011001,23,00010111,112,01110000
112,01110000,58,00111010,170,10101010
31,00011111,126,01111110,157,10011101
70,01000110,28,00011100,98,01100010
125,01111101,68,01000100,193,11000001
52,00110100,75,01001011,127,01111111
81,01010001,1,00000001,82,01010010
71,01000111,54,00110110,125,01111101
40,00101000,87,01010111,127,01111111
22,00010110,24,00011000,46,00101110
99,01100011,54,00110110,153,10011001
103,01100111,3,00000011,106,01101010
114,01110010,51,00110011,165,10100101
101,01100101,58,00111010,159,10011111
55,00110111,55,00110111,110,01101110
96,01100000,127,01111111,223,11011111
96,01100000,66,01000010,162,10100010
28,00011100,108,01101100,136,10001000
75,01001011,125,01111101,200,11001000
74,01001010,47,00101111,121,01111001
46,00101110,55,00110111,101,01100101
125,01111101,83,01010011,208,11010000
120,01111000,12,00001100,132,10000100
87,01010111,49,00110001,136,10001000
41,00101001,49,00110001,90,01011010
67,01000011,114,01110010,181,10110101
99,01100011,55,00110111,154,10011010
55,00110111,87,01010111,142,10001110
121,01111001,66,01000010,187,10111011
63,00111111,114,01110010,177,10110001
85,01010101,2,00000010,87,01010111
27,00011011,118,01110110,145,10010001
61,00111101,3,00000011,64,01000000
69,01000101,66,01000010,135,10000111
78,01001110,15,00001111,93,01011101
32,00100000,12,00001100,44,00101100
48,00110000,60,00111100,108,01101100
58,00111010,8,00001000,66,01000010
71,01000111,43,00101011,114,01110010
126,01111110,115,01110011,241,11110001
98,01100010,77,01001101,175,10101111
107,01101011,56,00111000,163,10100011
115,01110011,76,01001100,191,10111111
53,00110101,37,00100101,90,01011010
97,01100001,111,01101111,208,11010000
120,01111000,104,01101000,224,11100000
92,01011100,76,01001100,168,10101000
110,01101110,113,01110001,223,11011111
55,00110111,33,00100001,88,01011000
49,00110001,99,01100011,148,10010100
97,01100001,92,01011100,189,10111101
2,00000010,30,00011110,32,00100000
47,00101111,4,00000100,51,00110011
87,01010111,14,00001110,101,01100101
36,00100100,68,01000100,104,01101000
101,01100101,120,01111000,221,11011101
82,01010010,83,01010011,165,10100101
126,01111110,51,00110011,177,10110001
102,01100110,81,01010001,183,10110111
106,01101010,115,01110011,221,11011101
24,00011000,54,00110110,78,01001110
1,00000001,102,01100110,103,01100111
62,00111110,53,00110101,115,01110011
32,00100000,66,01000010,98,01100010
37,00100101,73,01001001,110,01101110
15,00001111,5,00000101,20,00010100
6,00000110,28,00011100,34,00100010
35,00100011,36,00100100,71,01000111
61,00111101,72,01001000,133,10000101
55,00110111,50,00110010,105,01101001
65,01000001,70,01000110,135,10000111
79,01001111,63,00111111,142,10001110
7,00000111,53,00110101,60,00111100
9,00001001,112,01110000,121,01111001
106,01101010,80,01010000,186,10111010
107,01101011,82,01010010,189,10111101
11,00001011,85,01010101,96,01100000
96,01100000,117,01110101,213,11010101
17,00010001,9,00001001,26,00011010
17,00010001,123,01111011,140,10001100
8,00001000,100,01100100,108,01101100
43,00101011,27,00011011,70,01000110
81,01010001,41,00101001,122,01111010
65,01000001,109,01101101,174,10101110
92,01011100,86,01010110,178,10110010
20,00010100,99,01100011,119,01110111
41,00101001,17,00010001,58,00111010
107,01101011,9,00001001,116,01110100
31,00011111,112,01110000,143,10001111
32,00100000,31,00011111,63,00111111
11,00001011,31,00011111,42,00101010
118,01110110,15,00001111,133,10000101
56,00111000,83,01010011,139,10001011
29,00011101,19,00010011,48,00110000
25,00011001,43,00101011,68,01000100
85,01010101,90,01011010,175,10101111
64,01000000,81,01010001,145,10010001
0,00000000,105,01101001,105,01101001
121,01111001,127,01111111,248,11111000
73,01001001,118,01110110,191,10111111
41,00101001,14,00001110,55,00110111
43,00101011,72,01001000,115,01110011
100,01100100,107,01101011,207,11001111
118,01110110,100,01100100,218,11011010
44,00101100,75,01001011,119,01110111
45,00101101,83,01010011,128,10000000
21,00010101,12,00001100,33,00100001
2,00000010,119,01110111,121,01111001
2,00000010,4,00000100,6,00000110
73,01001001,108,01101100,181,10110101
44,00101100,20,00010100,64,01000000
84,01010100,63,00111111,147,10010011
60,00111100,46,00101110,106,01101010
85,01010101,34,00100010,119,01110111
55,00110111,88,01011000,143,10001111
125,01111101,38,00100110,163,10100011
48,00110000,32,00100000,80,01010000
100,01100100,38,00100110,138,10001010
20,00010100,104,01101000,124,01111100
19,00010011,14,00001110,33,00100001
65,01000001,126,01111110,191,10111111
26,00011010,113,01110001,139,10001011
9,00001001,108,01101100,117,01110101
104,01101000,103,01100111,207,11001111
76,01001100,116,01110100,192,11000000
56,00111000,28,00011100,84,01010100
44,00101100,4,00000100,48,00110000
89,01011001,32,00100000,121,01111001
64,01000000,103,01100111,167,10100111
2,00000010,107,01101011,109,01101101
54,00110110,49,00110001,103,01100111
116,01110100,124,01111100,240,11110000
77,01001101,34,00100010,111,01101111
47,00101111,102,01100110,149,10010101
82,01010010,36,00100100,118,01110110
16,00010000,56,00111000,72,01001000
53,00110101,35,00100011,88,01011000
125,01111101,48,00110000,173,10101101
104,01101000,41,00101001,145,10010001
23,00010111,97,01100001,120,01111000
62,00111110,66,01000010,128,10000000
86,01010110,94,01011110,180,10110100
93,01011101,8,00001000,101,01100101
82,01010010,124,01111100,206,11001110
98,01100010,103,01100111,201,11001001
16,00010000,56,00111000,72,01001000
97,01100001,22,00010110,119,01110111
31,00011111,51,00110011,82,01010010
91,01011011,122,01111010,213,11010101
4,00000100,66,01000010,70,01000110
89,01011001,26,00011010,115,01110011
115,01110011,127,01111111,242,11110010
85,01010101,99,01100011,184,10111000
109,01101101,105,01101001,214,11010110
24,00011000,69,01000101,93,01011101
0,00000000,58,00111010,58,00111010
99,01100011,61,00111101,160,10100000
2,00000010,20,00010100,22,00010110
88,01011000,13,00001101,101,01100101
40,00101000,74,01001010,114,01110010
119,01110111,101,01100101,220,11011100
94,01011110,83,01010011,177,10110001
74,01001010,19,00010011,93,01011101
54,00110110,59,00111011,113,01110001
63,00111111,27,00011011,90,01011010
34,00100010,33,00100001,67,01000011
12,00001100,90,01011010,102,01100110
35,00100011,119,01110111,154,10011010
119,01110111,77,01001101,196,11000100
34,00100010,108,01101100,142,10001110
122,01111010,48,00110000,170,10101010
97,01100001,72,01001000,169,10101001
56,00111000,26,00011010,82,01010010
28,00011100,28,00011100,56,00111000
51,00110011,80,01010000,131,10000011
73,01001001,40,00101000,113,01110001
104,01101000,68,01000100,172,10101100
5,00000101,69,01000101,74,01001010
19,00010011,100,01100100,119,01110111
66,01000010,98,01100010,164,10100100
115,01110011,117,01110101,232,11101000
32,00100000,83,01010011,115,01110011
54,00110110,37,00100101,91,01011011
48,00110000,68,01000100,116,01110100
119,01110111,4,00000100,123,01111011
50,00110010,120,01111000,170,10101010
73,01001001,114,01110010,187,10111011
117,01110101,71,01000111,188,10111100
0,00000000,66,01000010,66,01000010
125,01111101,3,00000011,128,10000000
72,01001000,106,01101010,178,10110010
6,00000110,99,01100011,105,01101001
30,00011110,84,01010100,114,01110010
119,01110111,42,00101010,161,10100001
50,00110010,90,01011010,140,10001100
42,00101010,106,01101010,148,10010100
37,00100101,38,00100110,75,01001011
100,01100100,79,01001111,179,10110011
114,01110010,2,00000010,116,01110100
57,00111001,21,00010101,78,01001110
44,00101100,48,00110000,92,01011100
12,00001100,15,00001111,27,00011011
11,00001011,21,00010101,32,00100000
1,00000001,77,01001101,78,01001110
17,00010001,121,01111001,138,10001010
37,00100101,37,00100101,74,01001010
89,01011001,116,01110100,205,11001101
121,01111001,76,01001100,197,11000101
13,00001101,55,00110111,68,01000100
97,01100001,3,00000011,100,01100100
48,00110000,48,00110000,96,01100000
36,00100100,127,01111111,163,10100011
37,00100101,103,01100111,140,10001100
34,00100010,37,00100101,71,01000111
10,00001010,34,00100010,44,00101100
93,01011101,97,01100001,190,10111110
28,00011100,46,00101110,74,01001010
117,01110101,29,00011101,146,10010010
54,00110110,113,01110001,167,10100111
94,01011110,38,00100110,132,10000100
64,01000000,93,01011101,157,10011101
64,01000000,79,01001111,143,10001111
64,01000000,102,01100110,166,10100110
15,00001111,6,00000110,21,00010101
6,00000110,8,00001000,14,00001110
32,00100000,46,00101110,78,01001110
38,00100110,110,01101110,148,10010100
107,01101011,34,00100010,141,10001101
117,01110101,0,00000000,117,01110101
48,00110000,99,01100011,147,10010011
20,00010100,77,01001101,97,01100001
51,00110011,55,00110111,106,01101010
87,01010111,101,01100101,188,10111100
12,00001100,26,00011010,38,00100110
30,00011110,29,00011101,59,00111011
121,01111001,47,00101111,168,10101000
87,01010111,79,01001111,166,10100110
45,00101101,7,00000111,52,00110100
117,01110101,56,00111000,173,10101101
20,00010100,107,01101011,127,01111111
120,01111000,3,00000011,123,01111011
95,01011111,119,01110111,214,11010110
58,00111010,0,00000000,58,00111010
36,00100100,124,01111100,160,10100000
7,00000111,125,01111101,132,10000100
27,00011011,18,00010010,45,00101101
91,01011011,46,00101110,137,10001001
34,00100010,82,01010010,116,01110100
111,01101111,114,01110010,225,11100001
0,00000000,93,01011101,93,01011101
121,01111001,118,01110110,239,11101111
93,01011101,119,01110111,212,11010100
28,00011100,15,00001111,43,00101011
124,01111100,43,00101011,167,10100111
66,01000010,49,00110001,115,01110011
71,01000111,6,00000110,77,01001101
68,01000100,112,01110000,180,10110100
109,01101101,25,00011001,134,10000110
46,00101110,80,01010000,126,01111110
124,01111100,75,01001011,199,11000111
105,01101001,68,01000100,173,10101101
30,00011110,122,01111010,152,10011000
24,00011000,116,01110100,140,10001100
6,00000110,54,00110110,60,00111100
55,00110111,114,01110010,169,10101001
96,01100000,87,01010111,183,10110111
83,01010011,101,01100101,184,10111000
38,00100110,38,00100110,76,01001100
58,00111010,68,01000100,126,01111110
76,01001100,81,01010001,157,10011101
62,00111110,8,00001000,70,01000110
33,00100001,73,01001001,106,01101010
39,00100111,36,00100100,75,01001011
82,01010010,0,00000000,82,01010010
120,01111000,16,00010000,136,10001000
107,01101011,71,01000111,178,10110010
50,00110010,55,00110111,105,01101001
49,00110001,50,00110010,99,01100011
103,01100111,82,01010010,185,10111001
4,00000100,25,00011001,29,00011101
10,00001010,96,01100000,106,01101010
45,00101101,85,01010101,130,10000010
98,01100010,52,00110100,150,10010110
14,00001110,30,00011110,44,00101100
74,01001010,71,01000111,145,10010001
80,01010000,108,01101100,188,10111100
27,00011011,108,01101100,135,10000111
52,00110100,32,00100000,84,01010100
39,00100111,119,01110111,158,10011110
56,00111000,125,01111101,181,10110101
23,00010111,114,01110010,137,10001001
61,00111101,70,01000110,131,10000011
12,00001100,115,01110011,127,01111111
4,00000100,18,00010010,22,00010110
78,01001110,20,00010100,98,01100010
101,01100101,56,00111000,157,10011101
35,00100011,70,01000110,105,01101001
108,01101100,29,00011101,137,10001001
123,01111011,10,00001010,133,10000101
90,01011010,2,00000010,92,01011100
86,01010110,101,01100101,187,10111011
17,00010001,46,00101110,63,00111111
97,01100001,28,00011100,125,01111101
50,00110010,66,01000010,116,01110100
41,00101001,72,01001000,113,01110001
18,00010010,12,00001100,30,00011110
81,01010001,109,01101101,190,10111110
53,00110101,28,00011100,81,01010001
104,01101000,121,01111001,225,11100001
18,00010010,79,01001111,97,01100001
60,00111100,0,00000000,60,00111100
118,01110110,44,00101100,162,10100010
4,00000100,77,01001101,81,01010001
46,00101110,109,01101101,155,10011011
75,01001011,27,00011011,102,01100110
107,01101011,59,00111011,166,10100110
7,00000111,53,00110101,60,00111100
24,00011000,11,00001011,35,00100011
26,00011010,99,01100011,125,01111101
63,00111111,15,00001111,78,01001110
76,01001100,78,01001110,154,10011010
70,01000110,18,00010010,88,01011000
115,01110011,124,01111100,239,11101111
104,01101000,15,00001111,119,01110111
46,00101110,84,01010100,130,10000010
81,01010001,72,01001000,153,10011001
92,01011100,14,00001110,106,01101010
33,00100001,53,00110101,86,01010110
95,01011111,11,00001011,106,01101010
53,00110101,9,00001001,62,00111110
108,01101100,32,00100000,140,10001100
111,01101111,104,01101000,215,11010111
85,01010101,103,01100111,188,10111100
10,00001010,97,01100001,107,01101011
9,00001001,28,00011100,37,00100101
2,00000010,122,01111010,124,01111100
13,00001101,122,01111010,135,10000111
106,01101010,11,00001011,117,01110101
78,01001110,109,01101101,187,10111011
89,01011001,0,00000000,89,01011001
88,01011000,107,01101011,195,11000011
71,01000111,18,00010010,89,01011001
51,00110011,1,00000001,52,00110100
63,00111111,4,00000100,67,01000011
38,00100110,37,00100101,75,01001011
121,01111001,124,01111100,245,11110101
82,01010010,101,01100101,183,10110111
56,00111000,9,00001001,65,01000001
81,01010001,104,01101000,185,10111001
102,01100110,84,01010100,186,10111010
13,00001101,47,00101111,60,00111100
26,00011010,57,00111001,83,01010011
67,01000011,17,00010001,84,01010100
32,00100000,14,00001110,46,00101110
75,01001011,103,01100111,178,10110010
41,00101001,26,00011010,67,01000011
56,00111000,83,01010011,139,10001011
3,00000011,18,00010010,21,00010101
46,00101110,32,00100000,78,01001110
113,01110001,56,00111000,169,10101001
18,00010010,116,01110100,134,10000110
66,01000010,56,00111000,122,01111010
95,01011111,124,01111100,219,11011011
68,01000100,68,01000100,136,10001000
6,00000110,115,01110011,121,01111001
70,01000110,1,00000001,71,01000111
77,01001101,2,00000010,79,01001111
53,00110101,80,01010000,133,10000101
79,01001111,14,00001110,93,01011101
114,01110010,7,00000111,121,01111001
75,01001011,82,01010010,157,10011101
35,00100011,119,01110111,154,10011010
3,00000011,0,00000000,3,00000011
45,00101101,52,00110100,97,01100001
19,00010011,103,01100111,122,01111010
117,01110101,82,01010010,199,11000111
112,01110000,10,00001010,122,01111010
109,01101101,45,00101101,154,10011010
97,01100001,87,01010111,184,10111000
24,00011000,86,01010110,110,01101110
77,01001101,95,01011111,172,10101100
127,01111111,11,00001011,138,10001010
5,00000101,53,00110101,58,00111010
114,01110010,34,00100010,148,10010100
120,01111000,75,01001011,195,11000011
33,00100001,6,00000110,39,00100111
24,00011000,64,01000000,88,01011000
5,00000101,47,00101111,52,00110100
98,01100010,31,00011111,129,10000001
91,01011011,14,00001110,105,01101001
8,00001000,126,01111110,134,10000110
19,00010011,116,01110100,135,10000111
87,01010111,103,01100111,190,10111110
118,01110110,4,00000100,122,01111010
24,00011000,12,00001100,36,00100100
73,01001001,77,01001101,150,10010110
19,00010011,127,01111111,146,10010010
107,01101011,37,00100101,144,10010000
87,01010111,13,00001101,100,01100100
18,00010010,63,00111111,81,01010001
108,01101100,77,01001101,185,10111001
113,01110001,58,00111010,171,10101011
14,00001110,42,00101010,56,00111000
15,00001111,1,00000001,16,00010000
54,00110110,77,01001101,131,10000011
47,00101111,51,00110011,98,01100010
35,00100011,56,00111000,91,01011011
65,01000001,14,00001110,79,01001111
7,00000111,12,00001100,19,00010011
30,00011110,116,01110100,146,10010010
31,00011111,125,01111101,156,10011100
16,00010000,69,01000101,85,01010101
107,01101011,41,00101001,148,10010100
5,00000101,24,00011000,29,00011101
32,00100000,11,00001011,43,00101011
52,00110100,124,01111100,176,10110000
37,00100101,103,01100111,140,10001100
113,01110001,92,01011100,205,11001101
34,00100010,29,00011101,63,00111111
117,01110101,71,01000111,188,10111100
60,00111100,95,01011111,155,10011011
35,00100011,44,00101100,79,01001111
70,01000110,2,00000010,72,01001000
12,00001100,124,01111100,136,10001000
19,00010011,116,01110100,135,10000111
96,01100000,101,01100101,197,11000101
104,01101000,83,01010011,187,10111011
72,01001000,55,00110111,127,01111111
16,00010000,101,01100101,117,01110101
98,01100010,81,01010001,179,10110011
57,00111001,125,01111101,182,10110110
109,01101101,98,01100010,207,11001111
105,01101001,72,01001000,177,10110001
37,00100101,95,01011111,132,10000100
51,00110011,67,01000011,118,01110110
49,00110001,24,00011000,73,01001001
73,01001001,93,01011101,166,10100110
6,00000110,59,00111011,65,01000001
109,01101101,35,00100011,144,10010000
13,00001101,17,00010001,30,00011110
30,00011110,82,01010010,112,01110000
81,01010001,24,00011000,105,01101001
43,00101011,20,00010100,63,00111111
79,01001111,100,01100100,179,10110011
82,01010010,5,00000101,87,01010111
85,01010101,127,01111111,212,11010100
113,01110001,53,00110101,166,10100110
95,01011111,81,01010001,176,10110000
2,00000010,124,01111100,126,01111110
41,00101001,54,00110110,95,01011111
25,00011001,19,00010011,44,00101100
77,01001101,92,01011100,169,10101001
81,01010001,113,01110001,194,11000010
85,01010101,69,01000101,154,10011010
16,00010000,57,00111001,73,01001001
71,01000111,81,01010001,152,10011000
99,01100011,47,00101111,146,10010010
90,01011010,77,01001101,167,10100111
21,00010101,6,00000110,27,00011011
6,00000110,58,00111010,64,01000000
20,00010100,66,01000010,86,01010110
67,01000011,113,01110001,180,10110100
64,01000000,125,01111101,189,10111101
34,00100010,100,01100100,134,10000110
37,00100101,47,00101111,84,01010100
9,00001001,60,00111100,69,01000101
14,00001110,61,00111101,75,01001011
60,00111100,14,00001110,74,01001010
120,01111000,108,01101100,228,11100100
57,00111001,96,01100000,153,10011001
28,00011100,31,00011111,59,00111011
93,01011101,62,00111110,155,10011011
111,01101111,96,01100000,207,11001111
114,01110010,98,01100010,212,11010100
81,01010001,16,00010000,97,01100001
29,00011101,95,01011111,124,01111100
88,01011000,75,01001011,163,10100011
116,01110100,44,00101100,160,10100000
53,00110101,22,00010110,75,01001011
5,00000101,53,00110101,58,00111010
9,00001001,104,01101000,113,01110001
84,01010100,121,01111001,205,11001101
87,01010111,63,00111111,150,10010110
53,00110101,120,01111000,173,10101101
67,01000011,39,00100111,106,01101010
62,00111110,21,00010101,83,01010011
115,01110011,58,00111010,173,10101101
120,01111000,11,00001011,131,10000011
36,00100100,10,00001010,46,00101110
56,00111000,70,01000110,126,01111110
123,01111011,116,01110100,239,11101111
106,01101010,54,00110110,160,10100000
57,00111001,37,00100101,94,01011110
71,01000111,8,00001000,79,01001111
96,01100000,17,00010001,113,01110001
44,00101100,40,00101000,84,01010100
121,01111001,60,00111100,181,10110101
90,01011010,96,01100000,186,10111010
52,00110100,6,00000110,58,00111010
21,00010101,121,01111001,142,10001110
112,01110000,73,01001001,185,10111001
99,01100011,10,00001010,109,01101101
103,01100111,39,00100111,142,10001110
105,01101001,51,00110011,156,10011100
50,00110010,94,01011110,144,10010000
86,01010110,84,01010100,170,10101010
13,00001101,8,00001000,21,00010101
42,00101010,76,01001100,118,01110110
90,01011010,25,00011001,115,01110011
89,01011001,116,01110100,205,11001101
54,00110110,88,01011000,142,10001110
51,00110011,90,01011010,141,10001101
13,00001101,39,00100111,52,00110100
114,01110010,58,00111010,172,10101100
79,01001111,33,00100001,112,01110000
5,00000101,114,01110010,119,01110111
25,00011001,38,00100110,63,00111111
118,01110110,89,01011001,207,11001111
55,00110111,65,01000001,120,01111000
81,01010001,12,00001100,93,01011101
43,00101011,93,01011101,136,10001000
32,00100000,83,01010011,115,01110011
21,00010101,12,00001100,33,00100001
109,01101101,64,01000000,173,10101101
17,00010001,5,00000101,22,00010110
9,00001001,126,01111110,135,10000111
100,01100100,10,00001010,110,01101110
66,01000010,72,01001000,138,10001010
95,01011111,23,00010111,118,01110110
66,01000010,125,01111101,191,10111111
2,00000010,106,01101010,108,01101100
89,01011001,45,00101101,134,10000110
29,00011101,39,00100111,68,01000100
61,00111101,62,00111110,123,01111011
80,01010000,84,01010100,164,10100100
23,00010111,105,01101001,128,10000000
37,00100101,97,01100001,134,10000110
100,01100100,93,01011101,193,11000001
82,01010010,91,01011011,173,10101101
96,01100000,115,01110011,211,11010011
82,01010010,16,00010000,98,01100010
0,00000000,11,00001011,11,00001011
31,00011111,64,01000000,95,01011111
42,00101010,7,00000111,49,00110001
84,01010100,114,01110010,198,11000110
2,00000010,125,01111101,127,01111111
109,01101101,51,00110011,160,10100000
55,00110111,26,00011010,81,01010001
39,00100111,110,01101110,149,10010101
104,01101000,126,01111110,230,11100110
29,00011101,82,01010010,111,01101111
41,00101001,25,00011001,66,01000010
44,00101100,2,00000010,46,00101110
78,01001110,42,00101010,120,01111000
2,00000010,98,01100010,100,01100100
19,00010011,118,01110110,137,10001001
43,00101011,9,00001001,52,00110100
76,01001100,106,01101010,182,10110110
1,00000001,26,00011010,27,00011011
64,01000000,25,00011001,89,01011001
125,01111101,68,01000100,193,11000001
81,01010001,40,00101000,121,01111001
6,00000110,7,00000111,13,00001101
57,00111001,44,00101100,101,01100101
49,00110001,74,01001010,123,01111011
11,00001011,103,01100111,114,01110010
81,01010001,23,00010111,104,01101000
30,00011110,41,00101001,71,01000111
61,00111101,8,00001000,69,01000101
82,01010010,89,01011001,171,10101011
29,00011101,121,01111001,150,10010110
33,00100001,67,01000011,100,01100100
24,00011000,0,00000000,24,00011000
45,00101101,73,01001001,118,01110110
72,01001000,29,00011101,101,01100101
14,00001110,35,00100011,49,00110001
86,01010110,2,00000010,88,01011000
19,00010011,27,00011011,46,00101110
26,00011010,21,00010101,47,00101111
63,00111111,50,00110010,113,01110001
8,00001000,62,00111110,70,01000110
93,01011101,103,01100111,196,11000100
81,01010001,74,01001010,155,10011011
40,00101000,13,00001101,53,00110101
17,00010001,121,01111001,138,10001010
79,01001111,55,00110111,134,10000110
84,01010100,98,01100010,182,10110110
92,01011100,35,00100011,127,01111111
10,00001010,126,01111110,136,10001000
71,01000111,47,00101111,118,01110110
77,01001101,121,01111001,198,11000110
56,00111000,117,01110101,173,10101101
2,00000010,71,01000111,73,01001001
121,01111001,87,01010111,208,11010000
55,00110111,25,00011001,80,01010000
29,00011101,94,01011110,123,01111011
95,01011111,91,01011011,186,10111010
97,01100001,21,00010101,118,01110110
65,01000001,1,00000001,66,01000010
121,01111001,11,00001011,132,10000100
111,01101111,75,01001011,186,10111010
106,01101010,24,00011000,130,10000010
65,01000001,109,01101101,174,10101110
61,00111101,16,00010000,77,01001101
14,00001110,69,01000101,83,01010011
83,01010011,13,00001101,96,01100000
17,00010001,37,00100101,54,00110110
107,01101011,27,00011011,134,10000110
45,00101101,73,01001001,118,01110110
49,00110001,37,00100101,86,01010110
61,00111101,16,00010000,77,01001101
49,00110001,74,01001010,123,01111011
25,00011001,124,01111100,149,10010101
24,00011000,101,01100101,125,01111101
5,00000101,58,00111010,63,00111111
0,00000000,74,01001010,74,01001010
45,00101101,39,00100111,84,01010100
50,00110010,12,00001100,62,00111110
86,01010110,22,00010110,108,01101100
57,00111001,64,01000000,121,01111001
98,01100010,5,00000101,103,01100111
1,00000001,67,01000011,68,01000100
78,01001110,126,01111110,204,11001100
88,01011000,50,00110010,138,10001010
45,00101101,99,01100011,144,10010000
74,01001010,92,01011100,166,10100110
84,01010100,111,01101111,195,11000011
61,00111101,51,00110011,112,01110000
16,00010000,26,00011010,42,00101010
5,00000101,29,00011101,34,00100010
84,01010100,39,00100111,123,01111011
118,01110110,123,01111011,241,11110001
103,01100111,80,01010000,183,10110111
52,00110100,20,00010100,72,01001000
57,00111001,123,01111011,180,10110100
74,01001010,55,00110111,129,10000001
20,00010100,75,01001011,95,01011111
12,00001100,113,01110001,125,01111101
85,01010101,17,00010001,102,01100110
61,00111101,65,01000001,126,01111110
79,01001111,80,01010000,159,10011111
101,01100101,28,00011100,129,10000001
112,01110000,98,01100010,210,11010010
91,01011011,42,00101010,133,10000101
88,01011000,111,01101111,199,11000111
83,01010011,78,01001110,161,10100001
119,01110111,68,01000100,187,10111011
113,01110001,54,00110110,167,10100111
46,00101110,67,01000011,113,01110001
86,01010110,80,01010000,166,10100110
78,01001110,113,01110001,191,10111111
67,01000011,47,00101111,114,01110010
81,01010001,86,01010110,167,10100111
37,00100101,78,01001110,115,01110011
41,00101001,87,01010111,128,10000000
120,01111000,112,01110000,232,11101000
97,01100001,115,01110011,212,11010100
4,00000100,3,00000011,7,00000111
42,00101010,34,00100010,76,01001100
120,01111000,100,01100100,220,11011100
92,01011100,55,00110111,147,10010011
12,00001100,103,01100111,115,01110011
76,01001100,70,01000110,146,10010010
93,01011101,72,01001000,165,10100101
25,00011001,25,00011001,50,00110010
22,00010110,5,00000101,27,00011011
115,01110011,51,00110011,166,10100110
8,00001000,125,01111101,133,10000101
86,01010110,60,00111100,146,10010010
116,01110100,10,00001010,126,01111110
23,00010111,85,01010101,108,01101100
123,01111011,55,00110111,178,10110010
113,01110001,43,00101011,156,10011100
22,00010110,44,00101100,66,01000010
108,01101100,8,00001000,116,01110100
81,01010001,111,01101111,192,11000000
27,00011011,83,01010011,110,01101110
89,01011001,49,00110001,138,10001010
105,01101001,110,01101110,215,11010111
126,01111110,59,00111011,185,10111001
84,01010100,11,00001011,95,01011111
96,01100000,1,00000001,97,01100001
78,01001110,1,00000001,79,01001111
101,01100101,101,01100101,202,11001010
105,01101001,51,00110011,156,10011100
122,01111010,41,00101001,163,10100011
112,01110000,50,00110010,162,10100010
25,00011001,106,01101010,131,10000011
125,01111101,96,01100000,221,11011101
123,01111011,86,01010110,209,11010001
119,01110111,80,01010000,199,11000111
19,00010011,65,01000001,84,01010100
12,00001100,3,00000011,15,00001111
53,00110101,26,00011010,79,01001111
112,01110000,10,00001010,122,01111010
48,00110000,101,01100101,149,10010101
51,00110011,73,01001001,124,01111100
78,01001110,118,01110110,196,11000100
96,01100000,127,01111111,223,11011111
80,01010000,112,01110000,192,11000000
7,00000111,44,00101100,51,00110011
49,00110001,42,00101010,91,01011011
27,00011011,33,00100001,60,00111100
93,01011101,19,00010011,112,01110000
32,00100000,13,00001101,45,00101101
30,00011110,72,01001000,102,01100110
58,00111010,7,00000111,65,01000001
66,01000010,47,00101111,113,01110001
91,01011011,23,00010111,114,01110010
88,01011000,115,01110011,203,11001011
119,01110111,55,00110111,174,10101110
30,00011110,28,00011100,58,00111010
68,01000100,36,00100100,104,01101000
39,00100111,92,01011100,131,10000011
40,00101000,127,01111111,167,10100111
124,01111100,50,00110010,174,10101110
58,00111010,91,01011011,149,10010101
42,00101010,50,00110010,92,01011100
55,00110111,25,00011001,80,01010000
66,01000010,89,01011001,155,10011011
19,00010011,73,01001001,92,01011100
81,01010001,43,00101011,124,01111100
16,00010000,117,01110101,133,10000101
89,01011001,18,00010010,107,01101011
54,00110110,6,00000110,60,00111100
59,00111011,77,01001101,136,10001000
0,00000000,32,00100000,32,00100000
127,01111111,62,00111110,189,10111101
107,01101011,56,00111000,163,10100011
123,01111011,117,01110101,240,11110000
126,01111110,53,00110101,179,10110011
113,01110001,37,00100101,150,10010110
86,01010110,123,01111011,209,11010001
104,01101000,39,00100111,143,10001111
4,00000100,66,01000010,70,01000110
119,01110111,9,00001001,128,10000000
76,01001100,92,01011100,168,10101000
37,00100101,67,01000011,104,01101000
82,01010010,19,00010011,101,01100101
93,01011101,65,01000001,158,10011110
117,01110101,48,00110000,165,10100101
9,00001001,79,01001111,88,01011000
76,01001100,65,01000001,141,10001101
42,00101010,103,01100111,145,10010001
51,00110011,20,00010100,71,01000111
16,00010000,102,01100110,118,01110110
6,00000110,80,01010000,86,01010110
80,01010000,42,00101010,122,01111010
97,01100001,6,00000110,103,01100111
26,00011010,88,01011000,114,01110010
58,00111010,90,01011010,148,10010100
89,01011001,17,00010001,106,01101010
67,01000011,58,00111010,125,01111101
49,00110001,30,00011110,79,01001111
11,00001011,20,00010100,31,00011111
37,00100101,103,01100111,140,10001100
58,00111010,17,00010001,75,01001011
123,01111011,102,01100110,225,11100001
87,01010111,90,01011010,177,10110001
113,01110001,127,01111111,240,11110000
7,00000111,64,01000000,71,01000111
126,01111110,13,00001101,139,10001011
76,01001100,44,00101100,120,01111000
21,00010101,100,01100100,121,01111001
24,00011000,124,01111100,148,10010100
45,00101101,125,01111101,170,10101010
68,01000100,60,00111100,128,10000000
36,00100100,41,00101001,77,01001101
112,01110000,58,00111010,170,10101010
26,00011010,33,00100001,59,00111011
112,01110000,75,01001011,187,10111011
54,00110110,16,00010000,70,01000110
103,01100111,75,01001011,178,10110010
106,01101010,109,01101101,215,11010111
7,00000111,93,01011101,100,01100100
11,00001011,32,00100000,43,00101011
56,00111000,60,00111100,116,01110100
0,00000000,24,00011000,24,00011000
100,01100100,47,00101111,147,10010011
94,01011110,122,01111010,216,11011000
76,01001100,92,01011100,168,10101000
102,01100110,58,00111010,160,10100000
114,01110010,95,01011111,209,11010001
3,00000011,74,01001010,77,01001101
72,01001000,28,00011100,100,01100100
89,01011001,110,01101110,199,11000111
75,01001011,58,00111010,133,10000101
122,01111010,68,01000100,190,10111110
93,01011101,27,00011011,120,01111000
16,00010000,38,00100110,54,00110110
7,00000111,26,00011010,33,00100001
49,00110001,91,01011011,140,10001100
58,00111010,49,00110001,107,01101011
92,01011100,79,01001111,171,10101011
82,01010010,30,00011110,112,01110000
51,00110011,83,01010011,134,10000110
96,01100000,57,00111001,153,10011001
27,00011011,119,01110111,146,10010010
125,01111101,126,01111110,251,11111011
72,01001000,4,00000100,76,01001100
27,00011011,39,00100111,66,01000010
65,01000001,17,00010001,82,01010010
73,01001001,53,00110101,126,01111110
98,01100010,86,01010110,184,10111000
116,01110100,64,01000000,180,10110100
92,01011100,96,01100000,188,10111100
35,00100011,34,00100010,69,01000101
99,01100011,79,01001111,178,10110010
49,00110001,88,01011000,137,10001001
92,01011100,118,01110110,210,11010010
6,00000110,16,00010000,22,00010110
72,01001000,81,01010001,153,10011001
57,00111001,34,00100010,91,01011011
66,01000010,8,00001000,74,01001010
75,01001011,104,01101000,179,10110011
48,00110000,56,00111000,104,01101000
71,01000111,89,01011001,160,10100000
55,00110111,84,01010100,139,10001011
107,01101011,38,00100110,145,10010001
48,00110000,113,01110001,161,10100001
121,01111001,87,01010111,208,11010000
98,01100010,124,01111100,222,11011110
100,01100100,1,00000001,101,01100101
112,01110000,117,01110101,229,11100101
87,01010111,113,01110001,200,11001000
110,01101110,58,00111010,168,10101000
4,00000100,41,00101001,45,00101101
108,01101100,13,00001101,121,01111001
44,00101100,14,00001110,58,00111010
98,01100010,32,00100000,130,10000010
115,01110011,48,00110000,163,10100011
56,00111000,97,01100001,153,10011001
16,00010000,2,00000010,18,00010010
70,01000110,20,00010100,90,01011010
39,00100111,127,01111111,166,10100110
38,00100110,2,00000010,40,00101000
50,00110010,9,00001001,59,00111011
90,01011010,112,01110000,202,11001010
62,00111110,105,01101001,167,10100111
121,01111001,99,01100011,220,11011100
39,00100111,19,00010011,58,00111010
115,01110011,99,01100011,214,11010110
76,01001100,1,00000001,77,01001101
24,00011000,91,01011011,115,01110011
64,01000000,10,00001010,74,01001010
35,00100011,67,01000011,102,01100110
25,00011001,27,00011011,52,00110100
54,00110110,89,01011001,143,10001111
121,01111001,11,00001011,132,10000100
80,01010000,86,01010110,166,10100110
63,00111111,8,00001000,71,01000111
98,01100010,20,00010100,118,01110110
56,00111000,64,01000000,120,01111000
93,01011101,59,00111011,152,10011000
95,01011111,101,01100101,196,11000100
27,00011011,38,00100110,65,01000001
75,01001011,46,00101110,121,01111001
8,00001000,40,00101000,48,00110000
34,00100010,121,01111001,155,10011011
8,00001000,120,01111000,128,10000000
51,00110011,29,00011101,80,01010000
99,01100011,61,00111101,160,10100000
87,01010111,92,01011100,179,10110011
36,00100100,47,00101111,83,01010011
85,01010101,23,00010111,108,01101100
107,01101011,30,00011110,137,10001001
37,00100101,25,00011001,62,00111110
44,00101100,4,00000100,48,00110000
20,00010100,124,01111100,144,10010000
123,01111011,92,01011100,215,11010111
25,00011001,68,01000100,93,01011101
79,01001111,2,00000010,81,01010001
71,01000111,48,00110000,119,01110111
66,01000010,95,01011111,161,10100001
26,00011010,63,00111111,89,01011001
127,01111111,6,00000110,133,10000101
2,00000010,107,01101011,109,01101101
109,01101101,89,01011001,198,11000110
59,00111011,102,01100110,161,10100001
15,00001111,123,01111011,138,10001010
27,00011011,27,00011011,54,00110110
92,01011100,89,01011001,181,10110101
64,01000000,38,00100110,102,01100110
59,00111011,11,00001011,70,01000110
21,00010101,6,00000110,27,00011011
47,00101111,25,00011001,72,01001000
119,01110111,19,00010011,138,10001010
50,00110010,3,00000011,53,00110101
96,01100000,18,00010010,114,01110010
29,00011101,122,01111010,151,10010111
64,01000000,12,00001100,76,01001100
44,00101100,99,01100011,143,10001111
104,01101000,56,00111000,160,10100000
75,01001011,3,00000011,78,01001110
45,00101101,57,00111001,102,01100110
29,00011101,26,00011010,55,00110111
8,00001000,65,01000001,73,01001001
65,01000001,116,01110100,181,10110101
70,01000110,127,01111111,197,11000101
88,01011000,56,00111000,144,10010000
79,01001111,74,01001010,153,10011001
18,00010010,116,01110100,134,10000110
86,01010110,41,00101001,127,01111111
73,01001001,71,01000111,144,10010000
65,01000001,69,01000101,134,10000110
9,00001001,5,00000101,14,00001110
111,01101111,47,00101111,158,10011110
116,01110100,52,00110100,168,10101000
63,00111111,46,00101110,109,01101101
83,01010011,43,00101011,126,01111110
92,01011100,40,00101000,132,10000100
109,01101101,82,01010010,191,10111111
75,01001011,70,01000110,145,10010001
50,00110010,19,00010011,69,01000101
118,01110110,73,01001001,191,10111111
51,00110011,59,00111011,110,01101110
97,01100001,20,00010100,117,01110101
98,01100010,120,01111000,218,11011010
76,01001100,61,00111101,137,10001001
73,01001001,92,01011100,165,10100101
67,01000011,80,01010000,147,10010011
46,00101110,13,00001101,59,00111011
48,00110000,116,01110100,164,10100100
53,00110101,63,00111111,116,01110100
46,00101110,53,00110101,99,01100011
83,01010011,115,01110011,198,11000110
33,00100001,16,00010000,49,00110001
40,00101000,2,00000010,42,00101010
61,00111101,15,00001111,76,01001100
80,01010000,116,01110100,196,11000100
112,01110000,53,00110101,165,10100101
11,00001011,5,00000101,16,00010000
63,00111111,84,01010100,147,10010011
79,01001111,61,00111101,140,10001100
13,00001101,27,00011011,40,00101000
22,00010110,126,01111110,148,10010100
122,01111010,86,01010110,208,11010000
71,01000111,42,00101010,113,01110001
23,00010111,88,01011000,111,01101111
97,01100001,86,01010110,183,10110111
102,01100110,4,00000100,106,01101010
99,01100011,37,00100101,136,10001000
100,01100100,33,00100001,133,10000101
118,01110110,116,01110100,234,11101010
45,00101101,40,00101000,85,01010101
36,00100100,21,00010101,57,00111001
92,01011100,40,00101000,132,10000100
60,00111100,90,01011010,150,10010110
5,00000101,81,01010001,86,01010110
75,01001011,5,00000101,80,01010000
87,01010111,47,00101111,134,10000110
99,01100011,117,01110101,216,11011000
29,00011101,1,00000001,30,00011110
52,00110100,25,00011001,77,01001101
55,00110111,36,00100100,91,01011011
87,01010111,90,01011010,177,10110001
2,00000010,25,00011001,27,00011011
76,01001100,58,00111010,134,10000110
52,00110100,122,01111010,174,10101110
52,00110100,22,00010110,74,01001010
75,01001011,119,01110111,194,11000010
97,01100001,55,00110111,152,10011000
21,00010101,58,00111010,79,01001111
33,00100001,102,01100110,135,10000111
55,00110111,58,00111010,113,01110001
88,01011000,34,00100010,122,01111010
8,00001000,62,00111110,70,01000110
8,00001000,38,00100110,46,00101110
96,01100000,77,01001101,173,10101101
35,00100011,30,00011110,65,01000001
127,01111111,103,01100111,230,11100110
126,01111110,112,01110000,238,11101110
73,01001001,125,01111101,198,11000110
109,01101101,20,00010100,129,10000001
80,01010000,15,00001111,95,01011111
101,01100101,88,01011000,189,10111101
51,00110011,93,01011101,144,10010000
107,01101011,80,01010000,187,10111011
10,00001010,68,01000100,78,01001110
20,00010100,88,01011000,108,01101100
87,01010111,45,00101101,132,10000100
100,01100100,117,01110101,217,11011001
126,01111110,29,00011101,155,10011011
43,00101011,51,00110011,94,01011110
21,00010101,74,01001010,95,01011111
106,01101010,121,01111001,227,11100011
2,00000010,69,01000101,71,01000111
109,01101101,72,01001000,181,10110101
22,00010110,98,01100010,120,01111000
100,01100100,45,00101101,145,10010001
96,01100000,43,00101011,139,10001011
122,01111010,67,01000011,189,10111101
30,00011110,42,00101010,72,01001000
44,00101100,118,01110110,162,10100010
33,00100001,47,00101111,80,01010000
99,01100011,49,00110001,148,10010100
33,00100001,100,01100100,133,10000101
40,00101000,9,00001001,49,00110001
1,00000001,125,01111101,126,01111110
47,00101111,20,00010100,67,01000011
6,00000110,75,01001011,81,01010001
123,01111011,35,00100011,158,10011110
36,00100100,1,00000001,37,00100101
43,00101011,69,01000101,112,01110000
119,01110111,62,00111110,181,10110101
83,01010011,101,01100101,184,10111000
91,01011011,102,01100110,193,11000001
123,01111011,2,00000010,125,01111101
25,00011001,65,01000001,90,01011010
65,01000001,120,01111000,185,10111001
13,00001101,76,01001100,89,01011001
55,00110111,121,01111001,176,10110000
11,00001011,19,00010011,30,00011110
83,01010011,0,00000000,83,01010011
126,01111110,49,00110001,175,10101111
43,00101011,16,00010000,59,00111011
33,00100001,105,01101001,138,10001010
83,01010011,25,00011001,108,01101100
67,01000011,66,01000010,133,10000101
6,00000110,51,00110011,57,00111001
73,01001001,0,00000000,73,01001001
79,01001111,111,01101111,190,10111110
103,01100111,70,01000110,173,10101101
30,00011110,19,00010011,49,00110001
18,00010010,102,01100110,120,01111000
65,01000001,85,01010101,150,10010110
30,00011110,104,01101000,134,10000110
34,00100010,17,00010001,51,00110011
104,01101000,0,00000000,104,01101000
85,01010101,29,00011101,114,01110010
50,00110010,0,00000000,50,00110010
29,00011101,99,01100011,128,10000000
0,00000000,61,00111101,61,00111101
125,01111101,102,01100110,227,11100011
78,01001110,120,01111000,198,11000110
99,01100011,52,00110100,151,10010111
86,01010110,20,00010100,106,01101010
48,00110000,29,00011101,77,01001101
124,01111100,14,00001110,138,10001010
50,00110010,103,01100111,153,10011001
84,01010100,23,00010111,107,01101011
35,00100011,76,01001100,111,01101111
43,00101011,105,01101001,148,10010100
53,00110101,29,00011101,82,01010010
2,00000010,49,00110001,51,00110011
70,01000110,56,00111000,126,01111110
49,00110001,127,01111111,176,10110000
102,01100110,61,00111101,163,10100011
45,00101101,51,00110011,96,01100000
116,01110100,30,00011110,146,10010010
51,00110011,121,01111001,172,10101100
38,00100110,4,00000100,42,00101010
33,00100001,124,01111100,157,10011101
127,01111111,111,01101111,238,11101110
28,00011100,62,00111110,90,01011010
88,01011000,41,00101001,129,10000001
55,00110111,112,01110000,167,10100111
67,01000011,17,00010001,84,01010100
45,00101101,5,00000101,50,00110010
97,01100001,74,01001010,171,10101011
0,00000000,33,00100001,33,00100001
82,01010010,66,01000010,148,10010100
109,01101101,3,00000011,112,01110000
127,01111111,19,00010011,146,10010010
91,01011011,114,01110010,205,11001101
106,01101010,18,00010010,124,01111100
40,00101000,91,01011011,131,10000011
58,00111010,121,01111001,179,10110011
4,00000100,12,00001100,16,00010000
17,00010001,21,00010101,38,00100110
51,00110011,94,01011110,145,10010001
118,01110110,102,01100110,220,11011100
105,01101001,10,00001010,115,01110011
99,01100011,57,00111001,156,10011100
41,00101001,60,00111100,101,01100101
20,00010100,85,01010101,105,01101001
72,01001000,50,00110010,122,01111010
121,01111001,17,00010001,138,10001010
5,00000101,14,00001110,19,00010011
36,00100100,81,01010001,117,01110101
101,01100101,23,00010111,124,01111100
55,00110111,22,00010110,77,01001101
93,01011101,17,00010001,110,01101110
83,01010011,7,00000111,90,01011010
1,00000001,47,00101111,48,00110000
86,01010110,9,00001001,95,01011111
8,00001000,83,01010011,91,01011011
63,00111111,108,01101100,171,10101011
25,00011001,51,00110011,76,01001100
85,01010101,26,00011010,111,01101111
127,01111111,11,00001011,138,10001010
105,01101001,14,00001110,119,01110111
29,00011101,50,00110010,79,01001111
121,01111001,118,01110110,239,11101111
44,00101100,122,01111010,166,10100110
82,01010010,94,01011110,176,10110000
103,01100111,97,01100001,200,11001000
20,00010100,34,00100010,54,00110110
34,00100010,118,01110110,152,10011000
30,00011110,47,00101111,77,01001101
61,00111101,115,01110011,176,10110000
122,01111010,85,01010101,207,11001111
100,01100100,5,00000101,105,01101001
71,01000111,64,01000000,135,10000111
97,01100001,44,00101100,141,10001101
8,00001000,68,01000100,76,01001100
41,00101001,21,00010101,62,00111110
18,00010010,125,01111101,143,10001111
107,01101011,97,01100001,204,11001100
35,00100011,23,00010111,58,00111010
95,01011111,85,01010101,180,10110100
42,00101010,122,01111010,164,10100100
45,00101101,80,01010000,125,01111101
60,00111100,88,01011000,148,10010100
94,01011110,55,00110111,149,10010101
76,01001100,50,00110010,126,01111110
68,01000100,116,01110100,184,10111000
25,00011001,23,00010111,48,00110000
13,00001101,4,00000100,17,00010001
91,01011011,48,00110000,139,10001011
54,00110110,47,00101111,101,01100101
42,00101010,51,00110011,93,01011101
50,00110010,116,01110100,166,10100110
63,00111111,53,00110101,116,01110100
73,01001001,24,00011000,97,01100001
44,00101100,39,00100111,83,01010011
71,01000111,121,01111001,192,11000000
118,01110110,39,00100111,157,10011101
2,00000010,22,00010110,24,00011000
19,00010011,85,01010101,104,01101000
84,01010100,80,01010000,164,10100100
15,00001111,98,01100010,113,01110001
66,01000010,101,01100101,167,10100111
76,01001100,58,00111010,134,10000110
23,00010111,12,00001100,35,00100011
35,00100011,103,01100111,138,10001010
109,01101101,62,00111110,171,10101011
76,01001100,35,00100011,111,01101111
42,00101010,59,00111011,101,01100101
117,01110101,91,01011011,208,11010000
35,00100011,57,00111001,92,01011100
84,01010100,50,00110010,134,10000110
42,00101010,47,00101111,89,01011001
92,01011100,108,01101100,200,11001000
73,01001001,44,00101100,117,01110101
28,00011100,43,00101011,71,01000111
58,00111010,93,01011101,151,10010111
44,00101100,86,01010110,130,10000010
92,01011100,44,00101100,136,10001000
103,01100111,51,00110011,154,10011010
28,00011100,35,00100011,63,00111111
6,00000110,106,01101010,112,01110000
102,01100110,41,00101001,143,10001111
38,00100110,107,01101011,145,10010001
44,00101100,114,01110010,158,10011110
51,00110011,36,00100100,87,01010111
0,00000000,64,01000000,64,01000000
111,01101111,57,00111001,168,10101000
15,00001111,4,00000100,19,00010011
47,00101111,58,00111010,105,01101001
94,01011110,109,01101101,203,11001011
31,00011111,19,00010011,50,00110010
50,00110010,97,01100001,147,10010011
83,01010011,21,00010101,104,01101000
121,01111001,94,01011110,215,11010111
93,01011101,126,01111110,219,11011011
90,01011010,96,01100000,186,10111010
80,01010000,15,00001111,95,01011111
100,01100100,15,00001111,115,01110011
6,00000110,30,00011110,36,00100100
59,00111011,121,01111001,180,10110100
47,00101111,20,00010100,67,01000011
93,01011101,104,01101000,197,11000101
21,00010101,60,00111100,81,01010001
31,00011111,67,01000011,98,01100010
3,00000011,125,01111101,128,10000000
4,00000100,109,01101101,113,01110001
20,00010100,61,00111101,81,01010001
66,01000010,11,00001011,77,01001101
12,00001100,37,00100101,49,00110001
8,00001000,86,01010110,94,01011110
43,00101011,40,00101000,83,01010011
55,00110111,12,00001100,67,01000011
127,01111111,90,01011010,217,11011001
90,01011010,116,01110100,206,11001110
81,01010001,39,00100111,120,01111000
55,00110111,126,01111110,181,10110101
3,00000011,5,00000101,8,00001000
23,00010111,48,00110000,71,01000111
45,00101101,103,01100111,148,10010100
41,00101001,42,00101010,83,01010011
51,00110011,46,00101110,97,01100001
53,00110101,100,01100100,153,10011001
74,01001010,116,01110100,190,10111110
68,01000100,87,01010111,155,10011011
80,01010000,118,01110110,198,11000110
61,00111101,13,00001101,74,01001010
44,00101100,47,00101111,91,01011011
3,00000011,90,01011010,93,01011101
34,00100010,112,01110000,146,10010010
115,01110011,106,01101010,221,11011101
44,00101100,2,00000010,46,00101110
77,01001101,86,01010110,163,10100011
12,00001100,9,00001001,21,00010101
80,01010000,3,00000011,83,01010011
64,01000000,57,00111001,121,01111001
12,00001100,34,00100010,46,00101110
60,00111100,0,00000000,60,00111100
21,00010101,28,00011100,49,00110001
119,01110111,65,01000001,184,10111000
26,00011010,64,01000000,90,01011010
85,01010101,22,00010110,107,01101011
115,01110011,34,00100010,149,10010101
106,01101010,97,01100001,203,11001011
89,01011001,71,01000111,160,10100000
11,00001011,109,01101101,120,01111000
85,01010101,118,01110110,203,11001011
86,01010110,7,00000111,93,01011101
33,00100001,27,00011011,60,00111100
57,00111001,71,01000111,128,10000000
102,01100110,70,01000110,172,10101100
104,01101000,25,00011001,129,10000001
3,00000011,8,00001000,11,00001011
45,00101101,78,01001110,123,01111011
82,01010010,59,00111011,141,10001101
71,01000111,63,00111111,134,10000110
18,00010010,19,00010011,37,00100101
38,00100110,125,01111101,163,10100011
30,00011110,14,00001110,44,00101100
119,01110111,15,00001111,134,10000110
68,01000100,94,01011110,162,10100010
98,01100010,112,01110000,210,11010010
11,00001011,81,01010001,92,01011100
111,01101111,117,01110101,228,11100100
73,01001001,101,01100101,174,10101110
33,00100001,77,01001101,110,01101110
37,00100101,81,01010001,118,01110110
36,00100100,29,00011101,65,01000001
50,00110010,43,00101011,93,01011101
126,01111110,24,00011000,150,10010110
118,01110110,58,00111010,176,10110000
103,01100111,1,00000001,104,01101000
115,01110011,99,01100011,214,11010110
102,01100110,55,00110111,157,10011101
60,00111100,113,01110001,173,10101101
127,01111111,48,00110000,175,10101111
43,00101011,106,01101010,149,10010101
50,00110010,97,01100001,147,10010011
34,00100010,102,01100110,136,10001000
95,01011111,123,01111011,218,11011010
70,01000110,92,01011100,162,10100010
44,00101100,115,01110011,159,10011111
77,01001101,116,01110100,193,11000001
45,00101101,104,01101000,149,10010101
85,01010101,57,00111001,142,10001110
84,01010100,82,01010010,166,10100110
63,00111111,87,01010111,150,10010110
4,00000100,91,01011011,95,01011111
24,00011000,12,00001100,36,00100100
29,00011101,92,01011100,121,01111001
22,00010110,73,01001001,95,01011111
101,01100101,18,00010010,119,01110111
34,00100010,15,00001111,49,00110001
90,01011010,11,00001011,101,01100101
17,00010001,28,00011100,45,00101101
45,00101101,19,00010011,64,01000000
80,01010000,18,00010010,98,01100010
116,01110100,115,01110011,231,11100111
120,01111000,88,01011000,208,11010000
5,00000101,58,00111010,63,00111111
81,01010001,58,00111010,139,10001011
46,00101110,125,01111101,171,10101011
27,00011011,80,01010000,107,01101011
85,01010101,94,01011110,179,10110011
119,01110111,60,00111100,179,10110011
108,01101100,1,00000001,109,01101101
3,00000011,104,01101000,107,01101011
48,00110000,63,00111111,111,01101111
72,01001000,92,01011100,164,10100100
14,00001110,110,01101110,124,01111100
101,01100101,80,01010000,181,10110101
9,00001001,54,00110110,63,00111111
1,00000001,85,01010101,86,01010110
7,00000111,8,00001000,15,00001111
54,00110110,25,00011001,79,01001111
89,01011001,34,00100010,123,01111011
73,01001001,59,00111011,132,10000100
99,01100011,24,00011000,123,01111011
110,01101110,25,00011001,135,10000111
61,00111101,65,01000001,126,01111110
6,00000110,81,01010001,87,01010111
100,01100100,90,01011010,190,10111110
102,01100110,124,01111100,226,11100010
48,00110000,75,01001011,123,01111011
70,01000110,2,00000010,72,01001000
11,00001011,99,01100011,110,01101110
21,00010101,109,01101101,130,10000010
76,01001100,113,01110001,189,10111101
82,01010010,44,00101100,126,01111110
62,00111110,87,01010111,149,10010101
40,00101000,69,01000101,109,01101101
87,01010111,74,01001010,161,10100001
66,01000010,45,00101101,111,01101111
8,00001000,58,00111010,66,01000010
94,01011110,79,01001111,173,10101101
62,00111110,107,01101011,169,10101001
103,01100111,54,00110110,157,10011101
60,00111100,88,01011000,148,10010100
64,01000000,51,00110011,115,01110011
97,01100001,85,01010101,182,10110110
46,00101110,48,00110000,94,01011110
48,00110000,106,01101010,154,10011010
117,01110101,106,01101010,223,11011111
39,00100111,35,00100011,74,01001010
93,01011101,102,01100110,195,11000011
108,01101100,85,01010101,193,11000001
25,00011001,37,00100101,62,00111110
12,00001100,57,00111001,69,01000101
21,00010101,24,00011000,45,00101101
23,00010111,34,00100010,57,00111001
117,01110101,45,00101101,162,10100010
95,01011111,108,01101100,203,11001011
126,01111110,117,01110101,243,11110011
68,01000100,63,00111111,131,10000011
125,01111101,97,01100001,222,11011110
70,01000110,110,01101110,180,10110100
31,00011111,26,00011010,57,00111001
56,00111000,124,01111100,180,10110100
84,01010100,96,01100000,180,10110100
70,01000110,3,00000011,73,01001001
80,01010000,50,00110010,130,10000010
110,01101110,120,01111000,230,11100110
126,01111110,126,01111110,252,11111100
63,00111111,120,01111000,183,10110111
88,01011000,6,00000110,94,01011110
30,00011110,1,00000001,31,00011111
97,01100001,107,01101011,204,11001100
127,01111111,56,00111000,183,10110111
6,00000110,24,00011000,30,00011110
32,00100000,71,01000111,103,01100111
106,01101010,2,00000010,108,01101100
74,01001010,49,00110001,123,01111011
65,01000001,98,01100010,163,10100011
66,01000010,95,01011111,161,10100001
30,00011110,59,00111011,89,01011001
34,00100010,46,00101110,80,01010000
93,01011101,74,01001010,167,10100111
61,00111101,76,01001100,137,10001001
25,00011001,84,01010100,109,01101101
54,00110110,8,00001000,62,00111110
72,01001000,30,00011110,102,01100110
123,01111011,102,01100110,225,11100001
73,01001001,101,01100101,174,10101110
120,01111000,83,01010011,203,11001011
15,00001111,84,01010100,99,01100011
79,01001111,121,01111001,200,11001000
14,00001110,127,01111111,141,10001101
114,01110010,19,00010011,133,10000101
109,01101101,114,01110010,223,11011111
50,00110010,24,00011000,74,01001010
0,00000000,121,01111001,121,01111001
87,01010111,40,00101000,127,01111111
121,01111001,52,00110100,173,10101101
26,00011010,91,01011011,117,01110101
42,00101010,104,01101000,146,10010010
99,01100011,36,00100100,135,10000111
71,01000111,63,00111111,134,10000110
75,01001011,59,00111011,134,10000110
100,01100100,29,00011101,129,10000001
58,00111010,85,01010101,143,10001111
16,00010000,107,01101011,123,01111011
70,01000110,20,00010100,90,01011010
114,01110010,24,00011000,138,10001010
35,00100011,113,01110001,148,10010100
80,01010000,42,00101010,122,01111010
24,00011000,47,00101111,71,01000111
27,00011011,5,00000101,32,00100000
95,01011111,25,00011001,120,01111000
71,01000111,96,01100000,167,10100111
127,01111111,108,01101100,235,11101011
25,00011001,22,00010110,47,00101111
15,00001111,100,01100100,115,01110011
47,00101111,15,00001111,62,00111110
117,01110101,47,00101111,164,10100100
42,00101010,50,00110010,92,01011100
107,01101011,88,01011000,195,11000011
110,01101110,13,00001101,123,01111011
23,00010111,105,01101001,128,10000000
57,00111001,49,00110001,106,01101010
108,01101100,52,00110100,160,10100000
106,01101010,82,01010010,188,10111100
17,00010001,106,01101010,123,01111011
8,00001000,21,00010101,29,00011101
100,01100100,13,00001101,113,01110001
112,01110000,103,01100111,215,11010111
99,01100011,80,01010000,179,10110011
37,00100101,56,00111000,93,01011101
77,01001101,33,00100001,110,01101110
75,01001011,64,01000000,139,10001011
14,00001110,43,00101011,57,00111001
24,00011000,91,01011011,115,01110011
20,00010100,30,00011110,50,00110010
14,00001110,44,00101100,58,00111010
94,01011110,127,01111111,221,11011101
16,00010000,127,01111111,143,10001111
126,01111110,0,00000000,126,01111110
123,01111011,115,01110011,238,11101110
48,00110000,43,00101011,91,01011011
127,01111111,4,00000100,131,10000011
68,01000100,18,00010010,86,01010110
35,00100011,18,00010010,53,00110101
1,00000001,59,00111011,60,00111100
33,00100001,44,00101100,77,01001101
84,01010100,91,01011011,175,10101111
116,01110100,41,00101001,157,10011101
75,01001011,32,00100000,107,01101011
39,00100111,7,00000111,46,00101110
115,01110011,53,00110101,168,10101000
41,00101001,25,00011001,66,01000010
62,00111110,85,01010101,147,10010011
54,00110110,41,00101001,95,01011111
32,00100000,110,01101110,142,10001110
9,00001001,127,01111111,136,10001000
109,01101101,41,00101001,150,10010110
106,01101010,71,01000111,177,10110001
57,00111001,49,00110001,106,01101010
108,01101100,79,01001111,187,10111011
32,00100000,55,00110111,87,01010111
88,01011000,14,00001110,102,01100110
84,01010100,24,00011000,108,01101100
86,01010110,98,01100010,184,10111000
54,00110110,95,01011111,149,10010101
2,00000010,114,01110010,116,01110100
50,00110010,56,00111000,106,01101010
11,00001011,51,00110011,62,00111110
23,00010111,43,00101011,66,01000010
59,00111011,56,00111000,115,01110011
3,00000011,71,01000111,74,01001010
9,00001001,10,00001010,19,00010011
94,01011110,1,00000001,95,01011111
20,00010100,82,01010010,102,01100110
126,01111110,45,00101101,171,10101011
37,00100101,23,00010111,60,00111100
62,00111110,120,01111000,182,10110110
44,00101100,104,01101000,148,10010100
57,00111001,90,01011010,147,10010011
44,00101100,125,01111101,169,10101001
69,01000101,45,00101101,114,01110010
20,00010100,49,00110001,69,01000101
70,01000110,51,00110011,121,01111001
69,01000101,13,00001101,82,01010010
3,00000011,96,01100000,99,01100011
53,00110101,28,00011100,81,01010001
49,00110001,127,01111111,176,10110000
24,00011000,55,00110111,79,01001111
60,00111100,62,00111110,122,01111010
59,00111011,45,00101101,104,01101000
27,00011011,101,01100101,128,10000000
58,00111010,2,00000010,60,00111100
45,00101101,97,01100001,142,10001110
105,01101001,124,01111100,229,11100101
19,00010011,80,01010000,99,01100011
77,01001101,80,01010000,157,10011101
33,00100001,55,00110111,88,01011000
51,00110011,45,00101101,96,01100000
118,01110110,119,01110111,237,11101101
6,00000110,92,01011100,98,01100010
64,01000000,30,00011110,94,01011110
53,00110101,45,00101101,98,01100010
107,01101011,72,01001000,179,10110011
68,01000100,122,01111010,190,10111110
73,01001001,19,00010011,92,01011100
71,01000111,37,00100101,108,01101100
85,01010101,53,00110101,138,10001010
103,01100111,18,00010010,121,01111001
35,00100011,90,01011010,125,01111101
41,00101001,64,01000000,105,01101001
2,00000010,95,01011111,97,01100001
100,01100100,33,00100001,133,10000101
70,01000110,105,01101001,175,10101111
77,01001101,33,00100001,110,01101110
63,00111111,24,00011000,87,01010111
102,01100110,98,01100010,200,11001000
84,01010100,16,00010000,100,01100100
14,00001110,14,00001110,28,00011100
84,01010100,12,00001100,96,01100000
20,00010100,16,00010000,36,00100100
116,01110100,109,01101101,225,11100001
92,01011100,126,01111110,218,11011010
14,00001110,37,00100101,51,00110011
21,00010101,9,00001001,30,00011110
60,00111100,108,01101100,168,10101000
100,01100100,22,00010110,122,01111010
86,01010110,6,00000110,92,01011100
111,01101111,89,01011001,200,11001000
70,01000110,16,00010000,86,01010110
73,01001001,56,00111000,129,10000001
117,01110101,100,01100100,217,11011001
69,01000101,36,00100100,105,01101001
33,00100001,111,01101111,144,10010000
21,00010101,111,01101111,132,10000100
58,00111010,125,01111101,183,10110111
90,01011010,58,00111010,148,10010100
67,01000011,73,01001001,140,10001100
63,00111111,72,01001000,135,10000111
68,01000100,5,00000101,73,01001001
79,01001111,39,00100111,118,01110110
3,00000011,44,00101100,47,00101111
16,00010000,115,01110011,131,10000011
123,01111011,34,00100010,157,10011101
31,00011111,118,01110110,149,10010101
73,01001001,47,00101111,120,01111000
36,00100100,30,00011110,66,01000010
9,00001001,38,00100110,47,00101111
32,00100000,2,00000010,34,00100010
57,00111001,11,00001011,68,01000100
110,01101110,54,00110110,164,10100100
115,01110011,88,01011000,203,11001011
88,01011000,59,00111011,147,10010011
55,00110111,41,00101001,96,01100000
113,01110001,27,00011011,140,10001100
77,01001101,43,00101011,120,01111000
127,01111111,107,01101011,234,11101010
47,00101111,68,01000100,115,01110011
18,00010010,69,01000101,87,01010111
6,00000110,76,01001100,82,01010010
100,01100100,43,00101011,143,10001111
74,01001010,47,00101111,121,01111001
107,01101011,123,01111011,230,11100110
56,00111000,98,01100010,154,10011010
33,00100001,83,01010011,116,01110100
18,00010010,13,00001101,31,00011111
104,01101000,53,00110101,157,10011101
17,00010001,62,00111110,79,01001111
53,00110101,121,01111001,174,10101110
102,01100110,1,00000001,103,01100111
74,01001010,11,00001011,85,01010101
119,01110111,16,00010000,135,10000111
47,00101111,21,00010101,68,01000100
19,00010011,62,00111110,81,01010001
95,01011111,50,00110010,145,10010001
106,01101010,73,01001001,179,10110011
37,00100101,45,00101101,82,01010010
86,01010110,83,01010011,169,10101001
0,00000000,6,00000110,6,00000110
2,00000010,115,01110011,117,01110101
42,00101010,119,01110111,161,10100001
48,00110000,65,01000001,113,01110001
73,01001001,49,00110001,122,01111010
87,01010111,87,01010111,174,10101110
101,01100101,27,00011011,128,10000000
92,01011100,62,00111110,154,10011010
123,01111011,101,01100101,224,11100000
37,00100101,103,01100111,140,10001100
41,00101001,111,01101111,152,10011000
66,01000010,87,01010111,153,10011001
51,00110011,98,01100010,149,10010101
64,01000000,100,01100100,164,10100100
67,01000011,108,01101100,175,10101111
64,01000000,119,01110111,183,10110111
25,00011001,27,00011011,52,00110100
100,01100100,48,00110000,148,10010100
65,01000001,120,01111000,185,10111001
7,00000111,97,01100001,104,01101000
28,00011100,36,00100100,64,01000000
109,01101101,38,00100110,147,10010011
104,01101000,61,00111101,165,10100101
37,00100101,99,01100011,136,10001000
81,01010001,59,00111011,140,10001100
90,01011010,53,00110101,143,10001111
50,00110010,63,00111111,113,01110001
127,01111111,13,00001101,140,10001100
30,00011110,83,01010011,113,01110001
20,00010100,46,00101110,66,01000010
12,00001100,49,00110001,61,00111101
44,00101100,105,01101001,149,10010101
125,01111101,115,01110011,240,11110000
60,00111100,74,01001010,134,10000110
45,00101101,118,01110110,163,10100011
45,00101101,20,00010100,65,01000001
62,00111110,91,01011011,153,10011001
23,00010111,34,00100010,57,00111001
34,00100010,81,01010001,115,01110011
62,00111110,102,01100110,164,10100100
92,01011100,64,01000000,156,10011100
60,00111100,58,00111010,118,01110110
121,01111001,108,01101100,229,11100101
51,00110011,39,00100111,90,01011010
79,01001111,99,01100011,178,10110010
11,00001011,22,00010110,33,00100001
60,00111100,56,00111000,116,01110100
13,00001101,126,01111110,139,10001011
124,01111100,41,00101001,165,10100101
101,01100101,119,01110111,220,11011100
8,00001000,65,01000001,73,01001001
103,01100111,102,01100110,205,11001101
25,00011001,32,00100000,57,00111001
17,00010001,85,01010101,102,01100110
108,01101100,66,01000010,174,10101110
12,00001100,100,01100100,112,01110000
12,00001100,0,00000000,12,00001100
67,01000011,100,01100100,167,10100111
62,00111110,117,01110101,179,10110011
122,01111010,121,01111001,243,11110011
65,01000001,40,00101000,105,01101001
71,01000111,72,01001000,143,10001111
92,01011100,36,00100100,128,10000000
127,01111111,97,01100001,224,11100000
5,00000101,93,01011101,98,01100010
70,01000110,29,00011101,99,01100011
85,01010101,125,01111101,210,11010010
104,01101000,14,00001110,118,01110110
54,00110110,34,00100010,88,01011000
44,00101100,47,00101111,91,01011011
32,00100000,91,01011011,123,01111011
12,00001100,95,01011111,107,01101011
63,00111111,79,01001111,142,10001110
75,01001011,123,01111011,198,11000110
108,01101100,49,00110001,157,10011101
113,01110001,32,00100000,145,10010001
65,01000001,78,01001110,143,10001111
41,00101001,97,01100001,138,10001010
91,01011011,59,00111011,150,10010110
85,01010101,123,01111011,208,11010000
97,01100001,106,01101010,203,11001011
42,00101010,101,01100101,143,10001111
1,00000001,19,00010011,20,00010100
11,00001011,4,00000100,15,00001111
9,00001001,27,00011011,36,00100100
79,01001111,65,01000001,144,10010000
99,01100011,0,00000000,99,01100011
80,01010000,72,01001000,152,10011000
17,00010001,102,01100110,119,01110111
84,01010100,123,01111011,207,11001111
50,00110010,0,00000000,50,00110010
23,00010111,45,00101101,68,01000100
81,01010001,113,01110001,194,11000010
72,01001000,9,00001001,81,01010001
91,01011011,73,01001001,164,10100100
114,01110010,50,00110010,164,10100100
38,00100110,31,00011111,69,01000101
7,00000111,125,01111101,132,10000100
74,01001010,109,01101101,183,10110111
70,01000110,127,01111111,197,11000101
70,01000110,123,01111011,193,11000001
101,01100101,62,00111110,163,10100011
51,00110011,82,01010010,133,10000101
43,00101011,45,00101101,88,01011000
49,00110001,95,01011111,144,10010000
89,01011001,48,00110000,137,10001001
101,01100101,78,01001110,179,10110011
37,00100101,48,00110000,85,01010101
88,01011000,67,01000011,155,10011011
126,01111110,106,01101010,232,11101000
43,00101011,58,00111010,101,01100101
30,00011110,72,01001000,102,01100110
80,01010000,21,00010101,101,01100101
6,00000110,125,01111101,131,10000011
68,01000100,30,00011110,98,01100010
124,01111100,87,01010111,211,11010011
113,01110001,54,00110110,167,10100111
121,01111001,60,00111100,181,10110101
65,01000001,114,01110010,179,10110011
40,00101000,7,00000111,47,00101111
73,01001001,126,01111110,199,11000111
39,00100111,114,01110010,153,10011001
109,01101101,8,00001000,117,01110101
28,00011100,16,00010000,44,00101100
20,00010100,4,00000100,24,00011000
35,00100011,59,00111011,94,01011110
122,01111010,104,01101000,226,11100010
105,01101001,79,01001111,184,10111000
110,01101110,99,01100011,209,11010001
33,00100001,76,01001100,109,01101101
78,01001110,50,00110010,128,10000000
98,01100010,67,01000011,165,10100101
5,00000101,31,00011111,36,00100100
87,01010111,50,00110010,137,10001001
104,01101000,76,01001100,180,10110100
64,01000000,26,00011010,90,01011010
87,01010111,14,00001110,101,01100101
25,00011001,79,01001111,104,01101000
72,01001000,27,00011011,99,01100011
35,00100011,125,01111101,160,10100000
23,00010111,75,01001011,98,01100010
107,01101011,5,00000101,112,01110000
2,00000010,52,00110100,54,00110110
17,00010001,100,01100100,117,01110101
39,00100111,71,01000111,110,01101110
97,01100001,31,00011111,128,10000000
28,00011100,11,00001011,39,00100111
123,01111011,119,01110111,242,11110010
60,00111100,107,01101011,167,10100111
116,01110100,61,00111101,177,10110001
28,00011100,27,00011011,55,00110111
87,01010111,96,01100000,183,10110111
111,01101111,84,01010100,195,11000011
62,00111110,124,01111100,186,10111010
99,01100011,122,01111010,221,11011101
96,01100000,124,01111100,220,11011100
3,00000011,76,01001100,79,01001111
119,01110111,33,00100001,152,10011000
102,01100110,103,01100111,205,11001101
59,00111011,62,00111110,121,01111001
28,00011100,115,01110011,143,10001111
81,01010001,89,01011001,170,10101010
58,00111010,26,00011010,84,01010100
91,01011011,66,01000010,157,10011101
58,00111010,124,01111100,182,10110110
19,00010011,96,01100000,115,01110011
89,01011001,91,01011011,180,10110100
12,00001100,111,01101111,123,01111011
125,01111101,43,00101011,168,10101000
68,01000100,5,00000101,73,01001001
54,00110110,50,00110010,104,01101000
20,00010100,61,00111101,81,01010001
27,00011011,3,00000011,30,00011110
64,01000000,98,01100010,162,10100010
46,00101110,113,01110001,159,10011111
73,01001001,62,00111110,135,10000111
35,00100011,37,00100101,72,01001000
1,00000001,45,00101101,46,00101110
97,01100001,90,01011010,187,10111011
76,01001100,24,00011000,100,01100100
23,00010111,97,01100001,120,01111000
30,00011110,8,00001000,38,00100110
60,00111100,103,01100111,163,10100011
31,00011111,68,01000100,99,01100011
43,00101011,78,01001110,121,01111001
59,00111011,11,00001011,70,01000110
93,01011101,29,00011101,122,01111010
17,00010001,105,01101001,122,01111010
68,01000100,2,00000010,70,01000110
12,00001100,6,00000110,18,00010010
13,00001101,115,01110011,128,10000000
46,00101110,78,01001110,124,01111100
7,00000111,109,01101101,116,01110100
51,00110011,86,01010110,137,10001001
104,01101000,107,01101011,211,11010011
6,00000110,70,01000110,76,01001100
66,01000010,55,00110111,121,01111001
16,00010000,24,00011000,40,00101000
2,00000010,23,00010111,25,00011001
95,01011111,42,00101010,137,10001001
10,00001010,117,01110101,127,01111111
5,00000101,94,01011110,99,01100011
9,00001001,127,01111111,136,10001000
50,00110010,118,01110110,168,10101000
109,01101101,74,01001010,183,10110111
44,00101100,48,00110000,92,01011100
90,01011010,65,01000001,155,10011011
124,01111100,34,00100010,158,10011110
124,01111100,40,00101000,164,10100100
66,01000010,51,00110011,117,01110101
64,01000000,83,01010011,147,10010011
43,00101011,104,01101000,147,10010011
1,00000001,110,01101110,111,01101111
73,01001001,19,00010011,92,01011100
108,01101100,70,01000110,178,10110010
116,01110100,74,01001010,190,10111110
97,01100001,86,01010110,183,10110111
32,00100000,76,01001100,108,01101100
2,00000010,71,01000111,73,01001001
71,01000111,72,01001000,143,10001111
115,01110011,3,00000011,118,01110110
49,00110001,0,00000000,49,00110001
82,01010010,80,01010000,162,10100010
18,00010010,0,00000000,18,00010010
27,00011011,84,01010100,111,01101111
122,01111010,74,01001010,196,11000100
109,01101101,52,00110100,161,10100001
67,01000011,101,01100101,168,10101000
19,00010011,83,01010011,102,01100110
82,01010010,112,01110000,194,11000010
69,01000101,114,01110010,183,10110111
2,00000010,21,00010101,23,00010111
103,01100111,34,00100010,137,10001001
42,00101010,25,00011001,67,01000011
98,01100010,91,01011011,189,10111101
104,01101000,126,01111110,230,11100110
63,00111111,38,00100110,101,01100101
25,00011001,107,01101011,132,10000100
77,01001101,46,00101110,123,01111011
95,01011111,49,00110001,144,10010000
75,01001011,115,01110011,190,10111110
77,01001101,62,00111110,139,10001011
39,00100111,2,00000010,41,00101001
3,00000011,28,00011100,31,00011111
89,01011001,6,00000110,95,01011111
69,01000101,13,00001101,82,01010010
50,00110010,96,01100000,146,10010010
51,00110011,43,00101011,94,01011110
85,01010101,82,01010010,167,10100111
92,01011100,41,00101001,133,10000101
22,00010110,123,01111011,145,10010001
77,01001101,44,00101100,121,01111001
37,00100101,22,00010110,59,00111011
64,01000000,34,00100010,98,01100010
69,01000101,127,01111111,196,11000100
104,01101000,111,01101111,215,11010111
28,00011100,19,00010011,47,00101111
21,00010101,112,01110000,133,10000101
43,00101011,5,00000101,48,00110000
62,00111110,16,00010000,78,01001110
27,00011011,40,00101000,67,01000011
83,01010011,90,01011010,173,10101101
75,01001011,24,00011000,99,01100011
45,00101101,127,01111111,172,10101100
108,01101100,46,00101110,154,10011010
47,00101111,111,01101111,158,10011110
121,01111001,116,01110100,237,11101101
102,01100110,9,00001001,111,01101111
107,01101011,101,01100101,208,11010000
80,01010000,8,00001000,88,01011000
24,00011000,104,01101000,128,10000000
122,01111010,59,00111011,181,10110101
1,00000001,76,01001100,77,01001101
25,00011001,67,01000011,92,01011100
29,00011101,46,00101110,75,01001011
76,01001100,73,01001001,149,10010101
51,00110011,82,01010010,133,10000101
27,00011011,49,00110001,76,01001100
57,00111001,56,00111000,113,01110001
88,01011000,93,01011101,181,10110101
54,00110110,53,00110101,107,01101011
15,00001111,94,01011110,109,01101101
94,01011110,18,00010010,112,01110000
52,00110100,77,01001101,129,10000001
107,01101011,14,00001110,121,01111001
8,00001000,82,01010010,90,01011010
4,00000100,77,01001101,81,01010001
118,01110110,90,01011010,208,11010000
57,00111001,94,01011110,151,10010111
16,00010000,14,00001110,30,00011110
121,01111001,42,00101010,163,10100011
97,01100001,40,00101000,137,10001001
22,00010110,97,01100001,119,01110111
58,00111010,126,01111110,184,10111000
109,01101101,39,00100111,148,10010100
28,00011100,95,01011111,123,01111011
109,01101101,53,00110101,162,10100010
124,01111100,9,00001001,133,10000101
99,01100011,100,01100100,199,11000111
54,00110110,64,01000000,118,01110110
41,00101001,24,00011000,65,01000001
99,01100011,40,00101000,139,10001011
6,00000110,17,00010001,23,00010111
97,01100001,108,01101100,205,11001101
120,01111000,61,00111101,181,10110101
75,01001011,59,00111011,134,10000110
103,01100111,56,00111000,159,10011111
68,01000100,57,00111001,125,01111101
117,01110101,117,01110101,234,11101010
41,00101001,92,01011100,133,10000101
57,00111001,96,01100000,153,10011001
17,00010001,9,00001001,26,00011010
49,00110001,28,00011100,77,01001101
40,00101000,83,01010011,123,01111011
109,01101101,73,01001001,182,10110110
11,00001011,26,00011010,37,00100101
108,01101100,22,00010110,130,10000010
111,01101111,72,01001000,183,10110111
104,01101000,53,00110101,157,10011101
66,01000010,15,00001111,81,01010001
26,00011010,46,00101110,72,01001000
29,00011101,11,00001011,40,00101000
58,00111010,59,00111011,117,01110101
17,00010001,113,01110001,130,10000010
46,00101110,96,01100000,142,10001110
39,00100111,60,00111100,99,01100011
7,00000111,69,01000101,76,01001100
122,01111010,17,00010001,139,10001011
8,00001000,30,00011110,38,00100110
44,00101100,112,01110000,156,10011100
125,01111101,10,00001010,135,10000111
98,01100010,108,01101100,206,11001110
18,00010010,111,01101111,129,10000001
61,00111101,5,00000101,66,01000010
29,00011101,55,00110111,84,01010100
1,00000001,103,01100111,104,01101000
36,00100100,30,00011110,66,01000010
78,01001110,8,00001000,86,01010110
104,01101000,93,01011101,197,11000101
2,00000010,123,01111011,125,01111101
24,00011000,103,01100111,127,01111111
42,00101010,66,01000010,108,01101100
66,01000010,87,01010111,153,10011001
102,01100110,72,01001000,174,10101110
124,01111100,98,01100010,222,11011110
73,01001001,30,00011110,103,01100111
2,00000010,48,00110000,50,00110010
17,00010001,28,00011100,45,00101101
19,00010011,113,01110001,132,10000100
13,00001101,112,01110000,125,01111101
68,01000100,44,00101100,112,01110000
10,00001010,67,01000011,77,01001101
77,01001101,72,01001000,149,10010101
9,00001001,117,01110101,126,01111110
10,00001010,66,01000010,76,01001100
119,01110111,50,00110010,169,10101001
52,00110100,70,01000110,122,01111010
52,00110100,37,00100101,89,01011001
64,01000000,25,00011001,89,01011001
29,00011101,8,00001000,37,00100101
102,01100110,6,00000110,108,01101100
78,01001110,122,01111010,200,11001000
49,00110001,77,01001101,126,01111110
41,00101001,98,01100010,139,10001011
80,01010000,110,01101110,190,10111110
93,01011101,65,01000001,158,10011110
56,00111000,6,00000110,62,00111110
114,01110010,120,01111000,234,11101010
45,00101101,39,00100111,84,01010100
6,00000110,89,01011001,95,01011111
76,01001100,60,00111100,136,10001000
125,01111101,65,01000001,190,10111110
37,00100101,62,00111110,99,01100011
56,00111000,93,01011101,149,10010101
90,01011010,59,00111011,149,10010101
94,01011110,77,01001101,171,10101011
111,01101111,15,00001111,126,01111110
50,00110010,61,00111101,111,01101111
24,00011000,32,00100000,56,00111000
124,01111100,45,00101101,169,10101001
114,01110010,70,01000110,184,10111000
22,00010110,18,00010010,40,00101000
110,01101110,80,01010000,190,10111110
59,00111011,60,00111100,119,01110111
56,00111000,10,00001010,66,01000010
80,01010000,44,00101100,124,01111100
47,00101111,63,00111111,110,01101110
99,01100011,122,01111010,221,11011101
86,01010110,73,01001001,159,10011111
73,01001001,63,00111111,136,10001000
127,01111111,55,00110111,182,10110110
104,01101000,126,01111110,230,11100110
51,00110011,21,00010101,72,01001000
121,01111001,110,01101110,231,11100111
30,00011110,98,01100010,128,10000000
88,01011000,69,01000101,157,10011101
38,00100110,93,01011101,131,10000011
43,00101011,94,01011110,137,10001001
73,01001001,71,01000111,144,10010000
11,00001011,26,00011010,37,00100101
100,01100100,108,01101100,208,11010000
119,01110111,38,00100110,157,10011101
118,01110110,80,01010000,198,11000110
1,00000001,114,01110010,115,01110011
37,00100101,67,01000011,104,01101000
49,00110001,106,01101010,155,10011011
87,01010111,35,00100011,122,01111010
53,00110101,105,01101001,158,10011110
25,00011001,12,00001100,37,00100101
114,01110010,93,01011101,207,11001111
82,01010010,71,01000111,153,10011001
76,01001100,96,01100000,172,10101100
72,01001000,91,01011011,163,10100011
48,00110000,122,01111010,170,10101010
29,00011101,16,00010000,45,00101101
87,01010111,114,01110010,201,11001001
94,01011110,119,01110111,213,11010101
77,01001101,49,00110001,126,01111110
72,01001000,101,01100101,173,10101101
16,00010000,114,01110010,130,10000010
40,00101000,94,01011110,134,10000110
97,01100001,35,00100011,132,10000100
126,01111110,107,01101011,233,11101001
80,01010000,107,01101011,187,10111011
43,00101011,91,01011011,134,10000110
34,00100010,12,00001100,46,00101110
73,01001001,101,01100101,174,10101110
124,01111100,75,01001011,199,11000111
96,01100000,2,00000010,98,01100010
93,01011101,38,00100110,131,10000011
124,01111100,26,00011010,150,10010110
80,01010000,71,01000111,151,10010111
105,01101001,90,01011010,195,11000011
73,01001001,75,01001011,148,10010100
67,01000011,71,01000111,138,10001010
117,01110101,35,00100011,152,10011000
123,01111011,1,00000001,124,01111100
47,00101111,92,01011100,139,10001011
27,00011011,83,01010011,110,01101110
52,00110100,116,01110100,168,10101000
27,00011011,118,01110110,145,10010001
8,00001000,44,00101100,52,00110100
13,00001101,2,00000010,15,00001111
57,00111001,59,00111011,116,01110100
53,00110101,94,01011110,147,10010011
43,00101011,26,00011010,69,01000101
120,01111000,5,00000101,125,01111101
103,01100111,112,01110000,215,11010111
28,00011100,25,00011001,53,00110101
83,01010011,67,01000011,150,10010110
98,01100010,101,01100101,199,11000111
19,00010011,77,01001101,96,01100000
50,00110010,62,00111110,112,01110000
109,01101101,20,00010100,129,10000001
93,01011101,85,01010101,178,10110010
96,01100000,114,01110010,210,11010010
0,00000000,67,01000011,67,01000011
25,00011001,123,01111011,148,10010100
120,01111000,63,00111111,183,10110111
80,01010000,99,01100011,179,10110011
49,00110001,67,01000011,116,01110100
67,01000011,72,01001000,139,10001011
117,01110101,32,00100000,149,10010101
106,01101010,120,01111000,226,11100010
79,01001111,81,01010001,160,10100000
87,01010111,99,01100011,186,10111010
56,00111000,57,00111001,113,01110001
17,00010001,27,00011011,44,00101100
63,00111111,60,00111100,123,01111011
122,01111010,20,00010100,142,10001110
60,00111100,26,00011010,86,01010110
53,00110101,14,00001110,67,01000011
30,00011110,49,00110001,79,01001111
107,01101011,22,00010110,129,10000001
1,00000001,57,00111001,58,00111010
29,00011101,45,00101101,74,01001010
118,01110110,27,00011011,145,10010001
101,01100101,8,00001000,109,01101101
29,00011101,35,00100011,64,01000000
125,01111101,42,00101010,167,10100111
90,01011010,42,00101010,132,10000100
41,00101001,80,01010000,121,01111001
87,01010111,15,00001111,102,01100110
57,00111001,79,01001111,136,10001000
39,00100111,20,00010100,59,00111011
107,01101011,111,01101111,218,11011010
41,00101001,44,00101100,85,01010101
74,01001010,118,01110110,192,11000000
75,01001011,124,01111100,199,11000111
107,01101011,14,00001110,121,01111001
89,01011001,75,01001011,164,10100100
77,01001101,57,00111001,134,10000110
51,00110011,4,00000100,55,00110111
98,01100010,63,00111111,161,10100001
66,01000010,21,00010101,87,01010111
44,00101100,52,00110100,96,01100000
110,01101110,82,01010010,192,11000000
115,01110011,27,00011011,142,10001110
9,00001001,49,00110001,58,00111010
85,01010101,124,01111100,209,11010001
57,00111001,95,01011111,152,10011000
19,00010011,93,01011101,112,01110000
61,00111101,121,01111001,182,10110110
85,01010101,87,01010111,172,10101100
38,00100110,82,01010010,120,01111000
13,00001101,72,01001000,85,01010101
66,01000010,32,00100000,98,01100010
4,00000100,5,00000101,9,00001001
39,00100111,42,00101010,81,01010001
79,01001111,50,00110010,129,10000001
111,01101111,98,01100010,209,11010001
74,01001010,106,01101010,180,10110100
2,00000010,112,01110000,114,01110010
25,00011001,34,00100010,59,00111011
66,01000010,11,00001011,77,01001101
35,00100011,107,01101011,142,10001110
64,01000000,59,00111011,123,01111011
104,01101000,103,01100111,207,11001111
48,00110000,68,01000100,116,01110100
33,00100001,73,01001001,106,01101010
6,00000110,121,01111001,127,01111111
26,00011010,3,00000011,29,00011101
127,01111111,34,00100010,161,10100001
76,01001100,32,00100000,108,01101100
35,00100011,35,00100011,70,01000110
125,01111101,24,00011000,149,10010101
51,00110011,121,01111001,172,10101100
18,00010010,99,01100011,117,01110101
41,00101001,103,01100111,144,10010000
38,00100110,23,00010111,61,00111101
92,01011100,56,00111000,148,10010100
123,01111011,122,01111010,245,11110101
10,00001010,38,00100110,48,00110000
116,01110100,70,01000110,186,10111010
117,01110101,49,00110001,166,10100110
67,01000011,88,01011000,155,10011011
11,00001011,28,00011100,39,00100111
52,00110100,93,01011101,145,10010001
94,01011110,61,00111101,155,10011011
12,00001100,51,00110011,63,00111111
62,00111110,23,00010111,85,01010101
38,00100110,125,01111101,163,10100011
31,00011111,1,00000001,32,00100000
104,01101000,120,01111000,224,11100000
59,00111011,60,00111100,119,01110111
119,01110111,53,00110101,172,10101100
115,01110011,93,01011101,208,11010000
48,00110000,39,00100111,87,01010111
106,01101010,121,01111001,227,11100011
99,01100011,105,01101001,204,11001100
37,00100101,93,01011101,130,10000010
25,00011001,37,00100101,62,00111110
117,01110101,46,00101110,163,10100011
52,00110100,92,01011100,144,10010000
90,01011010,35,00100011,125,01111101
38,00100110,115,01110011,153,10011001
0,00000000,26,00011010,26,00011010
110,01101110,111,01101111,221,11011101
110,01101110,53,00110101,163,10100011
68,01000100,63,00111111,131,10000011
30,00011110,12,00001100,42,00101010
74,01001010,64,01000000,138,10001010
62,00111110,45,00101101,107,01101011
19,00010011,49,00110001,68,01000100
56,00111000,0,00000000,56,00111000
63,00111111,117,01110101,180,10110100
96,01100000,19,00010011,115,01110011
38,00100110,53,00110101,91,01011011
103,01100111,23,00010111,126,01111110
46,00101110,122,01111010,168,10101000
80,01010000,116,01110100,196,11000100
114,01110010,112,01110000,226,11100010
90,01011010,61,00111101,151,10010111
72,01001000,28,00011100,100,01100100
22,00010110,39,00100111,61,00111101
98,01100010,54,00110110,152,10011000
79,01001111,71,01000111,150,10010110
65,01000001,28,00011100,93,01011101
58,00111010,66,01000010,124,01111100
8,00001000,121,01111001,129,10000001
47,00101111,27,00011011,74,01001010
19,00010011,100,01100100,119,01110111
82,01010010,38,00100110,120,01111000
35,00100011,111,01101111,146,10010010
112,01110000,42,00101010,154,10011010
120,01111000,127,01111111,247,11110111
7,00000111,118,01110110,125,01111101
112,01110000,109,01101101,221,11011101
112,01110000,100,01100100,212,11010100
54,00110110,125,01111101,179,10110011
95,01011111,4,00000100,99,01100011
69,01000101,7,00000111,76,01001100
23,00010111,52,00110100,75,01001011
92,01011100,57,00111001,149,10010101
66,01000010,4,00000100,70,01000110
68,01000100,90,01011010,158,10011110
13,00001101,26,00011010,39,00100111
108,01101100,1,00000001,109,01101101
22,00010110,54,00110110,76,01001100
122,01111010,46,00101110,168,10101000
72,01001000,5,00000101,77,01001101
68,01000100,125,01111101,193,11000001
12,00001100,18,00010010,30,00011110
110,01101110,97,01100001,207,11001111
2,00000010,93,01011101,95,01011111
63,00111111,47,00101111,110,01101110
89,01011001,34,00100010,123,01111011
58,00111010,21,00010101,79,01001111
124,01111100,72,01001000,196,11000100
17,00010001,26,00011010,43,00101011
120,01111000,100,01100100,220,11011100
107,01101011,29,00011101,136,10001000
124,01111100,75,01001011,199,11000111
96,01100000,87,01010111,183,10110111
83,01010011,0,00000000,83,01010011
21,00010101,28,00011100,49,00110001
33,00100001,54,00110110,87,01010111
107,01101011,125,01111101,232,11101000
18,00010010,0,00000000,18,00010010
38,00100110,82,01010010,120,01111000
50,00110010,90,01011010,140,10001100
77,01001101,51,00110011,128,10000000
67,01000011,1,00000001,68,01000100
39,00100111,23,00010111,62,00111110
44,00101100,31,00011111,75,01001011
7,00000111,30,00011110,37,00100101
118,01110110,28,00011100,146,10010010
54,00110110,48,00110000,102,01100110
8,00001000,90,01011010,98,01100010
5,00000101,5,00000101,10,00001010
117,01110101,35,00100011,152,10011000
26,00011010,115,01110011,141,10001101
52,00110100,101,01100101,153,10011001
80,01010000,57,00111001,137,10001001
117,01110101,99,01100011,216,11011000
104,01101000,12,00001100,116,01110100
28,00011100,5,00000101,33,00100001
2,00000010,50,00110010,52,00110100
84,01010100,56,00111000,140,10001100
126,01111110,14,00001110,140,10001100
81,01010001,90,01011010,171,10101011
116,01110100,4,00000100,120,01111000
46,00101110,8,00001000,54,00110110
72,01001000,19,00010011,91,01011011
15,00001111,19,00010011,34,00100010
114,01110010,118,01110110,232,11101000
18,00010010,89,01011001,107,01101011
101,01100101,78,01001110,179,10110011
24,00011000,62,00111110,86,01010110
124,01111100,69,01000101,193,11000001
50,00110010,9,00001001,59,00111011
27,00011011,90,01011010,117,01110101
79,01001111,35,00100011,114,01110010
77,01001101,10,00001010,87,01010111
11,00001011,99,01100011,110,01101110
14,00001110,114,01110010,128,10000000
64,01000000,73,01001001,137,10001001
50,00110010,63,00111111,113,01110001
109,01101101,65,01000001,174,10101110
68,01000100,89,01011001,157,10011101
27,00011011,53,00110101,80,01010000
53,00110101,124,01111100,177,10110001
100,01100100,83,01010011,183,10110111
13,00001101,88,01011000,101,01100101
113,01110001,47,00101111,160,10100000
20,00010100,0,00000000,20,00010100
96,01100000,40,00101000,136,10001000
94,01011110,98,01100010,192,11000000
37,00100101,100,01100100,137,10001001
105,01101001,110,01101110,215,11010111
36,00100100,98,01100010,134,10000110
16,00010000,100,01100100,116,01110100
55,00110111,5,00000101,60,00111100
89,01011001,120,01111000,209,11010001
113,01110001,1,00000001,114,01110010
127,01111111,22,00010110,149,10010101
87,01010111,76,01001100,163,10100011
72,01001000,57,00111001,129,10000001
36,00100100,86,01010110,122,01111010
106,01101010,49,00110001,155,10011011
28,00011100,6,00000110,34,00100010
14,00001110,47,00101111,61,00111101
115,01110011,92,01011100,207,11001111
117,01110101,13,00001101,130,10000010
98,01100010,63,00111111,161,10100001
117,01110101,70,01000110,187,10111011
94,01011110,10,00001010,104,01101000
0,00000000,56,00111000,56,00111000
7,00000111,2,00000010,9,00001001
26,00011010,80,01010000,106,01101010
101,01100101,66,01000010,167,10100111
45,00101101,95,01011111,140,10001100
116,01110100,3,00000011,119,01110111
101,01100101,65,01000001,166,10100110
111,01101111,37,00100101,148,10010100
122,01111010,13,00001101,135,10000111
60,00111100,63,00111111,123,01111011
69,01000101,18,00010010,87,01010111
47,00101111,33,00100001,80,01010000
87,01010111,116,01110100,203,11001011
34,00100010,106,01101010,140,10001100
65,01000001,114,01110010,179,10110011
47,00101111,94,01011110,141,10001101
20,00010100,24,00011000,44,00101100
15,00001111,64,01000000,79,01001111
19,00010011,4,00000100,23,00010111
8,00001000,2,00000010,10,00001010
27,00011011,1,00000001,28,00011100
60,00111100,127,01111111,187,10111011
35,00100011,28,00011100,63,00111111
108,01101100,39,00100111,147,10010011
16,00010000,39,00100111,55,00110111
117,01110101,42,00101010,159,10011111
49,00110001,5,00000101,54,00110110
65,01000001,106,01101010,171,10101011
93,01011101,79,01001111,172,10101100
114,01110010,93,01011101,207,11001111
90,01011010,98,01100010,188,10111100
116,01110100,114,01110010,230,11100110
85,01010101,84,01010100,169,10101001
55,00110111,90,01011010,145,10010001
101,01100101,24,00011000,125,01111101
29,00011101,49,00110001,78,01001110
60,00111100,52,00110100,112,01110000
94,01011110,127,01111111,221,11011101
80,01010000,76,01001100,156,10011100
107,01101011,75,01001011,182,10110110
18,00010010,62,00111110,80,01010000
102,01100110,98,01100010,200,11001000
19,00010011,73,01001001,92,01011100
32,00100000,12,00001100,44,00101100
43,00101011,18,00010010,61,00111101
67,01000011,107,01101011,174,10101110
46,00101110,116,01110100,162,10100010
4,00000100,11,00001011,15,00001111
4,00000100,23,00010111,27,00011011
57,00111001,89,01011001,146,10010010
45,00101101,26,00011010,71,01000111
65,01000001,6,00000110,71,01000111
85,01010101,84,01010100,169,10101001
94,01011110,99,01100011,193,11000001
94,01011110,8,00001000,102,01100110
56,00111000,11,00001011,67,01000011
61,00111101,36,00100100,97,01100001
114,01110010,62,00111110,176,10110000
2,00000010,107,01101011,109,01101101
79,01001111,110,01101110,189,10111101
73,01001001,72,01001000,145,10010001
67,01000011,84,01010100,151,10010111
25,00011001,53,00110101,78,01001110
0,00000000,73,01001001,73,01001001
50,00110010,4,00000100,54,00110110
70,01000110,74,01001010,144,10010000
10,00001010,32,00100000,42,00101010
114,01110010,39,00100111,153,10011001
126,01111110,3,00000011,129,10000001
85,01010101,124,01111100,209,11010001
83,01010011,13,00001101,96,01100000
21,00010101,116,01110100,137,10001001
8,00001000,124,01111100,132,10000100
74,01001010,58,00111010,132,10000100
42,00101010,29,00011101,71,01000111
93,01011101,103,01100111,196,11000100
2,00000010,0,00000000,2,00000010
12,00001100,58,00111010,70,01000110
12,00001100,74,01001010,86,01010110
16,00010000,102,01100110,118,01110110
89,01011001,27,00011011,116,01110100
93,01011101,65,01000001,158,10011110
112,01110000,5,00000101,117,01110101
92,01011100,18,00010010,110,01101110
92,01011100,66,01000010,158,10011110
13,00001101,82,01010010,95,01011111
67,01000011,76,01001100,143,10001111
21,00010101,9,00001001,30,00011110
93,01011101,124,01111100,217,11011001
87,01010111,33,00100001,120,01111000
72,01001000,7,00000111,79,01001111
93,01011101,9,00001001,102,01100110
115,01110011,48,00110000,163,10100011
115,01110011,31,00011111,146,10010010
27,00011011,121,01111001,148,10010100
110,01101110,36,00100100,146,10010010
62,00111110,49,00110001,111,01101111
75,01001011,110,01101110,185,10111001
70,01000110,29,00011101,99,01100011
125,01111101,9,00001001,134,10000110
14,00001110,52,00110100,66,01000010
94,01011110,118,01110110,212,11010100
59,00111011,89,01011001,148,10010100
4,00000100,62,00111110,66,01000010
25,00011001,62,00111110,87,01010111
81,01010001,19,00010011,100,01100100
111,01101111,43,00101011,154,10011010
109,01101101,16,00010000,125,01111101
96,01100000,126,01111110,222,11011110
23,00010111,33,00100001,56,00111000
104,01101000,23,00010111,127,01111111
127,01111111,18,00010010,145,10010001
61,00111101,109,01101101,170,10101010
109,01101101,97,01100001,206,11001110
36,00100100,81,01010001,117,01110101
4,00000100,25,00011001,29,00011101
84,01010100,56,00111000,140,10001100
102,01100110,103,01100111,205,11001101
126,01111110,72,01001000,198,11000110
126,01111110,35,00100011,161,10100001
13,00001101,117,01110101,130,10000010
38,00100110,23,00010111,61,00111101
26,00011010,72,01001000,98,01100010
83,01010011,96,01100000,179,10110011
117,01110101,4,00000100,121,01111001
33,00100001,87,01010111,120,01111000
49,00110001,39,00100111,88,01011000
84,01010100,16,00010000,100,01100100
104,01101000,31,00011111,135,10000111
121,01111001,55,00110111,176,10110000
15,00001111,99,01100011,114,01110010
121,01111001,4,00000100,125,01111101
14,00001110,68,01000100,82,01010010
51,00110011,32,00100000,83,01010011
3,00000011,39,00100111,42,00101010
53,00110101,71,01000111,124,01111100
54,00110110,24,00011000,78,01001110
59,00111011,122,01111010,181,10110101
50,00110010,97,01100001,147,10010011
41,00101001,75,01001011,116,01110100
82,01010010,70,01000110,152,10011000
4,00000100,61,00111101,65,01000001
87,01010111,87,01010111,174,10101110
28,00011100,6,00000110,34,00100010
18,00010010,66,01000010,84,01010100
54,00110110,2,00000010,56,00111000
100,01100100,115,01110011,215,11010111
41,00101001,124,01111100,165,10100101
100,01100100,95,01011111,195,11000011
64,01000000,125,01111101,189,10111101
92,01011100,42,00101010,134,10000110
9,00001001,45,00101101,54,00110110
83,01010011,47,00101111,130,10000010
9,00001001,110,01101110,119,01110111
15,00001111,125,01111101,140,10001100
103,01100111,60,00111100,163,10100011
8,00001000,121,01111001,129,10000001
101,01100101,61,00111101,162,10100010
103,01100111,100,01100100,203,11001011
4,00000100,12,00001100,16,00010000
48,00110000,30,00011110,78,01001110
118,01110110,62,00111110,180,10110100
44,00101100,65,01000001,109,01101101
72,01001000,113,01110001,185,10111001
59,00111011,106,01101010,165,10100101
91,01011011,122,01111010,213,11010101
27,00011011,32,00100000,59,00111011
87,01010111,50,00110010,137,10001001
104,01101000,101,01100101,205,11001101
15,00001111,14,00001110,29,00011101
82,01010010,81,01010001,163,10100011
96,01100000,35,00100011,131,10000011
45,00101101,30,00011110,75,01001011
125,01111101,89,01011001,214,11010110
11,00001011,71,01000111,82,01010010
65,01000001,101,01100101,166,10100110
82,01010010,50,00110010,132,10000100
48,00110000,100,01100100,148,10010100
38,00100110,91,01011011,129,10000001
123,01111011,32,00100000,155,10011011
27,00011011,27,00011011,54,00110110
102,01100110,110,01101110,212,11010100
122,01111010,83,01010011,205,11001101
4,00000100,111,01101111,115,01110011
56,00111000,44,00101100,100,01100100
104,01101000,76,01001100,180,10110100
39,00100111,110,01101110,149,10010101
104,01101000,99,01100011,203,11001011
3,00000011,4,00000100,7,00000111
108,01101100,39,00100111,147,10010011
45,00101101,47,00101111,92,01011100
118,01110110,115,01110011,233,11101001
26,00011010,67,01000011,93,01011101
23,00010111,124,01111100,147,10010011
99,01100011,83,01010011,182,10110110
30,00011110,61,00111101,91,01011011
111,01101111,6,00000110,117,01110101
109,01101101,43,00101011,152,10011000
96,01100000,95,01011111,191,10111111
64,01000000,61,00111101,125,01111101
49,00110001,124,01111100,173,10101101
101,01100101,49,00110001,150,10010110
55,00110111,5,00000101,60,00111100
58,00111010,10,00001010,68,01000100
17,00010001,121,01111001,138,10001010
57,00111001,122,01111010,179,10110011
105,01101001,66,01000010,171,10101011
64,01000000,2,00000010,66,01000010
24,00011000,108,01101100,132,10000100
88,01011000,105,01101001,193,11000001
55,00110111,42,00101010,97,01100001
56,00111000,119,01110111,175,10101111
90,01011010,115,01110011,205,11001101
96,01100000,110,01101110,206,11001110
57,00111001,58,00111010,115,01110011
24,00011000,81,01010001,105,01101001
46,00101110,117,01110101,163,10100011
18,00010010,15,00001111,33,00100001
67,01000011,69,01000101,136,10001000
74,01001010,99,01100011,173,10101101
97,01100001,2,00000010,99,01100011
113,01110001,32,00100000,145,10010001
89,01011001,117,01110101,206,11001110
24,00011000,4,00000100,28,00011100
5,00000101,1,00000001,6,00000110
93,01011101,122,01111010,215,11010111
91,01011011,53,00110101,144,10010000
9,00001001,97,01100001,106,01101010
80,01010000,18,00010010,98,01100010
87,01010111,127,01111111,214,11010110
17,00010001,80,01010000,97,01100001
122,01111010,101,01100101,223,11011111
46,00101110,64,01000000,110,01101110
13,00001101,26,00011010,39,00100111
59,00111011,53,00110101,112,01110000
74,01001010,42,00101010,116,01110100
93,01011101,25,00011001,118,01110110
65,01000001,39,00100111,104,01101000
123,01111011,70,01000110,193,11000001
29,00011101,47,00101111,76,01001100
27,00011011,101,01100101,128,10000000
64,01000000,25,00011001,89,01011001
92,01011100,87,01010111,179,10110011
2,00000010,2,00000010,4,00000100
79,01001111,27,00011011,106,01101010
70,01000110,97,01100001,167,10100111
73,01001001,41,00101001,114,01110010
64,01000000,91,01011011,155,10011011
117,01110101,29,00011101,146,10010010
77,01001101,117,01110101,194,11000010
81,01010001,26,00011010,107,01101011
64,01000000,2,00000010,66,01000010
108,01101100,28,00011100,136,10001000
118,01110110,64,01000000,182,10110110
7,00000111,84,01010100,91,01011011
0,00000000,21,00010101,21,00010101
108,01101100,34,00100010,142,10001110
61,00111101,124,01111100,185,10111001
30,00011110,90,01011010,120,01111000
19,00010011,53,00110101,72,01001000
37,00100101,40,00101000,77,01001101
115,01110011,81,01010001,196,11000100
108,01101100,68,01000100,176,10110000
16,00010000,18,00010010,34,00100010
56,00111000,14,00001110,70,01000110
83,01010011,122,01111010,205,11001101
111,01101111,119,01110111,230,11100110
77,01001101,8,00001000,85,01010101
39,00100111,110,01101110,149,10010101
112,01110000,10,00001010,122,01111010
37,00100101,87,01010111,124,01111100
87,01010111,110,01101110,197,11000101
57,00111001,61,00111101,118,01110110
123,01111011,47,00101111,170,10101010
127,01111111,65,01000001,192,11000000
86,01010110,92,01011100,178,10110010
93,01011101,9,00001001,102,01100110
80,01010000,14,00001110,94,01011110
91,01011011,124,01111100,215,11010111
127,01111111,55,00110111,182,10110110
62,00111110,76,01001100,138,10001010
66,01000010,80,01010000,146,10010010
105,01101001,40,00101000,145,10010001
39,00100111,1,00000001,40,00101000
47,00101111,105,01101001,152,10011000
90,01011010,43,00101011,133,10000101
43,00101011,24,00011000,67,01000011
29,00011101,17,00010001,46,00101110
127,01111111,44,00101100,171,10101011
100,01100100,103,01100111,203,11001011
50,00110010,37,00100101,87,01010111
83,01010011,59,00111011,142,10001110
105,01101001,54,00110110,159,10011111
121,01111001,61,00111101,182,10110110
14,00001110,38,00100110,52,00110100
58,00111010,109,01101101,167,10100111
9,00001001,88,01011000,97,01100001
11,00001011,16,00010000,27,00011011
111,01101111,85,01010101,196,11000100
126,01111110,43,00101011,169,10101001
13,00001101,22,00010110,35,00100011
117,01110101,24,00011000,141,10001101
11,00001011,83,01010011,94,01011110
93,01011101,47,00101111,140,10001100
92,01011100,124,01111100,216,11011000
88,01011000,52,00110100,140,10001100
54,00110110,98,01100010,152,10011000
74,01001010,30,00011110,104,01101000
107,01101011,113,01110001,220,11011100
50,00110010,67,01000011,117,01110101
41,00101001,115,01110011,156,10011100
73,01001001,50,00110010,123,01111011
102,01100110,119,01110111,221,11011101
54,00110110,91,01011011,145,10010001
126,01111110,4,00000100,130,10000010
1,00000001,94,01011110,95,01011111
124,01111100,113,01110001,237,11101101
91,01011011,23,00010111,114,01110010
89,01011001,18,00010010,107,01101011
26,00011010,84,01010100,110,01101110
69,01000101,56,00111000,125,01111101
12,00001100,108,01101100,120,01111000
15,00001111,14,00001110,29,00011101
30,00011110,72,01001000,102,01100110
51,00110011,97,01100001,148,10010100
26,00011010,110,01101110,136,10001000
76,01001100,115,01110011,191,10111111
47,00101111,66,01000010,113,01110001
112,01110000,19,00010011,131,10000011
4,00000100,59,00111011,63,00111111
14,00001110,58,00111010,72,01001000
35,00100011,7,00000111,42,00101010
13,00001101,64,01000000,77,01001101
39,00100111,7,00000111,46,00101110
121,01111001,99,01100011,220,11011100
63,00111111,2,00000010,65,01000001
103,01100111,10,00001010,113,01110001
86,01010110,29,00011101,115,01110011
46,00101110,8,00001000,54,00110110
35,00100011,56,00111000,91,01011011
0,00000000,95,01011111,95,01011111
70,01000110,101,01100101,171,10101011
16,00010000,73,01001001,89,01011001
63,00111111,94,01011110,157,10011101
21,00010101,62,00111110,83,01010011
92,01011100,33,00100001,125,01111101
125,01111101,7,00000111,132,10000100
14,00001110,112,01110000,126,01111110
54,00110110,15,00001111,69,01000101
26,00011010,11,00001011,37,00100101
78,01001110,41,00101001,119,01110111
56,00111000,80,01010000,136,10001000
106,01101010,24,00011000,130,10000010
2,00000010,63,00111111,65,01000001
95,01011111,114,01110010,209,11010001
68,01000100,43,00101011,111,01101111
115,01110011,9,00001001,124,01111100
89,01011001,59,00111011,148,10010100
33,00100001,27,00011011,60,00111100
10,00001010,114,01110010,124,01111100
103,01100111,94,01011110,197,11000101
110,01101110,61,00111101,171,10101011
26,00011010,32,00100000,58,00111010
81,01010001,29,00011101,110,01101110
108,01101100,93,01011101,201,11001001
56,00111000,38,00100110,94,01011110
104,01101000,5,00000101,109,01101101
33,00100001,32,00100000,65,01000001
74,01001010,114,01110010,188,10111100
41,00101001,126,01111110,167,10100111
42,00101010,123,01111011,165,10100101
50,00110010,118,01110110,168,10101000
78,01001110,27,00011011,105,01101001
48,00110000,11,00001011,59,00111011
51,00110011,71,01000111,122,01111010
12,00001100,96,01100000,108,01101100
54,00110110,55,00110111,109,01101101
11,00001011,59,00111011,70,01000110
90,01011010,115,01110011,205,11001101
5,00000101,125,01111101,130,10000010
42,00101010,119,01110111,161,10100001
47,00101111,8,00001000,55,00110111
21,00010101,70,01000110,91,01011011
88,01011000,104,01101000,192,11000000
101,01100101,29,00011101,130,10000010
13,00001101,35,00100011,48,00110000
5,00000101,116,01110100,121,01111001
117,01110101,77,01001101,194,11000010
37,00100101,30,00011110,67,01000011
96,01100000,66,01000010,162,10100010
52,00110100,77,01001101,129,10000001
118,01110110,59,00111011,177,10110001
125,01111101,94,01011110,219,11011011
0,00000000,9,00001001,9,00001001
18,00010010,47,00101111,65,01000001
16,00010000,43,00101011,59,00111011
41,00101001,79,01001111,120,01111000
21,00010101,21,00010101,42,00101010
118,01110110,107,01101011,225,11100001
27,00011011,62,00111110,89,01011001
110,01101110,25,00011001,135,10000111
4,00000100,88,01011000,92,01011100
8,00001000,53,00110101,61,00111101
87,01010111,91,01011011,178,10110010
104,01101000,101,01100101,205,11001101
28,00011100,106,01101010,134,10000110
111,01101111,30,00011110,141,10001101
97,01100001,77,01001101,174,10101110
51,00110011,104,01101000,155,10011011
86,01010110,81,01010001,167,10100111
42,00101010,67,01000011,109,01101101
39,00100111,84,01010100,123,01111011
2,00000010,31,00011111,33,00100001
79,01001111,126,01111110,205,11001101
9,00001001,82,01010010,91,01011011
100,01100100,87,01010111,187,10111011
81,01010001,83,01010011,164,10100100
67,01000011,101,01100101,168,10101000
9,00001001,67,01000011,76,01001100
118,01110110,70,01000110,188,10111100
80,01010000,104,01101000,184,10111000
107,01101011,87,01010111,194,11000010
94,01011110,100,01100100,194,11000010
90,01011010,25,00011001,115,01110011
99,01100011,44,00101100,143,10001111
97,01100001,48,00110000,145,10010001
96,01100000,68,01000100,164,10100100
97,01100001,14,00001110,111,01101111
88,01011000,113,01110001,201,11001001
7,00000111,45,00101101,52,00110100
114,01110010,100,01100100,214,11010110
1,00000001,99,01100011,100,01100100
80,01010000,98,01100010,178,10110010
112,01110000,120,01111000,232,11101000
6,00000110,72,01001000,78,01001110
109,01101101,118,01110110,227,11100011
30,00011110,9,00001001,39,00100111
9,00001001,109,01101101,118,01110110
14,00001110,112,01110000,126,01111110
70,01000110,10,00001010,80,01010000
11,00001011,54,00110110,65,01000001
98,01100010,108,01101100,206,11001110
69,01000101,111,01101111,180,10110100
24,00011000,86,01010110,110,01101110
26,00011010,114,01110010,140,10001100
64,01000000,58,00111010,122,01111010
35,00100011,107,01101011,142,10001110
2,00000010,51,00110011,53,00110101
65,01000001,58,00111010,123,01111011
7,00000111,82,01010010,89,01011001
108,01101100,101,01100101,209,11010001
112,01110000,16,00010000,128,10000000
88,01011000,53,00110101,141,10001101
84,01010100,100,01100100,184,10111000
1,00000001,47,00101111,48,00110000
10,00001010,5,00000101,15,00001111
93,01011101,14,00001110,107,01101011
17,00010001,94,01011110,111,01101111
15,00001111,126,01111110,141,10001101
46,00101110,47,00101111,93,01011101
19,00010011,127,01111111,146,10010010
53,00110101,54,00110110,107,01101011
40,00101000,125,01111101,165,10100101
46,00101110,24,00011000,70,01000110
49,00110001,80,01010000,129,10000001
24,00011000,76,01001100,100,01100100
97,01100001,115,01110011,212,11010100
60,00111100,125,01111101,185,10111001
68,01000100,20,00010100,88,01011000
53,00110101,85,01010101,138,10001010
57,00111001,69,01000101,126,01111110
39,00100111,95,01011111,134,10000110
0,00000000,12,00001100,12,00001100
101,01100101,86,01010110,187,10111011
46,00101110,89,01011001,135,10000111
87,01010111,108,01101100,195,11000011
87,01010111,92,01011100,179,10110011
103,01100111,28,00011100,131,10000011
39,00100111,8,00001000,47,00101111
101,01100101,100,01100100,201,11001001
17,00010001,79,01001111,96,01100000
53,00110101,84,01010100,137,10001001
65,01000001,116,01110100,181,10110101
15,00001111,114,01110010,129,10000001
101,01100101,60,00111100,161,10100001
122,01111010,8,00001000,130,10000010
60,00111100,65,01000001,125,01111101
54,00110110,80,01010000,134,10000110
79,01001111,41,00101001,120,01111000
1,00000001,104,01101000,105,01101001
127,01111111,63,00111111,190,10111110
126,01111110,14,00001110,140,10001100
20,00010100,3,00000011,23,00010111
28,00011100,96,01100000,124,01111100
56,00111000,95,01011111,151,10010111
33,00100001,30,00011110,63,00111111
91,01011011,23,00010111,114,01110010
49,00110001,61,00111101,110,01101110
126,01111110,69,01000101,195,11000011
107,01101011,117,01110101,224,11100000
31,00011111,3,00000011,34,00100010
38,00100110,55,00110111,93,01011101
114,01110010,102,01100110,216,11011000
49,00110001,78,01001110,127,01111111
2,00000010,99,01100011,101,01100101
109,01101101,87,01010111,196,11000100
12,00001100,73,01001001,85,01010101
54,00110110,95,01011111,149,10010101
86,01010110,0,00000000,86,01010110
33,00100001,99,01100011,132,10000100
98,01100010,35,00100011,133,10000101
64,01000000,44,00101100,108,01101100
93,01011101,44,00101100,137,10001001
126,01111110,16,00010000,142,10001110
66,01000010,3,00000011,69,01000101
33,00100001,47,00101111,80,01010000
21,00010101,98,01100010,119,01110111
29,00011101,123,01111011,152,10011000
57,00111001,113,01110001,170,10101010
46,00101110,80,01010000,126,01111110
1,00000001,29,00011101,30,00011110
27,00011011,18,00010010,45,00101101
39,00100111,118,01110110,157,10011101
44,00101100,84,01010100,128,10000000
10,00001010,64,01000000,74,01001010
58,00111010,33,00100001,91,01011011
44,00101100,77,01001101,121,01111001
19,00010011,124,01111100,143,10001111
78,01001110,46,00101110,124,01111100
81,01010001,85,01010101,166,10100110
77,01001101,28,00011100,105,01101001
14,00001110,66,01000010,80,01010000
115,01110011,47,00101111,162,10100010
30,00011110,50,00110010,80,01010000
62,00111110,119,01110111,181,10110101
127,01111111,33,00100001,160,10100000
74,01001010,127,01111111,201,11001001
122,01111010,104,01101000,226,11100010
101,01100101,89,01011001,190,10111110
47,00101111,108,01101100,155,10011011
107,01101011,41,00101001,148,10010100
119,01110111,33,00100001,152,10011000
0,00000000,5,00000101,5,00000101
106,01101010,62,00111110,168,10101000
43,00101011,26,00011010,69,01000101
63,00111111,41,00101001,104,01101000
27,00011011,14,00001110,41,00101001
111,01101111,112,01110000,223,11011111
2,00000010,19,00010011,21,00010101
12,00001100,112,01110000,124,01111100
31,00011111,49,00110001,80,01010000
38,00100110,94,01011110,132,10000100
54,00110110,107,01101011,161,10100001
1,00000001,122,01111010,123,01111011
33,00100001,63,00111111,96,01100000
103,01100111,49,00110001,152,10011000
80,01010000,122,01111010,202,11001010
44,00101100,114,01110010,158,10011110
12,00001100,27,00011011,39,00100111
86,01010110,110,01101110,196,11000100
110,01101110,76,01001100,186,10111010
101,01100101,115,01110011,216,11011000
13,00001101,118,01110110,131,10000011
71,01000111,35,00100011,106,01101010
108,01101100,62,00111110,170,10101010
61,00111101,86,01010110,147,10010011
107,01101011,84,01010100,191,10111111
32,00100000,61,00111101,93,01011101
126,01111110,115,01110011,241,11110001
50,00110010,31,00011111,81,01010001
53,00110101,82,01010010,135,10000111
103,01100111,59,00111011,162,10100010
51,00110011,10,00001010,61,00111101
74,01001010,102,01100110,176,10110000
92,01011100,58,00111010,150,10010110
33,00100001,95,01011111,128,10000000
60,00111100,28,00011100,88,01011000
80,01010000,105,01101001,185,10111001
124,01111100,113,01110001,237,11101101
17,00010001,80,01010000,97,01100001
90,01011010,77,01001101,167,10100111
67,01000011,70,01000110,137,10001001
17,00010001,8,00001000,25,00011001
92,01011100,87,01010111,179,10110011
39,00100111,26,00011010,65,01000001
91,01011011,34,00100010,125,01111101
31,00011111,62,00111110,93,01011101
94,01011110,41,00101001,135,10000111
95,01011111,86,01010110,181,10110101
61,00111101,11,00001011,72,01001000
100,01100100,83,01010011,183,10110111
103,01100111,51,00110011,154,10011010
30,00011110,23,00010111,53,00110101
3,00000011,59,00111011,62,00111110
127,01111111,83,01010011,210,11010010
117,01110101,97,01100001,214,11010110
59,00111011,5,00000101,64,01000000
43,00101011,26,00011010,69,01000101
115,01110011,114,01110010,229,11100101
45,00101101,21,00010101,66,01000010
58,00111010,111,01101111,169,10101001
65,01000001,67,01000011,132,10000100
43,00101011,81,01010001,124,01111100
77,01001101,48,00110000,125,01111101
98,01100010,70,01000110,168,10101000
80,01010000,78,01001110,158,10011110
44,00101100,60,00111100,104,01101000
95,01011111,37,00100101,132,10000100
89,01011001,94,01011110,183,10110111
97,01100001,62,00111110,159,10011111
18,00010010,64,01000000,82,01010010
43,00101011,86,01010110,129,10000001
115,01110011,103,01100111,218,11011010
36,00100100,66,01000010,102,01100110
81,01010001,50,00110010,131,10000011
75,01001011,1,00000001,76,01001100
10,00001010,72,01001000,82,01010010
47,00101111,97,01100001,144,10010000
51,00110011,35,00100011,86,01010110
97,01100001,77,01001101,174,10101110
71,01000111,114,01110010,185,10111001
42,00101010,46,00101110,88,01011000
107,01101011,108,01101100,215,11010111
31,00011111,42,00101010,73,01001001
126,01111110,56,00111000,182,10110110
84,01010100,89,01011001,173,10101101
116,01110100,96,01100000,212,11010100
0,00000000,125,01111101,125,01111101
65,01000001,46,00101110,111,01101111
124,01111100,67,01000011,191,10111111
66,01000010,75,01001011,141,10001101
46,00101110,120,01111000,166,10100110
100,01100100,89,01011001,189,10111101
24,00011000,62,00111110,86,01010110
70,01000110,106,01101010,176,10110000
117,01110101,126,01111110,243,11110011
51,00110011,100,01100100,151,10010111
120,01111000,93,01011101,213,11010101
86,01010110,110,01101110,196,11000100
38,00100110,100,01100100,138,10001010
13,00001101,40,00101000,53,00110101
91,01011011,109,01101101,200,11001000
43,00101011,17,00010001,60,00111100
54,00110110,109,01101101,163,10100011
72,01001000,15,00001111,87,01010111
72,01001000,66,01000010,138,10001010
24,00011000,78,01001110,102,01100110
79,01001111,42,00101010,121,01111001
115,01110011,78,01001110,193,11000001
11,00001011,48,00110000,59,00111011
120,01111000,62,00111110,182,10110110
110,01101110,42,00101010,152,10011000
93,01011101,91,01011011,184,10111000
92,01011100,89,01011001,181,10110101
109,01101101,4,00000100,113,01110001
41,00101001,80,01010000,121,01111001
48,00110000,117,01110101,165,10100101
74,01001010,124,01111100,198,11000110
76,01001100,102,01100110,178,10110010
115,01110011,76,01001100,191,10111111
56,00111000,8,00001000,64,01000000
88,01011000,55,00110111,143,10001111
58,00111010,93,01011101,151,10010111
107,01101011,106,01101010,213,11010101
44,00101100,116,01110100,160,10100000
102,01100110,60,00111100,162,10100010
62,00111110,50,00110010,112,01110000
86,01010110,92,01011100,178,10110010
91,01011011,51,00110011,142,10001110
80,01010000,1,00000001,81,01010001
24,00011000,53,00110101,77,01001101
101,01100101,24,00011000,125,01111101
67,01000011,55,00110111,122,01111010
102,01100110,43,00101011,145,10010001
95,01011111,31,00011111,126,01111110
38,00100110,82,01010010,120,01111000
77,01001101,94,01011110,171,10101011
68,01000100,9,00001001,77,01001101
93,01011101,26,00011010,119,01110111
114,01110010,99,01100011,213,11010101
35,00100011,31,00011111,66,01000010
76,01001100,17,00010001,93,01011101
72,01001000,92,01011100,164,10100100
15,00001111,92,01011100,107,01101011
40,00101000,125,01111101,165,10100101
52,00110100,127,01111111,179,10110011
98,01100010,63,00111111,161,10100001
20,00010100,82,01010010,102,01100110
47,00101111,0,00000000,47,00101111
111,01101111,83,01010011,194,11000010
12,00001100,21,00010101,33,00100001
21,00010101,50,00110010,71,01000111
58,00111010,71,01000111,129,10000001
122,01111010,114,01110010,236,11101100
22,00010110,9,00001001,31,00011111
64,01000000,81,01010001,145,10010001
5,00000101,76,01001100,81,01010001
48,00110000,1,00000001,49,00110001
61,00111101,7,00000111,68,01000100
99,01100011,92,01011100,191,10111111
57,00111001,80,01010000,137,10001001
29,00011101,98,01100010,127,01111111
65,01000001,36,00100100,101,01100101
16,00010000,44,00101100,60,00111100
92,01011100,2,00000010,94,01011110
0,00000000,19,00010011,19,00010011
106,01101010,23,00010111,129,10000001
105,01101001,18,00010010,123,01111011
4,00000100,3,00000011,7,00000111
4,00000100,109,01101101,113,01110001
125,01111101,90,01011010,215,11010111
103,01100111,79,01001111,182,10110110
6,00000110,116,01110100,122,01111010
127,01111111,90,01011010,217,11011001
1,00000001,116,01110100,117,01110101
60,00111100,70,01000110,130,10000010
32,00100000,45,00101101,77,01001101
85,01010101,69,01000101,154,10011010
13,00001101,103,01100111,116,01110100
126,01111110,26,00011010,152,10011000
26,00011010,22,00010110,48,00110000
77,01001101,52,00110100,129,10000001
104,01101000,116,01110100,220,11011100
22,00010110,16,00010000,38,00100110
24,00011000,108,01101100,132,10000100
12,00001100,77,01001101,89,01011001
43,00101011,100,01100100,143,10001111
88,01011000,39,00100111,127,01111111
125,01111101,36,00100100,161,10100001
122,01111010,106,01101010,228,11100100
109,01101101,69,01000101,178,10110010
68,01000100,104,01101000,172,10101100
119,01110111,18,00010010,137,10001001
35,00100011,1,00000001,36,00100100
122,01111010,34,00100010,156,10011100
68,01000100,108,01101100,176,10110000
88,01011000,67,01000011,155,10011011
51,00110011,112,01110000,163,10100011
89,01011001,124,01111100,213,11010101
107,01101011,73,01001001,180,10110100
21,00010101,119,01110111,140,10001100
17,00010001,15,00001111,32,00100000
31,00011111,111,01101111,142,10001110
22,00010110,21,00010101,43,00101011
64,01000000,109,01101101,173,10101101
105,01101001,127,01111111,232,11101000
88,01011000,19,00010011,107,01101011
99,01100011,100,01100100,199,11000111
1,00000001,46,00101110,47,00101111
54,00110110,123,01111011,177,10110001
43,00101011,29,00011101,72,01001000
57,00111001,22,00010110,79,01001111
28,00011100,84,01010100,112,01110000
83,01010011,49,00110001,132,10000100
50,00110010,9,00001001,59,00111011
99,01100011,34,00100010,133,10000101
82,01010010,105,01101001,187,10111011
36,00100100,116,01110100,152,10011000
41,00101001,75,01001011,116,01110100
53,00110101,87,01010111,140,10001100
79,01001111,78,01001110,157,10011101
15,00001111,113,01110001,128,10000000
86,01010110,5,00000101,91,01011011
39,00100111,33,00100001,72,01001000
37,00100101,25,00011001,62,00111110
74,01001010,86,01010110,160,10100000
28,00011100,26,00011010,54,00110110
20,00010100,101,01100101,121,01111001
7,00000111,123,01111011,130,10000010
118,01110110,96,01100000,214,11010110
2,00000010,117,01110101,119,01110111
45,00101101,109,01101101,154,10011010
78,01001110,8,00001000,86,01010110
41,00101001,14,00001110,55,00110111
4,00000100,34,00100010,38,00100110
71,01000111,17,00010001,88,01011000
6,00000110,122,01111010,128,10000000
20,00010100,71,01000111,91,01011011
16,00010000,125,01111101,141,10001101
84,01010100,74,01001010,158,10011110
29,00011101,90,01011010,119,01110111
89,01011001,41,00101001,130,10000010
92,01011100,77,01001101,169,10101001
84,01010100,89,01011001,173,10101101
22,00010110,16,00010000,38,00100110
121,01111001,5,00000101,126,01111110
98,01100010,109,01101101,207,11001111
93,01011101,26,00011010,119,01110111
114,01110010,36,00100100,150,10010110
101,01100101,39,00100111,140,10001100
12,00001100,38,00100110,50,00110010
99,01100011,68,01000100,167,10100111
47,00101111,94,01011110,141,10001101
115,01110011,19,00010011,134,10000110
55,00110111,78,01001110,133,10000101
118,01110110,69,01000101,187,10111011
123,01111011,82,01010010,205,11001101
62,00111110,13,00001101,75,01001011
58,00111010,30,00011110,88,01011000
98,01100010,17,00010001,115,01110011
124,01111100,109,01101101,233,11101001
120,01111000,29,00011101,149,10010101
72,01001000,33,00100001,105,01101001
62,00111110,64,01000000,126,01111110
66,01000010,37,00100101,103,01100111
99,01100011,70,01000110,169,10101001
116,01110100,96,01100000,212,11010100
4,00000100,114,01110010,118,01110110
10,00001010,48,00110000,58,00111010
68,01000100,19,00010011,87,01010111
101,01100101,95,01011111,196,11000100
113,01110001,87,01010111,200,11001000
115,01110011,54,00110110,169,10101001
75,01001011,49,00110001,124,01111100
66,01000010,76,01001100,142,10001110
24,00011000,65,01000001,89,01011001
70,01000110,13,00001101,83,01010011
97,01100001,61,00111101,158,10011110
38,00100110,127,01111111,165,10100101
70,01000110,103,01100111,173,10101101
105,01101001,113,01110001,218,11011010
119,01110111,102,01100110,221,11011101
46,00101110,123,01111011,169,10101001
1,00000001,104,01101000,105,01101001
103,01100111,68,01000100,171,10101011
89,01011001,94,01011110,183,10110111
32,00100000,57,00111001,89,01011001
1,00000001,114,01110010,115,01110011
91,01011011,60,00111100,151,10010111
29,00011101,29,00011101,58,00111010
14,00001110,96,01100000,110,01101110
61,00111101,9,00001001,70,01000110
94,01011110,73,01001001,167,10100111
26,00011010,112,01110000,138,10001010
77,01001101,5,00000101,82,01010010
80,01010000,11,00001011,91,01011011
10,00001010,26,00011010,36,00100100
5,00000101,64,01000000,69,01000101
17,00010001,100,01100100,117,01110101
53,00110101,35,00100011,88,01011000
97,01100001,74,01001010,171,10101011
120,01111000,0,00000000,120,01111000
88,01011000,78,01001110,166,10100110
53,00110101,115,01110011,168,10101000
38,00100110,38,00100110,76,01001100
0,00000000,69,01000101,69,01000101
118,01110110,19,00010011,137,10001001
49,00110001,5,00000101,54,00110110
54,00110110,74,01001010,128,10000000
23,00010111,98,01100010,121,01111001
57,00111001,9,00001001,66,01000010
113,01110001,111,01101111,224,11100000
87,01010111,16,00010000,103,01100111
97,01100001,20,00010100,117,01110101
55,00110111,106,01101010,161,10100001
78,01001110,61,00111101,139,10001011
35,00100011,95,01011111,130,10000010
74,01001010,51,00110011,125,01111101
85,01010101,53,00110101,138,10001010
48,00110000,17,00010001,65,01000001
13,00001101,56,00111000,69,01000101
81,01010001,66,01000010,147,10010011
107,01101011,28,00011100,135,10000111
79,01001111,90,01011010,169,10101001
4,00000100,85,01010101,89,01011001
9,00001001,109,01101101,118,01110110
101,01100101,118,01110110,219,11011011
106,01101010,56,00111000,162,10100010
73,01001001,45,00101101,118,01110110
113,01110001,115,01110011,228,11100100
20,00010100,49,00110001,69,01000101
9,00001001,39,00100111,48,00110000
101,01100101,43,00101011,144,10010000
91,01011011,7,00000111,98,01100010
90,01011010,77,01001101,167,10100111
89,01011001,94,01011110,183,10110111
108,01101100,69,01000101,177,10110001
31,00011111,114,01110010,145,10010001
118,01110110,90,01011010,208,11010000
53,00110101,80,01010000,133,10000101
76,01001100,121,01111001,197,11000101
26,00011010,58,00111010,84,01010100
76,01001100,24,00011000,100,01100100
12,00001100,33,00100001,45,00101101
21,00010101,47,00101111,68,01000100
116,01110100,125,01111101,241,11110001
37,00100101,97,01100001,134,10000110
11,00001011,125,01111101,136,10001000
43,00101011,43,00101011,86,01010110
126,01111110,92,01011100,218,11011010
68,01000100,42,00101010,110,01101110
72,01001000,69,01000101,141,10001101
16,00010000,75,01001011,91,01011011
109,01101101,20,00010100,129,10000001
120,01111000,81,01010001,201,11001001
43,00101011,2,00000010,45,00101101
8,00001000,53,00110101,61,00111101
99,01100011,54,00110110,153,10011001
5,00000101,55,00110111,60,00111100
68,01000100,3,00000011,71,01000111
68,01000100,41,00101001,109,01101101
122,01111010,114,01110010,236,11101100
16,00010000,114,01110010,130,10000010
96,01100000,115,01110011,211,11010011
124,01111100,82,01010010,206,11001110
27,00011011,117,01110101,144,10010000
102,01100110,58,00111010,160,10100000
21,00010101,41,00101001,62,00111110
60,00111100,43,00101011,103,01100111
16,00010000,3,00000011,19,00010011
115,01110011,55,00110111,170,10101010
77,01001101,53,00110101,130,10000010
4,00000100,109,01101101,113,01110001
88,01011000,55,00110111,143,10001111
87,01010111,22,00010110,109,01101101
109,01101101,54,00110110,163,10100011
50,00110010,24,00011000,74,01001010
3,00000011,66,01000010,69,01000101
32,00100000,83,01010011,115,01110011
63,00111111,87,01010111,150,10010110
20,00010100,114,01110010,134,10000110
13,00001101,36,00100100,49,00110001
83,01010011,20,00010100,103,01100111
57,00111001,34,00100010,91,01011011
103,01100111,3,00000011,106,01101010
87,01010111,60,00111100,147,10010011
53,00110101,98,01100010,151,10010111
57,00111001,91,01011011,148,10010100
1,00000001,41,00101001,42,00101010
89,01011001,19,00010011,108,01101100
47,00101111,106,01101010,153,10011001
62,00111110,80,01010000,142,10001110
43,00101011,57,00111001,100,01100100
11,00001011,45,00101101,56,00111000
20,00010100,29,00011101,49,00110001
42,00101010,71,01000111,113,01110001
50,00110010,11,00001011,61,00111101
76,01001100,123,01111011,199,11000111
18,00010010,70,01000110,88,01011000
111,01101111,72,01001000,183,10110111
76,01001100,18,00010010,94,01011110
19,00010011,64,01000000,83,01010011
116,01110100,10,00001010,126,01111110
102,01100110,91,01011011,193,11000001
92,01011100,15,00001111,107,01101011
104,01101000,35,00100011,139,10001011
84,01010100,108,01101100,192,11000000
19,00010011,111,01101111,130,10000010
22,00010110,63,00111111,85,01010101
13,00001101,125,01111101,138,10001010
12,00001100,67,01000011,79,01001111
1,00000001,87,01010111,88,01011000
68,01000100,0,00000000,68,01000100
73,01001001,85,01010101,158,10011110
18,00010010,28,00011100,46,00101110
28,00011100,16,00010000,44,00101100
89,01011001,6,00000110,95,01011111
43,00101011,78,01001110,121,01111001
36,00100100,76,01001100,112,01110000
109,01101101,8,00001000,117,01110101
8,00001000,45,00101101,53,00110101
50,00110010,44,00101100,94,01011110
36,00100100,27,00011011,63,00111111
25,00011001,68,01000100,93,01011101
56,00111000,29,00011101,85,01010101
30,00011110,37,00100101,67,01000011
101,01100101,76,01001100,177,10110001
65,01000001,38,00100110,103,01100111
14,00001110,38,00100110,52,00110100
106,01101010,13,00001101,119,01110111
37,00100101,93,01011101,130,10000010
94,01011110,39,00100111,133,10000101
123,01111011,11,00001011,134,10000110
127,01111111,33,00100001,160,10100000
59,00111011,117,01110101,176,10110000
60,00111100,47,00101111,107,01101011
120,01111000,39,00100111,159,10011111
111,01101111,111,01101111,222,11011110
105,01101001,23,00010111,128,10000000
0,00000000,112,01110000,112,01110000
117,01110101,122,01111010,239,11101111
118,01110110,2,00000010,120,01111000
43,00101011,79,01001111,122,01111010
6,00000110,73,01001001,79,01001111
125,01111101,12,00001100,137,10001001
55,00110111,47,00101111,102,01100110
98,01100010,67,01000011,165,10100101
73,01001001,26,00011010,99,01100011
47,00101111,113,01110001,160,10100000
87,01010111,109,01101101,196,11000100
62,00111110,16,00010000,78,01001110
12,00001100,76,01001100,88,01011000
56,00111000,94,01011110,150,10010110
44,00101100,16,00010000,60,00111100
58,00111010,32,00100000,90,01011010
57,00111001,103,01100111,160,10100000
66,01000010,7,00000111,73,01001001
40,00101000,100,01100100,140,10001100
56,00111000,34,00100010,90,01011010
6,00000110,114,01110010,120,01111000
118,01110110,77,01001101,195,11000011
47,00101111,115,01110011,162,10100010
118,01110110,102,01100110,220,11011100
56,00111000,7,00000111,63,00111111
106,01101010,46,00101110,152,10011000
51,00110011,17,00010001,68,01000100
16,00010000,32,00100000,48,00110000
22,00010110,21,00010101,43,00101011
76,01001100,45,00101101,121,01111001
18,00010010,16,00010000,34,00100010
41,00101001,63,00111111,104,01101000
68,01000100,97,01100001,165,10100101
63,00111111,111,01101111,174,10101110
38,00100110,107,01101011,145,10010001
102,01100110,10,00001010,112,01110000
7,00000111,86,01010110,93,01011101
70,01000110,30,00011110,100,01100100
86,01010110,52,00110100,138,10001010
50,00110010,66,01000010,116,01110100
12,00001100,29,00011101,41,00101001
59,00111011,98,01100010,157,10011101
19,00010011,24,00011000,43,00101011
77,01001101,61,00111101,138,10001010
89,01011001,84,01010100,173,10101101
116,01110100,119,01110111,235,11101011
20,00010100,60,00111100,80,01010000
56,00111000,41,00101001,97,01100001
33,00100001,30,00011110,63,00111111
111,01101111,11,00001011,122,01111010
103,01100111,25,00011001,128,10000000
22,00010110,53,00110101,75,01001011
60,00111100,79,01001111,139,10001011
57,00111001,0,00000000,57,00111001
69,01000101,117,01110101,186,10111010
106,01101010,37,00100101,143,10001111
40,00101000,42,00101010,82,01010010
124,01111100,54,00110110,178,10110010
2,00000010,40,00101000,42,00101010
120,01111000,68,01000100,188,10111100
126,01111110,57,00111001,183,10110111
41,00101001,75,01001011,116,01110100
113,01110001,54,00110110,167,10100111
36,00100100,28,00011100,64,01000000
52,00110100,97,01100001,149,10010101
9,00001001,127,01111111,136,10001000
3,00000011,94,01011110,97,01100001
75,01001011,93,01011101,168,10101000
38,00100110,111,01101111,149,10010101
16,00010000,110,01101110,126,01111110
16,00010000,31,00011111,47,00101111
57,00111001,43,00101011,100,01100100
43,00101011,1,00000001,44,00101100
49,00110001,79,01001111,128,10000000
69,01000101,49,00110001,118,01110110
59,00111011,5,00000101,64,01000000
2,00000010,96,01100000,98,01100010
2,00000010,17,00010001,19,00010011
70,01000110,31,00011111,101,01100101
8,00001000,89,01011001,97,01100001
119,01110111,90,01011010,209,11010001
38,00100110,1,00000001,39,00100111
60,00111100,23,00010111,83,01010011
108,01101100,15,00001111,123,01111011
71,01000111,123,01111011,194,11000010
74,01001010,52,00110100,126,01111110
59,00111011,43,00101011,102,01100110
108,01101100,37,00100101,145,10010001
75,01001011,105,01101001,180,10110100
69,01000101,122,01111010,191,10111111
48,00110000,95,01011111,143,10001111
32,00100000,81,01010001,113,01110001
100,01100100,75,01001011,175,10101111
89,01011001,119,01110111,208,11010000
10,00001010,51,00110011,61,00111101
80,01010000,78,01001110,158,10011110
46,00101110,34,00100010,80,01010000
124,01111100,64,01000000,188,10111100
104,01101000,14,00001110,118,01110110
28,00011100,94,01011110,122,01111010
28,00011100,113,01110001,141,10001101
63,00111111,108,01101100,171,10101011
73,01001001,27,00011011,100,01100100
25,00011001,92,01011100,117,01110101
124,01111100,125,01111101,249,11111001
52,00110100,117,01110101,169,10101001
94,01011110,78,01001110,172,10101100
74,01001010,49,00110001,123,01111011
0,00000000,43,00101011,43,00101011
23,00010111,96,01100000,119,01110111
123,01111011,114,01110010,237,11101101
99,01100011,99,01100011,198,11000110
118,01110110,97,01100001,215,11010111
127,01111111,86,01010110,213,11010101
24,00011000,2,00000010,26,00011010
53,00110101,87,01010111,140,10001100
13,00001101,60,00111100,73,01001001
3,00000011,39,00100111,42,00101010
7,00000111,46,00101110,53,00110101
101,01100101,22,00010110,123,01111011
72,01001000,4,00000100,76,01001100
34,00100010,63,00111111,97,01100001
7,00000111,51,00110011,58,00111010
22,00010110,49,00110001,71,01000111
35,00100011,68,01000100,103,01100111
68,01000100,25,00011001,93,01011101
108,01101100,97,01100001,205,11001101
117,01110101,68,01000100,185,10111001
125,01111101,9,00001001,134,10000110
29,00011101,100,01100100,129,10000001
35,00100011,54,00110110,89,01011001
27,00011011,1,00000001,28,00011100
22,00010110,72,01001000,94,01011110
62,00111110,104,01101000,166,10100110
104,01101000,56,00111000,160,10100000
82,01010010,111,01101111,193,11000001
33,00100001,17,00010001,50,00110010
118,01110110,117,01110101,235,11101011
105,01101001,38,00100110,143,10001111
108,01101100,60,00111100,168,10101000
116,01110100,53,00110101,169,10101001
78,01001110,29,00011101,107,01101011
63,00111111,125,01111101,188,10111100
120,01111000,43,00101011,163,10100011
69,01000101,112,01110000,181,10110101
50,00110010,41,00101001,91,01011011
77,01001101,44,00101100,121,01111001
54,00110110,60,00111100,114,01110010
4,00000100,26,00011010,30,00011110
29,00011101,35,00100011,64,01000000
90,01011010,73,01001001,163,10100011
68,01000100,102,01100110,170,10101010
30,00011110,104,01101000,134,10000110
123,01111011,125,01111101,248,11111000
82,01010010,74,01001010,156,10011100
85,01010101,78,01001110,163,10100011
61,00111101,48,00110000,109,01101101
60,00111100,14,00001110,74,01001010
100,01100100,9,00001001,109,01101101
91,01011011,20,00010100,111,01101111
15,00001111,66,01000010,81,01010001
19,00010011,22,00010110,41,00101001
118,01110110,0,00000000,118,01110110
117,01110101,90,01011010,207,11001111
68,01000100,37,00100101,105,01101001
57,00111001,118,01110110,175,10101111
111,01101111,22,00010110,133,10000101
57,00111001,43,00101011,100,01100100
60,00111100,35,00100011,95,01011111
76,01001100,83,01010011,159,10011111
121,01111001,87,01010111,208,11010000
27,00011011,20,00010100,47,00101111
43,00101011,41,00101001,84,01010100
112,01110000,127,01111111,239,11101111
61,00111101,54,00110110,115,01110011
54,00110110,123,01111011,177,10110001
20,00010100,112,01110000,132,10000100
2,00000010,110,01101110,112,01110000
121,01111001,23,00010111,144,10010000
34,00100010,58,00111010,92,01011100
84,01010100,0,00000000,84,01010100
11,00001011,0,00000000,11,00001011
65,01000001,83,01010011,148,10010100
7,00000111,57,00111001,64,01000000
59,00111011,20,00010100,79,01001111
59,00111011,58,00111010,117,01110101
48,00110000,75,01001011,123,01111011
119,01110111,72,01001000,191,10111111
112,01110000,36,00100100,148,10010100
57,00111001,100,01100100,157,10011101
32,00100000,43,00101011,75,01001011
73,01001001,53,00110101,126,01111110
69,01000101,21,00010101,90,01011010
6,00000110,22,00010110,28,00011100
13,00001101,109,01101101,122,01111010
68,01000100,104,01101000,172,10101100
39,00100111,104,01101000,143,10001111
44,00101100,20,00010100,64,01000000
91,01011011,69,01000101,160,10100000
113,01110001,95,01011111,208,11010000
114,01110010,70,01000110,184,10111000
73,01001001,82,01010010,155,10011011
124,01111100,88,01011000,212,11010100
11,00001011,113,01110001,124,01111100
82,01010010,110,01101110,192,11000000
5,00000101,33,00100001,38,00100110
126,01111110,116,01110100,242,11110010
41,00101001,125,01111101,166,10100110
38,00100110,22,00010110,60,00111100
4,00000100,96,01100000,100,01100100
106,01101010,37,00100101,143,10001111
84,01010100,125,01111101,209,11010001
63,00111111,6,00000110,69,01000101
112,01110000,29,00011101,141,10001101
107,01101011,31,00011111,138,10001010
36,00100100,59,00111011,95,01011111
35,00100011,46,00101110,81,01010001
53,00110101,125,01111101,178,10110010
0,00000000,113,01110001,113,01110001
79,01001111,121,01111001,200,11001000
25,00011001,35,00100011,60,00111100
107,01101011,66,01000010,173,10101101
68,01000100,42,00101010,110,01101110
21,00010101,15,00001111,36,00100100
15,00001111,10,00001010,25,00011001
52,00110100,49,00110001,101,01100101
83,01010011,70,01000110,153,10011001
27,00011011,109,01101101,136,10001000
83,01010011,111,01101111,194,11000010
49,00110001,93,01011101,142,10001110
40,00101000,24,00011000,64,01000000
71,01000111,38,00100110,109,01101101
25,00011001,108,01101100,133,10000101
34,00100010,7,00000111,41,00101001
18,00010010,8,00001000,26,00011010
41,00101001,86,01010110,127,01111111
62,00111110,63,00111111,125,01111101
11,00001011,107,01101011,118,01110110
83,01010011,78,01001110,161,10100001
31,00011111,6,00000110,37,00100101
40,00101000,102,01100110,142,10001110
85,01010101,121,01111001,206,11001110
74,01001010,105,01101001,179,10110011
51,00110011,18,00010010,69,01000101
49,00110001,59,00111011,108,01101100
113,01110001,49,00110001,162,10100010
84,01010100,127,01111111,211,11010011
108,01101100,101,01100101,209,11010001
54,00110110,9,00001001,63,00111111
121,01111001,43,00101011,164,10100100
67,01000011,57,00111001,124,01111100
127,01111111,56,00111000,183,10110111
3,00000011,119,01110111,122,01111010
66,01000010,1,00000001,67,01000011
87,01010111,60,00111100,147,10010011
31,00011111,114,01110010,145,10010001
63,00111111,55,00110111,118,01110110
35,00100011,96,01100000,131,10000011
116,01110100,43,00101011,159,10011111
5,00000101,38,00100110,43,00101011
1,00000001,89,01011001,90,01011010
105,01101001,99,01100011,204,11001100
40,00101000,33,00100001,73,01001001
45,00101101,50,00110010,95,01011111
79,01001111,17,00010001,96,01100000
26,00011010,75,01001011,101,01100101
24,00011000,113,01110001,137,10001001
116,01110100,50,00110010,166,10100110
60,00111100,8,00001000,68,01000100
49,00110001,28,00011100,77,01001101
45,00101101,102,01100110,147,10010011
38,00100110,16,00010000,54,00110110
15,00001111,107,01101011,122,01111010
114,01110010,43,00101011,157,10011101
90,01011010,37,00100101,127,01111111
50,00110010,5,00000101,55,00110111
3,00000011,112,01110000,115,01110011
37,00100101,87,01010111,124,01111100
126,01111110,51,00110011,177,10110001
127,01111111,120,01111000,247,11110111
42,00101010,8,00001000,50,00110010
105,01101001,71,01000111,176,10110000
59,00111011,97,01100001,156,10011100
61,00111101,121,01111001,182,10110110
58,00111010,11,00001011,69,01000101
112,01110000,118,01110110,230,11100110
53,00110101,79,01001111,132,10000100
26,00011010,94,01011110,120,01111000
29,00011101,82,01010010,111,01101111
104,01101000,105,01101001,209,11010001
89,01011001,32,00100000,121,01111001
8,00001000,96,01100000,104,01101000
50,00110010,125,01111101,175,10101111
76,01001100,0,00000000,76,01001100
24,00011000,127,01111111,151,10010111
22,00010110,93,01011101,115,01110011
114,01110010,17,00010001,131,10000011
60,00111100,107,01101011,167,10100111
56,00111000,31,00011111,87,01010111
80,01010000,87,01010111,167,10100111
98,01100010,89,01011001,187,10111011
89,01011001,72,01001000,161,10100001
26,00011010,71,01000111,97,01100001
83,01010011,100,01100100,183,10110111
115,01110011,123,01111011,238,11101110
89,01011001,35,00100011,124,01111100
117,01110101,77,01001101,194,11000010
18,00010010,121,01111001,139,10001011
90,01011010,39,00100111,129,10000001
115,01110011,50,00110010,165,10100101
77,01001101,2,00000010,79,01001111
83,01010011,77,01001101,160,10100000
84,01010100,44,00101100,128,10000000
41,00101001,47,00101111,88,01011000
68,01000100,83,01010011,151,10010111
57,00111001,42,00101010,99,01100011
33,00100001,107,01101011,140,10001100
58,00111010,17,00010001,75,01001011
109,01101101,103,01100111,212,11010100
65,01000001,97,01100001,162,10100010
68,01000100,110,01101110,178,10110010
78,01001110,67,01000011,145,10010001
12,00001100,63,00111111,75,01001011
50,00110010,72,01001000,122,01111010
5,00000101,121,01111001,126,01111110
95,01011111,38,00100110,133,10000101
20,00010100,123,01111011,143,10001111
43,00101011,30,00011110,73,01001001
115,01110011,82,01010010,197,11000101
113,01110001,69,01000101,182,10110110
121,01111001,94,01011110,215,11010111
15,00001111,45,00101101,60,00111100
84,01010100,102,01100110,186,10111010
114,01110010,40,00101000,154,10011010
26,00011010,51,00110011,77,01001101
123,01111011,50,00110010,173,10101101
61,00111101,49,00110001,110,01101110
95,01011111,63,00111111,158,10011110
68,01000100,116,01110100,184,10111000
18,00010010,84,01010100,102,01100110
112,01110000,29,00011101,141,10001101
94,01011110,76,01001100,170,10101010
91,01011011,85,01010101,176,10110000
60,00111100,50,00110010,110,01101110
80,01010000,114,01110010,194,11000010
50,00110010,63,00111111,113,01110001
73,01001001,75,01001011,148,10010100
102,01100110,36,00100100,138,10001010
127,01111111,43,00101011,170,10101010
118,01110110,87,01010111,205,11001101
2,00000010,126,01111110,128,10000000
73,01001001,89,01011001,162,10100010
104,01101000,104,01101000,208,11010000
93,01011101,93,01011101,186,10111010
45,00101101,89,01011001,134,10000110
42,00101010,7,00000111,49,00110001
57,00111001,57,00111001,114,01110010
38,00100110,123,01111011,161,10100001
100,01100100,59,00111011,159,10011111
70,01000110,17,00010001,87,01010111
45,00101101,122,01111010,167,10100111
75,01001011,114,01110010,189,10111101
127,01111111,74,01001010,201,11001001
114,01110010,105,01101001,219,11011011
11,00001011,15,00001111,26,00011010
81,01010001,44,00101100,125,01111101
87,01010111,62,00111110,149,10010101
33,00100001,9,00001001,42,00101010
72,01001000,20,00010100,92,01011100
111,01101111,44,00101100,155,10011011
125,01111101,60,00111100,185,10111001
77,01001101,43,00101011,120,01111000
86,01010110,122,01111010,208,11010000
111,01101111,53,00110101,164,10100100
31,00011111,102,01100110,133,10000101
8,00001000,39,00100111,47,00101111
14,00001110,61,00111101,75,01001011
71,01000111,18,00010010,89,01011001
93,01011101,9,00001001,102,01100110
2,00000010,86,01010110,88,01011000
26,00011010,18,00010010,44,00101100
72,01001000,20,00010100,92,01011100
64,01000000,123,01111011,187,10111011
54,00110110,10,00001010,64,01000000
38,00100110,94,01011110,132,10000100
52,00110100,36,00100100,88,01011000
58,00111010,112,01110000,170,10101010
109,01101101,23,00010111,132,10000100
61,00111101,61,00111101,122,01111010
93,01011101,30,00011110,123,01111011
50,00110010,65,01000001,115,01110011
27,00011011,24,00011000,51,00110011
46,00101110,36,00100100,82,01010010
51,00110011,37,00100101,88,01011000
24,00011000,73,01001001,97,01100001
67,01000011,73,01001001,140,10001100
14,00001110,31,00011111,45,00101101
52,00110100,123,01111011,175,10101111
111,01101111,69,01000101,180,10110100
35,00100011,90,01011010,125,01111101
44,00101100,77,01001101,121,01111001
84,01010100,90,01011010,174,10101110
32,00100000,49,00110001,81,01010001
117,01110101,55,00110111,172,10101100
42,00101010,111,01101111,153,10011001
98,01100010,79,01001111,177,10110001
84,01010100,95,01011111,179,10110011
3,00000011,17,00010001,20,00010100
24,00011000,121,01111001,145,10010001
99,01100011,70,01000110,169,10101001
100,01100100,52,00110100,152,10011000
109,01101101,85,01010101,194,11000010
2,00000010,35,00100011,37,00100101
17,00010001,13,00001101,30,00011110
17,00010001,120,01111000,137,10001001
100,01100100,51,00110011,151,10010111
55,00110111,5,00000101,60,00111100
101,01100101,78,01001110,179,10110011
106,01101010,36,00100100,142,10001110
15,00001111,70,01000110,85,01010101
70,01000110,122,01111010,192,11000000
4,00000100,3,00000011,7,00000111
110,01101110,45,00101101,155,10011011
60,00111100,30,00011110,90,01011010
47,00101111,33,00100001,80,01010000
92,01011100,57,00111001,149,10010101
63,00111111,63,00111111,126,01111110
87,01010111,54,00110110,141,10001101
126,01111110,79,01001111,205,11001101
27,00011011,113,01110001,140,10001100
53,00110101,29,00011101,82,01010010
30,00011110,15,00001111,45,00101101
124,01111100,87,01010111,211,11010011
46,00101110,112,01110000,158,10011110
31,00011111,37,00100101,68,01000100
96,01100000,127,01111111,223,11011111
90,01011010,82,01010010,172,10101100
100,01100100,53,00110101,153,10011001
21,00010101,91,01011011,112,01110000
78,01001110,1,00000001,79,01001111
99,01100011,79,01001111,178,10110010
57,00111001,95,01011111,152,10011000
22,00010110,35,00100011,57,00111001
93,01011101,3,00000011,96,01100000
51,00110011,123,01111011,174,10101110
54,00110110,32,00100000,86,01010110
119,01110111,53,00110101,172,10101100
104,01101000,89,01011001,193,11000001
63,00111111,114,01110010,177,10110001
21,00010101,115,01110011,136,10001000
52,00110100,2,00000010,54,00110110
11,00001011,110,01101110,121,01111001
69,01000101,126,01111110,195,11000011
31,00011111,106,01101010,137,10001001
115,01110011,29,00011101,144,10010000
61,00111101,122,01111010,183,10110111
6,00000110,37,00100101,43,00101011
0,00000000,7,00000111,7,00000111
30,00011110,73,01001001,103,01100111
98,01100010,55,00110111,153,10011001
84,01010100,81,01010001,165,10100101
124,01111100,21,00010101,145,10010001
25,00011001,22,00010110,47,00101111
44,00101100,9,00001001,53,00110101
109,01101101,107,01101011,216,11011000
22,00010110,53,00110101,75,01001011
121,01111001,126,01111110,247,11110111
36,00100100,88,01011000,124,01111100
58,00111010,0,00000000,58,00111010
89,01011001,72,01001000,161,10100001
54,00110110,15,00001111,69,01000101
96,01100000,112,01110000,208,11010000
75,01001011,110,01101110,185,10111001
124,01111100,78,01001110,202,11001010
60,00111100,103,01100111,163,10100011
42,00101010,112,01110000,154,10011010
38,00100110,46,00101110,84,01010100
109,01101101,80,01010000,189,10111101
82,01010010,61,00111101,143,10001111
28,00011100,64,01000000,92,01011100
96,01100000,66,01000010,162,10100010
48,00110000,63,00111111,111,01101111
18,00010010,101,01100101,119,01110111
47,00101111,80,01010000,127,01111111
37,00100101,90,01011010,127,01111111
6,00000110,51,00110011,57,00111001
75,01001011,1,00000001,76,01001100
115,01110011,1,00000001,116,01110100
25,00011001,108,01101100,133,10000101
61,00111101,61,00111101,122,01111010
84,01010100,102,01100110,186,10111010
76,01001100,69,01000101,145,10010001
102,01100110,51,00110011,153,10011001
82,01010010,24,00011000,106,01101010
99,01100011,36,00100100,135,10000111
40,00101000,77,01001101,117,01110101
46,00101110,36,00100100,82,01010010
27,00011011,19,00010011,46,00101110
65,01000001,101,01100101,166,10100110
39,00100111,118,01110110,157,10011101
30,00011110,91,01011011,121,01111001
38,00100110,112,01110000,150,10010110
118,01110110,114,01110010,232,11101000
74,01001010,49,00110001,123,01111011
3,00000011,85,01010101,88,01011000
2,00000010,37,00100101,39,00100111
4,00000100,41,00101001,45,00101101
68,01000100,29,00011101,97,01100001
61,00111101,93,01011101,154,10011010
28,00011100,76,01001100,104,01101000
19,00010011,9,00001001,28,00011100
77,01001101,52,00110100,129,10000001
86,01010110,38,00100110,124,01111100
36,00100100,27,00011011,63,00111111
46,00101110,89,01011001,135,10000111
79,01001111,73,01001001,152,10011000
103,01100111,32,00100000,135,10000111
68,01000100,2,00000010,70,01000110
35,00100011,17,00010001,52,00110100
10,00001010,126,01111110,136,10001000
63,00111111,72,01001000,135,10000111
82,01010010,37,00100101,119,01110111
110,01101110,75,01001011,185,10111001
31,00011111,117,01110101,148,10010100
101,01100101,97,01100001,198,11000110
80,01010000,119,01110111,199,11000111
46,00101110,121,01111001,167,10100111
50,00110010,35,00100011,85,01010101
76,01001100,68,01000100,144,10010000
101,01100101,103,01100111,204,11001100
122,01111010,97,01100001,219,11011011
1,00000001,0,00000000,1,00000001
6,00000110,42,00101010,48,00110000
40,00101000,29,00011101,69,01000101
55,00110111,101,01100101,156,10011100
1,00000001,20,00010100,21,00010101
3,00000011,70,01000110,73,01001001
39,00100111,118,01110110,157,10011101
13,00001101,21,00010101,34,00100010
40,00101000,104,01101000,144,10010000
70,01000110,9,00001001,79,01001111
105,01101001,85,01010101,190,10111110
124,01111100,105,01101001,229,11100101
90,01011010,27,00011011,117,01110101
35,00100011,16,00010000,51,00110011
37,00100101,124,01111100,161,10100001
67,01000011,124,01111100,191,10111111
124,01111100,72,01001000,196,11000100
99,01100011,81,01010001,180,10110100
124,01111100,58,00111010,182,10110110
117,01110101,70,01000110,187,10111011
8,00001000,117,01110101,125,01111101
100,01100100,77,01001101,177,10110001
88,01011000,120,01111000,208,11010000
46,00101110,50,00110010,96,01100000
101,01100101,124,01111100,225,11100001
93,01011101,115,01110011,208,11010000
11,00001011,111,01101111,122,01111010
28,00011100,72,01001000,100,01100100
121,01111001,111,01101111,232,11101000
21,00010101,36,00100100,57,00111001
40,00101000,33,00100001,73,01001001
102,01100110,60,00111100,162,10100010
113,01110001,62,00111110,175,10101111
3,00000011,79,01001111,82,01010010
125,01111101,36,00100100,161,10100001
89,01011001,71,01000111,160,10100000
82,01010010,21,00010101,103,01100111
63,00111111,126,01111110,189,10111101
57,00111001,3,00000011,60,00111100
47,00101111,82,01010010,129,10000001
87,01010111,100,01100100,187,10111011
47,00101111,96,01100000,143,10001111
23,00010111,58,00111010,81,01010001
95,01011111,109,01101101,204,11001100
42,00101010,93,01011101,135,10000111
80,01010000,100,01100100,180,10110100
46,00101110,68,01000100,114,01110010
6,00000110,49,00110001,55,00110111
85,01010101,112,01110000,197,11000101
67,01000011,3,00000011,70,01000110
96,01100000,62,00111110,158,10011110
81,01010001,21,00010101,102,01100110
109,01101101,6,00000110,115,01110011
41,00101001,84,01010100,125,01111101
92,01011100,0,00000000,92,01011100
5,00000101,50,00110010,55,00110111
29,00011101,113,01110001,142,10001110
67,01000011,114,01110010,181,10110101
92,01011100,107,01101011,199,11000111
56,00111000,19,00010011,75,01001011
2,00000010,74,01001010,76,01001100
18,00010010,75,01001011,93,01011101
50,00110010,43,00101011,93,01011101
62,00111110,0,00000000,62,00111110
10,00001010,47,00101111,57,00111001
16,00010000,92,01011100,108,01101100
43,00101011,12,00001100,55,00110111
93,01011101,81,01010001,174,10101110
10,00001010,65,01000001,75,01001011
5,00000101,39,00100111,44,00101100
92,01011100,125,01111101,217,11011001
8,00001000,96,01100000,104,01101000
40,00101000,15,00001111,55,00110111
1,00000001,38,00100110,39,00100111
33,00100001,47,00101111,80,01010000
62,00111110,111,01101111,173,10101101
55,00110111,77,01001101,132,10000100
43,00101011,121,01111001,164,10100100
30,00011110,73,01001001,103,01100111
43,00101011,116,01110100,159,10011111
29,00011101,6,00000110,35,00100011
19,00010011,22,00010110,41,00101001
22,00010110,40,00101000,62,00111110
86,01010110,75,01001011,161,10100001
117,01110101,68,01000100,185,10111001
14,00001110,36,00100100,50,00110010
73,01001001,13,00001101,86,01010110
79,01001111,10,00001010,89,01011001
87,01010111,42,00101010,129,10000001
124,01111100,83,01010011,207,11001111
88,01011000,89,01011001,177,10110001
42,00101010,68,01000100,110,01101110
0,00000000,60,00111100,60,00111100
101,01100101,87,01010111,188,10111100
126,01111110,70,01000110,196,11000100
91,01011011,118,01110110,209,11010001
72,01001000,71,01000111,143,10001111
45,00101101,110,01101110,155,10011011
85,01010101,10,00001010,95,01011111
5,00000101,104,01101000,109,01101101
21,00010101,57,00111001,78,01001110
0,00000000,124,01111100,124,01111100
55,00110111,62,00111110,117,01110101
109,01101101,57,00111001,166,10100110
42,00101010,73,01001001,115,01110011
59,00111011,99,01100011,158,10011110
84,01010100,40,00101000,124,01111100
1,00000001,96,01100000,97,01100001
52,00110100,100,01100100,152,10011000
124,01111100,36,00100100,160,10100000
86,01010110,81,01010001,167,10100111
24,00011000,106,01101010,130,10000010
43,00101011,42,00101010,85,01010101
12,00001100,39,00100111,51,00110011
98,01100010,95,01011111,193,11000001
127,01111111,85,01010101,212,11010100
41,00101001,64,01000000,105,01101001
31,00011111,87,01010111,118,01110110
93,01011101,95,01011111,188,10111100
66,01000010,37,00100101,103,01100111
46,00101110,16,00010000,62,00111110
63,00111111,120,01111000,183,10110111
74,01001010,26,00011010,100,01100100
84,01010100,21,00010101,105,01101001
64,01000000,39,00100111,103,01100111
2,00000010,37,00100101,39,00100111
78,01001110,90,01011010,168,10101000
75,01001011,17,00010001,92,01011100
4,00000100,121,01111001,125,01111101
40,00101000,2,00000010,42,00101010
126,01111110,28,00011100,154,10011010
0,00000000,51,00110011,51,00110011
69,01000101,51,00110011,120,01111000
126,01111110,44,00101100,170,10101010
31,00011111,48,00110000,79,01001111
127,01111111,58,00111010,185,10111001
25,00011001,50,00110010,75,01001011
23,00010111,6,00000110,29,00011101
42,00101010,47,00101111,89,01011001
12,00001100,55,00110111,67,01000011
41,00101001,106,01101010,147,10010011
52,00110100,42,00101010,94,01011110
27,00011011,100,01100100,127,01111111
44,00101100,62,00111110,106,01101010
119,01110111,32,00100000,151,10010111
107,01101011,86,01010110,193,11000001
1,00000001,95,01011111,96,01100000
72,01001000,19,00010011,91,01011011
20,00010100,62,00111110,82,01010010
0,00000000,107,01101011,107,01101011
55,00110111,17,00010001,72,01001000
19,00010011,69,01000101,88,01011000
98,01100010,28,00011100,126,01111110
58,00111010,29,00011101,87,01010111
103,01100111,77,01001101,180,10110100
45,00101101,120,01111000,165,10100101
95,01011111,111,01101111,206,11001110
122,01111010,55,00110111,177,10110001
26,00011010,40,00101000,66,01000010
26,00011010,85,01010101,111,01101111
64,01000000,80,01010000,144,10010000
25,00011001,30,00011110,55,00110111
90,01011010,67,01000011,157,10011101
68,01000100,5,00000101,73,01001001
98,01100010,46,00101110,144,10010000
72,01001000,74,01001010,146,10010010
110,01101110,34,00100010,144,10010000
112,01110000,105,01101001,217,11011001
114,01110010,126,01111110,240,11110000
77,01001101,60,00111100,137,10001001
82,01010010,60,00111100,142,10001110
74,01001010,62,00111110,136,10001000
12,00001100,105,01101001,117,01110101
35,00100011,57,00111001,92,01011100
8,00001000,114,01110010,122,01111010
29,00011101,54,00110110,83,01010011
4,00000100,42,00101010,46,00101110
93,01011101,48,00110000,141,10001101
11,00001011,55,00110111,66,01000010
54,00110110,14,00001110,68,01000100
98,01100010,103,01100111,201,11001001
0,00000000,104,01101000,104,01101000
76,01001100,125,01111101,201,11001001
20,00010100,56,00111000,76,01001100
29,00011101,78,01001110,107,01101011
108,01101100,22,00010110,130,10000010
84,01010100,1,00000001,85,01010101
47,00101111,62,00111110,109,01101101
35,00100011,121,01111001,156,10011100
26,00011010,117,01110101,143,10001111
53,00110101,41,00101001,94,01011110
115,01110011,75,01001011,190,10111110
12,00001100,103,01100111,115,01110011
77,01001101,111,01101111,188,10111100
68,01000100,3,00000011,71,01000111
71,01000111,106,01101010,177,10110001
75,01001011,109,01101101,184,10111000
43,00101011,72,01001000,115,01110011
26,00011010,64,01000000,90,01011010
7,00000111,64,01000000,71,01000111
118,01110110,4,00000100,122,01111010
100,01100100,47,00101111,147,10010011
94,01011110,53,00110101,147,10010011
76,01001100,14,00001110,90,01011010
64,01000000,47,00101111,111,01101111
81,01010001,85,01010101,166,10100110
77,01001101,126,01111110,203,11001011
40,00101000,27,00011011,67,01000011
123,01111011,53,00110101,176,10110000
126,01111110,56,00111000,182,10110110
99,01100011,90,01011010,189,10111101
22,00010110,88,01011000,110,01101110
25,00011001,27,00011011,52,00110100
80,01010000,69,01000101,149,10010101
81,01010001,99,01100011,180,10110100
96,01100000,119,01110111,215,11010111
19,00010011,96,01100000,115,01110011
29,00011101,18,00010010,47,00101111
22,00010110,112,01110000,134,10000110
69,01000101,19,00010011,88,01011000
93,01011101,44,00101100,137,10001001
38,00100110,107,01101011,145,10010001
123,01111011,54,00110110,177,10110001
71,01000111,29,00011101,100,01100100
114,01110010,6,00000110,120,01111000
10,00001010,100,01100100,110,01101110
46,00101110,119,01110111,165,10100101
112,01110000,74,01001010,186,10111010
85,01010101,21,00010101,106,01101010
126,01111110,99,01100011,225,11100001
29,00011101,34,00100010,63,00111111
28,00011100,1,00000001,29,00011101
48,00110000,57,00111001,105,01101001
77,01001101,39,00100111,116,01110100
61,00111101,4,00000100,65,01000001
66,01000010,73,01001001,139,10001011
44,00101100,43,00101011,87,01010111
82,01010010,4,00000100,86,01010110
124,01111100,104,01101000,228,11100100
112,01110000,97,01100001,209,11010001
100,01100100,122,01111010,222,11011110
44,00101100,100,01100100,144,10010000
51,00110011,113,01110001,164,10100100
101,01100101,102,01100110,203,11001011
15,00001111,63,00111111,78,01001110
49,00110001,62,00111110,111,01101111
12,00001100,40,00101000,52,00110100
84,01010100,16,00010000,100,01100100
81,01010001,90,01011010,171,10101011
101,01100101,46,00101110,147,10010011
105,01101001,119,01110111,224,11100000
44,00101100,107,01101011,151,10010111
107,01101011,47,00101111,154,10011010
96,01100000,21,00010101,117,01110101
112,01110000,34,00100010,146,10010010
73,01001001,125,01111101,198,11000110
108,01101100,40,00101000,148,10010100
29,00011101,92,01011100,121,01111001
7,00000111,87,01010111,94,01011110
66,01000010,10,00001010,76,01001100
25,00011001,85,01010101,110,01101110
40,00101000,6,00000110,46,00101110
82,01010010,16,00010000,98,01100010
11,00001011,45,00101101,56,00111000
24,00011000,22,00010110,46,00101110
59,00111011,67,01000011,126,01111110
107,01101011,94,01011110,201,11001001
45,00101101,104,01101000,149,10010101
7,00000111,2,00000010,9,00001001
29,00011101,72,01001000,101,01100101
49,00110001,120,01111000,169,10101001
29,00011101,2,00000010,31,00011111
6,00000110,62,00111110,68,01000100
52,00110100,90,01011010,142,10001110
1,00000001,125,01111101,126,01111110
95,01011111,104,01101000,199,11000111
43,00101011,106,01101010,149,10010101
61,00111101,111,01101111,172,10101100
77,01001101,46,00101110,123,01111011
117,01110101,72,01001000,189,10111101
69,01000101,75,01001011,144,10010000
31,00011111,34,00100010,65,01000001
64,01000000,126,01111110,190,10111110
12,00001100,44,00101100,56,00111000
84,01010100,116,01110100,200,11001000
14,00001110,98,01100010,112,01110000
29,00011101,93,01011101,122,01111010
54,00110110,29,00011101,83,01010011
1,00000001,82,01010010,83,01010011
27,00011011,73,01001001,100,01100100
43,00101011,116,01110100,159,10011111
124,01111100,88,01011000,212,11010100
104,01101000,29,00011101,133,10000101
12,00001100,33,00100001,45,00101101
74,01001010,63,00111111,137,10001001
49,00110001,12,00001100,61,00111101
6,00000110,70,01000110,76,01001100
122,01111010,30,00011110,152,10011000
106,01101010,69,01000101,175,10101111
100,01100100,29,00011101,129,10000001
26,00011010,60,00111100,86,01010110
29,00011101,18,00010010,47,00101111
124,01111100,71,01000111,195,11000011
20,00010100,88,01011000,108,01101100
32,00100000,63,00111111,95,01011111
94,01011110,91,01011011,185,10111001
24,00011000,124,01111100,148,10010100
3,00000011,5,00000101,8,00001000
13,00001101,107,01101011,120,01111000
69,01000101,17,00010001,86,01010110
88,01011000,83,01010011,171,10101011
48,00110000,89,01011001,137,10001001
121,01111001,4,00000100,125,01111101
17,00010001,126,01111110,143,10001111
33,00100001,24,00011000,57,00111001
100,01100100,100,01100100,200,11001000
37,00100101,31,00011111,68,01000100
84,01010100,52,00110100,136,10001000
83,01010011,18,00010010,101,01100101
78,01001110,28,00011100,106,01101010
114,01110010,90,01011010,204,11001100
120,01111000,122,01111010,242,11110010
79,01001111,104,01101000,183,10110111
1,00000001,77,01001101,78,01001110
126,01111110,30,00011110,156,10011100
123,01111011,81,01010001,204,11001100
52,00110100,63,00111111,115,01110011
37,00100101,38,00100110,75,01001011
30,00011110,42,00101010,72,01001000
113,01110001,100,01100100,213,11010101
10,00001010,104,01101000,114,01110010
81,01010001,46,00101110,127,01111111
120,01111000,53,00110101,173,10101101
119,01110111,16,00010000,135,10000111
58,00111010,20,00010100,78,01001110
46,00101110,78,01001110,124,01111100
96,01100000,12,00001100,108,01101100
75,01001011,4,00000100,79,01001111
17,00010001,19,00010011,36,00100100
46,00101110,19,00010011,65,01000001
9,00001001,8,00001000,17,00010001
106,01101010,20,00010100,126,01111110
103,01100111,46,00101110,149,10010101
111,01101111,122,01111010,233,11101001
112,01110000,86,01010110,198,11000110
6,00000110,115,01110011,121,01111001
31,00011111,89,01011001,120,01111000
102,01100110,98,01100010,200,11001000
57,00111001,73,01001001,130,10000010
81,01010001,19,00010011,100,01100100
20,00010100,60,00111100,80,01010000
79,01001111,13,00001101,92,01011100
120,01111000,48,00110000,168,10101000
67,01000011,6,00000110,73,01001001
11,00001011,122,01111010,133,10000101
47,00101111,15,00001111,62,00111110
79,01001111,72,01001000,151,10010111
37,00100101,50,00110010,87,01010111
81,01010001,28,00011100,109,01101101
86,01010110,33,00100001,119,01110111
124,01111100,45,00101101,169,10101001
69,01000101,66,01000010,135,10000111
87,01010111,63,00111111,150,10010110
32,00100000,84,01010100,116,01110100
126,01111110,23,00010111,149,10010101
14,00001110,71,01000111,85,01010101
69,01000101,116,01110100,185,10111001
51,00110011,39,00100111,90,01011010
9,00001001,34,00100010,43,00101011
51,00110011,63,00111111,114,01110010
122,01111010,102,01100110,224,11100000
57,00111001,95,01011111,152,10011000
27,00011011,57,00111001,84,01010100
88,01011000,37,00100101,125,01111101
47,00101111,118,01110110,165,10100101
62,00111110,44,00101100,106,01101010
19,00010011,113,01110001,132,10000100
110,01101110,116,01110100,226,11100010
4,00000100,8,00001000,12,00001100
48,00110000,125,01111101,173,10101101
47,00101111,116,01110100,163,10100011
40,00101000,10,00001010,50,00110010
34,00100010,58,00111010,92,01011100
54,00110110,45,00101101,99,01100011
12,00001100,62,00111110,74,01001010
2,00000010,30,00011110,32,00100000
47,00101111,71,01000111,118,01110110
14,00001110,4,00000100,18,00010010
75,01001011,120,01111000,195,11000011
89,01011001,121,01111001,210,11010010
29,00011101,51,00110011,80,01010000
16,00010000,5,00000101,21,00010101
74,01001010,126,01111110,200,11001000
61,00111101,29,00011101,90,01011010
9,00001001,4,00000100,13,00001101
97,01100001,110,01101110,207,11001111
14,00001110,83,01010011,97,01100001
90,01011010,80,01010000,170,10101010
92,01011100,112,01110000,204,11001100
100,01100100,94,01011110,194,11000010
73,01001001,32,00100000,105,01101001
80,01010000,24,00011000,104,01101000
86,01010110,102,01100110,188,10111100
79,01001111,35,00100011,114,01110010
48,00110000,16,00010000,64,01000000
117,01110101,11,00001011,128,10000000
52,00110100,86,01010110,138,10001010
81,01010001,54,00110110,135,10000111
82,01010010,100,01100100,182,10110110
94,01011110,56,00111000,150,10010110
127,01111111,121,01111001,248,11111000
22,00010110,40,00101000,62,00111110
16,00010000,12,00001100,28,00011100
39,00100111,22,00010110,61,00111101
70,01000110,85,01010101,155,10011011
98,01100010,88,01011000,186,10111010
122,01111010,73,01001001,195,11000011
119,01110111,122,01111010,241,11110001
63,00111111,67,01000011,130,10000010
52,00110100,78,01001110,130,10000010
17,00010001,22,00010110,39,00100111
46,00101110,31,00011111,77,01001101
49,00110001,29,00011101,78,01001110
9,00001001,92,01011100,101,01100101
52,00110100,1,00000001,53,00110101
21,00010101,99,01100011,120,01111000
33,00100001,98,01100010,131,10000011
11,00001011,120,01111000,131,10000011
69,01000101,42,00101010,111,01101111
51,00110011,13,00001101,64,01000000
38,00100110,47,00101111,85,01010101
14,00001110,31,00011111,45,00101101
61,00111101,92,01011100,153,10011001
92,01011100,89,01011001,181,10110101
115,01110011,117,01110101,232,11101000
66,01000010,125,01111101,191,10111111
83,01010011,45,00101101,128,10000000
42,00101010,22,00010110,64,01000000
27,00011011,11,00001011,38,00100110
121,01111001,54,00110110,175,10101111
29,00011101,112,01110000,141,10001101
107,01101011,77,01001101,184,10111000
37,00100101,52,00110100,89,01011001
94,01011110,99,01100011,193,11000001
81,01010001,32,00100000,113,01110001
46,00101110,59,00111011,105,01101001
6,00000110,25,00011001,31,00011111
89,01011001,71,01000111,160,10100000
103,01100111,31,00011111,134,10000110
103,01100111,13,00001101,116,01110100
51,00110011,24,00011000,75,01001011
81,01010001,119,01110111,200,11001000
58,00111010,93,01011101,151,10010111
22,00010110,28,00011100,50,00110010
104,01101000,52,00110100,156,10011100
78,01001110,104,01101000,182,10110110
25,00011001,111,01101111,136,10001000
107,01101011,20,00010100,127,01111111
67,01000011,75,01001011,142,10001110
125,01111101,13,00001101,138,10001010
0,00000000,101,01100101,101,01100101
18,00010010,41,00101001,59,00111011
0,00000000,76,01001100,76,01001100
33,00100001,30,00011110,63,00111111
3,00000011,35,00100011,38,00100110
26,00011010,126,01111110,152,10011000
80,01010000,44,00101100,124,01111100
46,00101110,3,00000011,49,00110001
105,01101001,59,00111011,164,10100100
64,01000000,1,00000001,65,01000001
7,00000111,94,01011110,101,01100101
88,01011000,31,00011111,119,01110111
67,01000011,112,01110000,179,10110011
54,00110110,123,01111011,177,10110001
112,01110000,98,01100010,210,11010010
70,01000110,8,00001000,78,01001110
0,00000000,23,00010111,23,00010111
24,00011000,94,01011110,118,01110110
103,01100111,90,01011010,193,11000001
90,01011010,37,00100101,127,01111111
44,00101100,75,01001011,119,01110111
14,00001110,61,00111101,75,01001011
31,00011111,109,01101101,140,10001100
9,00001001,112,01110000,121,01111001
14,00001110,106,01101010,120,01111000
74,01001010,75,01001011,149,10010101
31,00011111,29,00011101,60,00111100
50,00110010,13,00001101,63,00111111
19,00010011,96,01100000,115,01110011
115,01110011,48,00110000,163,10100011
30,00011110,101,01100101,131,10000011
88,01011000,126,01111110,214,11010110
15,00001111,40,00101000,55,00110111
11,00001011,100,01100100,111,01101111
127,01111111,75,01001011,202,11001010
73,01001001,64,01000000,137,10001001
89,01011001,81,01010001,170,10101010
64,01000000,39,00100111,103,01100111
118,01110110,58,00111010,176,10110000
111,01101111,71,01000111,182,10110110
47,00101111,5,00000101,52,00110100
68,01000100,40,00101000,108,01101100
88,01011000,26,00011010,114,01110010
110,01101110,82,01010010,192,11000000
105,01101001,76,01001100,181,10110101
73,01001001,18,00010010,91,01011011
9,00001001,100,01100100,109,01101101
57,00111001,1,00000001,58,00111010
55,00110111,46,00101110,101,01100101
59,00111011,43,00101011,102,01100110
56,00111000,52,00110100,108,01101100
69,01000101,27,00011011,96,01100000
29,00011101,42,00101010,71,01000111
88,01011000,124,01111100,212,11010100
25,00011001,109,01101101,134,10000110
53,00110101,114,01110010,167,10100111
111,01101111,82,01010010,193,11000001
37,00100101,20,00010100,57,00111001
94,01011110,55,00110111,149,10010101
65,01000001,14,00001110,79,01001111
30,00011110,90,01011010,120,01111000
103,01100111,104,01101000,207,11001111
68,01000100,56,00111000,124,01111100
21,00010101,96,01100000,117,01110101
119,01110111,69,01000101,188,10111100
61,00111101,50,00110010,111,01101111
32,00100000,50,00110010,82,01010010
65,01000001,33,00100001,98,01100010
62,00111110,25,00011001,87,01010111
114,01110010,61,00111101,175,10101111
97,01100001,21,00010101,118,01110110
101,01100101,54,00110110,155,10011011
124,01111100,41,00101001,165,10100101
34,00100010,19,00010011,53,00110101
104,01101000,98,01100010,202,11001010
46,00101110,27,00011011,73,01001001
12,00001100,114,01110010,126,01111110
36,00100100,69,01000101,105,01101001
35,00100011,5,00000101,40,00101000
98,01100010,30,00011110,128,10000000
65,01000001,96,01100000,161,10100001
3,00000011,50,00110010,53,00110101
54,00110110,70,01000110,124,01111100
87,01010111,33,00100001,120,01111000
43,00101011,17,00010001,60,00111100
52,00110100,86,01010110,138,10001010
29,00011101,121,01111001,150,10010110
90,01011010,75,01001011,165,10100101
111,01101111,87,01010111,198,11000110
60,00111100,104,01101000,164,10100100
42,00101010,96,01100000,138,10001010
116,01110100,66,01000010,182,10110110
121,01111001,78,01001110,199,11000111
13,00001101,47,00101111,60,00111100
14,00001110,67,01000011,81,01010001
110,01101110,43,00101011,153,10011001
123,01111011,15,00001111,138,10001010
84,01010100,17,00010001,101,01100101
5,00000101,39,00100111,44,00101100
48,00110000,109,01101101,157,10011101
65,01000001,17,00010001,82,01010010
80,01010000,5,00000101,85,01010101
42,00101010,74,01001010,116,01110100
91,01011011,22,00010110,113,01110001
106,01101010,47,00101111,153,10011001
79,01001111,15,00001111,94,01011110
13,00001101,5,00000101,18,00010010
25,00011001,12,00001100,37,00100101
20,00010100,80,01010000,100,01100100
27,00011011,126,01111110,153,10011001
28,00011100,65,01000001,93,01011101
91,01011011,22,00010110,113,01110001
112,01110000,113,01110001,225,11100001
26,00011010,48,00110000,74,01001010
42,00101010,3,00000011,45,00101101
21,00010101,81,01010001,102,01100110
115,01110011,127,01111111,242,11110010
93,01011101,64,01000000,157,10011101
4,00000100,103,01100111,107,01101011
88,01011000,108,01101100,196,11000100
95,01011111,35,00100011,130,10000010
61,00111101,113,01110001,174,10101110
54,00110110,66,01000010,120,01111000
89,01011001,30,00011110,119,01110111
81,01010001,48,00110000,129,10000001
8,00001000,16,00010000,24,00011000
120,01111000,30,00011110,150,10010110
67,01000011,110,01101110,177,10110001
23,00010111,96,01100000,119,01110111
47,00101111,11,00001011,58,00111010
45,00101101,91,01011011,136,10001000
36,00100100,127,01111111,163,10100011
28,00011100,41,00101001,69,01000101
91,01011011,7,00000111,98,01100010
60,00111100,53,00110101,113,01110001
120,01111000,109,01101101,229,11100101
120,01111000,95,01011111,215,11010111
82,01010010,33,00100001,115,01110011
46,00101110,17,00010001,63,00111111
108,01101100,5,00000101,113,01110001
93,01011101,102,01100110,195,11000011
41,00101001,58,00111010,99,01100011
75,01001011,101,01100101,176,10110000
104,01101000,8,00001000,112,01110000
108,01101100,100,01100100,208,11010000
90,01011010,89,01011001,179,10110011
28,00011100,90,01011010,118,01110110
30,00011110,90,01011010,120,01111000
114,01110010,0,00000000,114,01110010
40,00101000,121,01111001,161,10100001
25,00011001,39,00100111,64,01000000
6,00000110,3,00000011,9,00001001
44,00101100,75,01001011,119,01110111
38,00100110,42,00101010,80,01010000
117,01110101,70,01000110,187,10111011
96,01100000,62,00111110,158,10011110
86,01010110,23,00010111,109,01101101
4,00000100,66,01000010,70,01000110
44,00101100,103,01100111,147,10010011
57,00111001,63,00111111,120,01111000
78,01001110,27,00011011,105,01101001
1,00000001,109,01101101,110,01101110
79,01001111,46,00101110,125,01111101
55,00110111,111,01101111,166,10100110
20,00010100,8,00001000,28,00011100
104,01101000,123,01111011,227,11100011
16,00010000,21,00010101,37,00100101
118,01110110,34,00100010,152,10011000
37,00100101,88,01011000,125,01111101
3,00000011,86,01010110,89,01011001
127,01111111,98,01100010,225,11100001
78,01001110,107,01101011,185,10111001
11,00001011,0,00000000,11,00001011
29,00011101,116,01110100,145,10010001
77,01001101,51,00110011,128,10000000
22,00010110,102,01100110,124,01111100
26,00011010,122,01111010,148,10010100
53,00110101,114,01110010,167,10100111
29,00011101,39,00100111,68,01000100
55,00110111,114,01110010,169,10101001
7,00000111,67,01000011,74,01001010
44,00101100,84,01010100,128,10000000
95,01011111,111,01101111,206,11001110
7,00000111,120,01111000,127,01111111
78,01001110,13,00001101,91,01011011
105,01101001,94,01011110,199,11000111
113,01110001,66,01000010,179,10110011
121,01111001,122,01111010,243,11110011
6,00000110,91,01011011,97,01100001
7,00000111,105,01101001,112,01110000
5,00000101,99,01100011,104,01101000
44,00101100,102,01100110,146,10010010
75,01001011,117,01110101,192,11000000
36,00100100,33,00100001,69,01000101
107,01101011,53,00110101,160,10100000
90,01011010,25,00011001,115,01110011
12,00001100,92,01011100,104,01101000
55,00110111,72,01001000,127,01111111
44,00101100,75,01001011,119,01110111
106,01101010,1,00000001,107,01101011
60,00111100,42,00101010,102,01100110
53,00110101,18,00010010,71,01000111
67,01000011,2,00000010,69,01000101
121,01111001,38,00100110,159,10011111
8,00001000,86,01010110,94,01011110
99,01100011,68,01000100,167,10100111
42,00101010,79,01001111,121,01111001
30,00011110,17,00010001,47,00101111
62,00111110,101,01100101,163,10100011
68,01000100,22,00010110,90,01011010
115,01110011,46,00101110,161,10100001
114,01110010,6,00000110,120,01111000
25,00011001,86,01010110,111,01101111
115,01110011,56,00111000,171,10101011
99,01100011,60,00111100,159,10011111
69,01000101,60,00111100,129,10000001
42,00101010,90,01011010,132,10000100
6,00000110,100,01100100,106,01101010
42,00101010,35,00100011,77,01001101
52,00110100,24,00011000,76,01001100
16,00010000,79,01001111,95,01011111
83,01010011,29,00011101,112,01110000
65,01000001,30,00011110,95,01011111
68,01000100,106,01101010,174,10101110
121,01111001,56,00111000,177,10110001
96,01100000,56,00111000,152,10011000
19,00010011,88,01011000,107,01101011
112,01110000,57,00111001,169,10101001
50,00110010,115,01110011,165,10100101
114,01110010,51,00110011,165,10100101
107,01101011,2,00000010,109,01101101
45,00101101,29,00011101,74,01001010
13,00001101,2,00000010,15,00001111
44,00101100,112,01110000,156,10011100
1,00000001,48,00110000,49,00110001
15,00001111,68,01000100,83,01010011
99,01100011,50,00110010,149,10010101
79,01001111,62,00111110,141,10001101
22,00010110,20,00010100,42,00101010
97,01100001,34,00100010,131,10000011
66,01000010,31,00011111,97,01100001
126,01111110,3,00000011,129,10000001
5,00000101,85,01010101,90,01011010
109,01101101,63,00111111,172,10101100
127,01111111,44,00101100,171,10101011
42,00101010,11,00001011,53,00110101
1,00000001,83,01010011,84,01010100
85,01010101,106,01101010,191,10111111
24,00011000,17,00010001,41,00101001
103,01100111,99,01100011,202,11001010
114,01110010,43,00101011,157,10011101
120,01111000,12,00001100,132,10000100
123,01111011,45,00101101,168,10101000
45,00101101,63,00111111,108,01101100
1,00000001,89,01011001,90,01011010
124,01111100,90,01011010,214,11010110
95,01011111,104,01101000,199,11000111
63,00111111,0,00000000,63,00111111
10,00001010,49,00110001,59,00111011
39,00100111,21,00010101,60,00111100
76,01001100,47,00101111,123,01111011
98,01100010,12,00001100,110,01101110
119,01110111,43,00101011,162,10100010
39,00100111,83,01010011,122,01111010
46,00101110,46,00101110,92,01011100
102,01100110,56,00111000,158,10011110
65,01000001,68,01000100,133,10000101
48,00110000,98,01100010,146,10010010
98,01100010,88,01011000,186,10111010
40,00101000,84,01010100,124,01111100
8,00001000,30,00011110,38,00100110
19,00010011,28,00011100,47,00101111
103,01100111,45,00101101,148,10010100
86,01010110,8,00001000,94,01011110
14,00001110,9,00001001,23,00010111
127,01111111,109,01101101,236,11101100
22,00010110,53,00110101,75,01001011
53,00110101,14,00001110,67,01000011
15,00001111,50,00110010,65,01000001
123,01111011,48,00110000,171,10101011
67,01000011,66,01000010,133,10000101
6,00000110,30,00011110,36,00100100
33,00100001,118,01110110,151,10010111
29,00011101,112,01110000,141,10001101
115,01110011,84,01010100,199,11000111
75,01001011,91,01011011,166,10100110
116,01110100,104,01101000,220,11011100
64,01000000,40,00101000,104,01101000
90,01011010,87,01010111,177,10110001
36,00100100,89,01011001,125,01111101
93,01011101,87,01010111,180,10110100
60,00111100,70,01000110,130,10000010
28,00011100,100,01100100,128,10000000
123,01111011,10,00001010,133,10000101
28,00011100,3,00000011,31,00011111
52,00110100,90,01011010,142,10001110
127,01111111,27,00011011,154,10011010
119,01110111,86,01010110,205,11001101
85,01010101,25,00011001,110,01101110
1,00000001,126,01111110,127,01111111
111,01101111,58,00111010,169,10101001
36,00100100,64,01000000,100,01100100
93,01011101,125,01111101,218,11011010
95,01011111,108,01101100,203,11001011
22,00010110,109,01101101,131,10000011
75,01001011,1,00000001,76,01001100
53,00110101,0,00000000,53,00110101
15,00001111,69,01000101,84,01010100
43,00101011,32,00100000,75,01001011
119,01110111,100,01100100,219,11011011
125,01111101,90,01011010,215,11010111
16,00010000,24,00011000,40,00101000
34,00100010,125,01111101,159,10011111
104,01101000,68,01000100,172,10101100
61,00111101,88,01011000,149,10010101
113,01110001,52,00110100,165,10100101
67,01000011,7,00000111,74,01001010
119,01110111,89,01011001,208,11010000
32,00100000,52,00110100,84,01010100
34,00100010,89,01011001,123,01111011
78,01001110,12,00001100,90,01011010
3,00000011,78,01001110,81,01010001
63,00111111,45,00101101,108,01101100
113,01110001,125,01111101,238,11101110
73,01001001,118,01110110,191,10111111
11,00001011,57,00111001,68,01000100
31,00011111,2,00000010,33,00100001
87,01010111,74,01001010,161,10100001
87,01010111,15,00001111,102,01100110
20,00010100,72,01001000,92,01011100
55,00110111,7,00000111,62,00111110
2,00000010,102,01100110,104,01101000
109,01101101,30,00011110,139,10001011
51,00110011,113,01110001,164,10100100
116,01110100,78,01001110,194,11000010
124,01111100,33,00100001,157,10011101
112,01110000,10,00001010,122,01111010
27,00011011,96,01100000,123,01111011
25,00011001,100,01100100,125,01111101
31,00011111,99,01100011,130,10000010
115,01110011,14,00001110,129,10000001
116,01110100,10,00001010,126,01111110
88,01011000,100,01100100,188,10111100
93,01011101,7,00000111,100,01100100
49,00110001,95,01011111,144,10010000
115,01110011,80,01010000,195,11000011
125,01111101,83,01010011,208,11010000
8,00001000,102,01100110,110,01101110
115,01110011,39,00100111,154,10011010
102,01100110,44,00101100,146,10010010
102,01100110,112,01110000,214,11010110
122,01111010,111,01101111,233,11101001
1,00000001,25,00011001,26,00011010
64,01000000,85,01010101,149,10010101
44,00101100,9,00001001,53,00110101
114,01110010,96,01100000,210,11010010
110,01101110,89,01011001,199,11000111
3,00000011,113,01110001,116,01110100
10,00001010,76,01001100,86,01010110
74,01001010,101,01100101,175,10101111
46,00101110,44,00101100,90,01011010
48,00110000,123,01111011,171,10101011
79,01001111,22,00010110,101,01100101
105,01101001,8,00001000,113,01110001
100,01100100,104,01101000,204,11001100
56,00111000,106,01101010,162,10100010
65,01000001,101,01100101,166,10100110
50,00110010,20,00010100,70,01000110
24,00011000,116,01110100,140,10001100
89,01011001,65,01000001,154,10011010
71,01000111,80,01010000,151,10010111
64,01000000,116,01110100,180,10110100
8,00001000,82,01010010,90,01011010
36,00100100,22,00010110,58,00111010
102,01100110,118,01110110,220,11011100
82,01010010,61,00111101,143,10001111
52,00110100,118,01110110,170,10101010
90,01011010,53,00110101,143,10001111
10,00001010,10,00001010,20,00010100
52,00110100,59,00111011,111,01101111
111,01101111,44,00101100,155,10011011
48,00110000,83,01010011,131,10000011
122,01111010,42,00101010,164,10100100
16,00010000,103,01100111,119,01110111
125,01111101,46,00101110,171,10101011
36,00100100,110,01101110,146,10010010
76,01001100,91,01011011,167,10100111
99,01100011,16,00010000,115,01110011
7,00000111,9,00001001,16,00010000
106,01101010,57,00111001,163,10100011
69,01000101,6,00000110,75,01001011
35,00100011,112,01110000,147,10010011
16,00010000,71,01000111,87,01010111
94,01011110,109,01101101,203,11001011
64,01000000,55,00110111,119,01110111
71,01000111,3,00000011,74,01001010
47,00101111,3,00000011,50,00110010
24,00011000,1,00000001,25,00011001
5,00000101,36,00100100,41,00101001
22,00010110,89,01011001,111,01101111
5,00000101,53,00110101,58,00111010
14,00001110,127,01111111,141,10001101
79,01001111,37,00100101,116,01110100
50,00110010,66,01000010,116,01110100
93,01011101,51,00110011,144,10010000
58,00111010,66,01000010,124,01111100
71,01000111,127,01111111,198,11000110
71,01000111,16,00010000,87,01010111
20,00010100,103,01100111,123,01111011
82,01010010,45,00101101,127,01111111
105,01101001,118,01110110,223,11011111
90,01011010,102,01100110,192,11000000
26,00011010,78,01001110,104,01101000
90,01011010,124,01111100,214,11010110
100,01100100,1,00000001,101,01100101
76,01001100,10,00001010,86,01010110
17,00010001,13,00001101,30,00011110
15,00001111,49,00110001,64,01000000
78,01001110,35,00100011,113,01110001
2,00000010,84,01010100,86,01010110
13,00001101,103,01100111,116,01110100
8,00001000,15,00001111,23,00010111
20,00010100,127,01111111,147,10010011
20,00010100,18,00010010,38,00100110
7,00000111,94,01011110,101,01100101
91,01011011,120,01111000,211,11010011
75,01001011,2,00000010,77,01001101
0,00000000,47,00101111,47,00101111
64,01000000,93,01011101,157,10011101
42,00101010,118,01110110,160,10100000
114,01110010,99,01100011,213,11010101
42,00101010,28,00011100,70,01000110
122,01111010,82,01010010,204,11001100
37,00100101,9,00001001,46,00101110
9,00001001,32,00100000,41,00101001
109,01101101,31,00011111,140,10001100
55,00110111,120,01111000,175,10101111
70,01000110,79,01001111,149,10010101
85,01010101,101,01100101,186,10111010
92,01011100,43,00101011,135,10000111
58,00111010,68,01000100,126,01111110
70,01000110,62,00111110,132,10000100
118,01110110,95,01011111,213,11010101
70,01000110,63,00111111,133,10000101
106,01101010,100,01100100,206,11001110
111,01101111,104,01101000,215,11010111
112,01110000,114,01110010,226,11100010
27,00011011,104,01101000,131,10000011
59,00111011,47,00101111,106,01101010
87,01010111,91,01011011,178,10110010
26,00011010,29,00011101,55,00110111
1,00000001,77,01001101,78,01001110
38,00100110,79,01001111,117,01110101
122,01111010,92,01011100,214,11010110
103,01100111,93,01011101,196,11000100
35,00100011,76,01001100,111,01101111
24,00011000,33,00100001,57,00111001
111,01101111,106,01101010,217,11011001
2,00000010,104,01101000,106,01101010
62,00111110,109,01101101,171,10101011
63,00111111,53,00110101,116,01110100
48,00110000,44,00101100,92,01011100
37,00100101,16,00010000,53,00110101
39,00100111,80,01010000,119,01110111
46,00101110,58,00111010,104,01101000
36,00100100,1,00000001,37,00100101
93,01011101,85,01010101,178,10110010
77,01001101,65,01000001,142,10001110
32,00100000,32,00100000,64,01000000
10,00001010,30,00011110,40,00101000
63,00111111,35,00100011,98,01100010
78,01001110,83,01010011,161,10100001
2,00000010,35,00100011,37,00100101
54,00110110,48,00110000,102,01100110
63,00111111,41,00101001,104,01101000
37,00100101,30,00011110,67,01000011
33,00100001,13,00001101,46,00101110
21,00010101,117,01110101,138,10001010
30,00011110,12,00001100,42,00101010
51,00110011,90,01011010,141,10001101
79,01001111,29,00011101,108,01101100
71,01000111,45,00101101,116,01110100
111,01101111,79,01001111,190,10111110
10,00001010,104,01101000,114,01110010
119,01110111,127,01111111,246,11110110
24,00011000,81,01010001,105,01101001
91,01011011,43,00101011,134,10000110
67,01000011,12,00001100,79,01001111
52,00110100,42,00101010,94,01011110
121,01111001,81,01010001,202,11001010
35,00100011,35,00100011,70,01000110
23,00010111,114,01110010,137,10001001
124,01111100,51,00110011,175,10101111
120,01111000,61,00111101,181,10110101
92,01011100,68,01000100,160,10100000
50,00110010,111,01101111,161,10100001
38,00100110,69,01000101,107,01101011
79,01001111,14,00001110,93,01011101
102,01100110,55,00110111,157,10011101
85,01010101,76,01001100,161,10100001
61,00111101,43,00101011,104,01101000
80,01010000,104,01101000,184,10111000
83,01010011,122,01111010,205,11001101
51,00110011,24,00011000,75,01001011
81,01010001,51,00110011,132,10000100
59,00111011,43,00101011,102,01100110
73,01001001,5,00000101,78,01001110
114,01110010,99,01100011,213,11010101
25,00011001,73,01001001,98,01100010
68,01000100,81,01010001,149,10010101
93,01011101,74,01001010,167,10100111
85,01010101,113,01110001,198,11000110
29,00011101,40,00101000,69,01000101
57,00111001,25,00011001,82,01010010
41,00101001,68,01000100,109,01101101
65,01000001,58,00111010,123,01111011
38,00100110,108,01101100,146,10010010
2,00000010,96,01100000,98,01100010
50,00110010,1,00000001,51,00110011
118,01110110,46,00101110,164,10100100
118,01110110,113,01110001,231,11100111
113,01110001,14,00001110,127,01111111
17,00010001,66,01000010,83,01010011
3,00000011,15,00001111,18,00010010
71,01000111,85,01010101,156,10011100
43,00101011,71,01000111,114,01110010
52,00110100,17,00010001,69,01000101
27,00011011,40,00101000,67,01000011
20,00010100,63,00111111,83,01010011
117,01110101,16,00010000,133,10000101
113,01110001,107,01101011,220,11011100
29,00011101,105,01101001,134,10000110
92,01011100,71,01000111,163,10100011
69,01000101,7,00000111,76,01001100
122,01111010,50,00110010,172,10101100
104,01101000,37,00100101,141,10001101
89,01011001,64,01000000,153,10011001
90,01011010,112,01110000,202,11001010
45,00101101,11,00001011,56,00111000
80,01010000,20,00010100,100,01100100
20,00010100,28,00011100,48,00110000
55,00110111,113,01110001,168,10101000
18,00010010,73,01001001,91,01011011
98,01100010,67,01000011,165,10100101
1,00000001,69,01000101,70,01000110
99,01100011,19,00010011,118,01110110
92,01011100,19,00010011,111,01101111
44,00101100,50,00110010,94,01011110
3,00000011,19,00010011,22,00010110
53,00110101,117,01110101,170,10101010
10,00001010,113,01110001,123,01111011
100,01100100,99,01100011,199,11000111
61,00111101,82,01010010,143,10001111
17,00010001,106,01101010,123,01111011
61,00111101,54,00110110,115,01110011
53,00110101,92,01011100,145,10010001
100,01100100,15,00001111,115,01110011
37,00100101,50,00110010,87,01010111
118,01110110,38,00100110,156,10011100
11,00001011,79,01001111,90,01011010
106,01101010,54,00110110,160,10100000
53,00110101,72,01001000,125,01111101
61,00111101,107,01101011,168,10101000
89,01011001,79,01001111,168,10101000
79,01001111,64,01000000,143,10001111
47,00101111,53,00110101,100,01100100
122,01111010,104,01101000,226,11100010
84,01010100,109,01101101,193,11000001
79,01001111,41,00101001,120,01111000
41,00101001,25,00011001,66,01000010
76,01001100,80,01010000,156,10011100
82,01010010,45,00101101,127,01111111
91,01011011,25,00011001,116,01110100
110,01101110,15,00001111,125,01111101
52,00110100,36,00100100,88,01011000
76,01001100,78,01001110,154,10011010
119,01110111,73,01001001,192,11000000
28,00011100,40,00101000,68,01000100
41,00101001,93,01011101,134,10000110
45,00101101,10,00001010,55,00110111
30,00011110,8,00001000,38,00100110
102,01100110,4,00000100,106,01101010
115,01110011,78,01001110,193,11000001
104,01101000,24,00011000,128,10000000
103,01100111,72,01001000,175,10101111
85,01010101,17,00010001,102,01100110
106,01101010,7,00000111,113,01110001
9,00001001,104,01101000,113,01110001
85,01010101,1,00000001,86,01010110
31,00011111,25,00011001,56,00111000
56,00111000,41,00101001,97,01100001
54,00110110,92,01011100,146,10010010
5,00000101,97,01100001,102,01100110
7,00000111,112,01110000,119,01110111
43,00101011,108,01101100,151,10010111
41,00101001,76,01001100,117,01110101
2,00000010,22,00010110,24,00011000
98,01100010,114,01110010,212,11010100
6,00000110,122,01111010,128,10000000
88,01011000,44,00101100,132,10000100
20,00010100,90,01011010,110,01101110
51,00110011,123,01111011,174,10101110
113,01110001,118,01110110,231,11100111
43,00101011,67,01000011,110,01101110
15,00001111,45,00101101,60,00111100
98,01100010,92,01011100,190,10111110
52,00110100,98,01100010,150,10010110
89,01011001,0,00000000,89,01011001
51,00110011,123,01111011,174,10101110
122,01111010,6,00000110,128,10000000
46,00101110,50,00110010,96,01100000
114,01110010,24,00011000,138,10001010
2,00000010,41,00101001,43,00101011
70,01000110,54,00110110,124,01111100
95,01011111,29,00011101,124,01111100
31,00011111,104,01101000,135,10000111
78,01001110,44,00101100,122,01111010
55,00110111,70,01000110,125,01111101
119,01110111,10,00001010,129,10000001
4,00000100,61,00111101,65,01000001
47,00101111,65,01000001,112,01110000
39,00100111,26,00011010,65,01000001
3,00000011,101,01100101,104,01101000
58,00111010,96,01100000,154,10011010
17,00010001,119,01110111,136,10001000
90,01011010,10,00001010,100,01100100
25,00011001,31,00011111,56,00111000
41,00101001,64,01000000,105,01101001
37,00100101,118,01110110,155,10011011
101,01100101,32,00100000,133,10000101
12,00001100,108,01101100,120,01111000
108,01101100,40,00101000,148,10010100
32,00100000,55,00110111,87,01010111
45,00101101,117,01110101,162,10100010
24,00011000,105,01101001,129,10000001
34,00100010,39,00100111,73,01001001
30,00011110,54,00110110,84,01010100
51,00110011,47,00101111,98,01100010
109,01101101,35,00100011,144,10010000
65,01000001,108,01101100,173,10101101
123,01111011,2,00000010,125,01111101
122,01111010,83,01010011,205,11001101
89,01011001,121,01111001,210,11010010
9,00001001,8,00001000,17,00010001
60,00111100,98,01100010,158,10011110
125,01111101,47,00101111,172,10101100
118,01110110,1,00000001,119,01110111
4,00000100,69,01000101,73,01001001
24,00011000,37,00100101,61,00111101
5,00000101,51,00110011,56,00111000
71,01000111,106,01101010,177,10110001
120,01111000,28,00011100,148,10010100
117,01110101,67,01000011,184,10111000
126,01111110,13,00001101,139,10001011
37,00100101,64,01000000,101,01100101
11,00001011,117,01110101,128,10000000
84,01010100,60,00111100,144,10010000
59,00111011,97,01100001,156,10011100
29,00011101,86,01010110,115,01110011
90,01011010,71,01000111,161,10100001
97,01100001,38,00100110,135,10000111
100,01100100,17,00010001,117,01110101
9,00001001,109,01101101,118,01110110
25,00011001,37,00100101,62,00111110
124,01111100,81,01010001,205,11001101
27,00011011,90,01011010,117,01110101
90,01011010,78,01001110,168,10101000
54,00110110,94,01011110,148,10010100
39,00100111,51,00110011,90,01011010
113,01110001,102,01100110,215,11010111
103,01100111,124,01111100,227,11100011
69,01000101,120,01111000,189,10111101
41,00101001,125,01111101,166,10100110
3,00000011,60,00111100,63,00111111
78,01001110,26,00011010,104,01101000
86,01010110,120,01111000,206,11001110
117,01110101,50,00110010,167,10100111
83,01010011,46,00101110,129,10000001
74,01001010,109,01101101,183,10110111
86,01010110,114,01110010,200,11001000
76,01001100,83,01010011,159,10011111
29,00011101,97,01100001,126,01111110
120,01111000,112,01110000,232,11101000
67,01000011,90,01011010,157,10011101
92,01011100,47,00101111,139,10001011
99,01100011,35,00100011,134,10000110
51,00110011,73,01001001,124,01111100
92,01011100,85,01010101,177,10110001
56,00111000,14,00001110,70,01000110
79,01001111,120,01111000,199,11000111
30,00011110,115,01110011,145,10010001
125,01111101,49,00110001,174,10101110
8,00001000,112,01110000,120,01111000
59,00111011,20,00010100,79,01001111
90,01011010,53,00110101,143,10001111
123,01111011,14,00001110,137,10001001
28,00011100,40,00101000,68,01000100
92,01011100,83,01010011,175,10101111
116,01110100,35,00100011,151,10010111
3,00000011,115,01110011,118,01110110
77,01001101,80,01010000,157,10011101
37,00100101,75,01001011,112,01110000
78,01001110,74,01001010,152,10011000
54,00110110,89,01011001,143,10001111
35,00100011,89,01011001,124,01111100
46,00101110,33,00100001,79,01001111
73,01001001,90,01011010,163,10100011
74,01001010,90,01011010,164,10100100
6,00000110,105,01101001,111,01101111
127,01111111,36,00100100,163,10100011
29,00011101,19,00010011,48,00110000
67,01000011,52,00110100,119,01110111
34,00100010,104,01101000,138,10001010
114,01110010,104,01101000,218,11011010
127,01111111,66,01000010,193,11000001
115,01110011,71,01000111,186,10111010
93,01011101,114,01110010,207,11001111
17,00010001,48,00110000,65,01000001
55,00110111,41,00101001,96,01100000
54,00110110,93,01011101,147,10010011
22,00010110,33,00100001,55,00110111
77,01001101,17,00010001,94,01011110
7,00000111,46,00101110,53,00110101
36,00100100,68,01000100,104,01101000
27,00011011,20,00010100,47,00101111
106,01101010,6,00000110,112,01110000
113,01110001,75,01001011,188,10111100
46,00101110,23,00010111,69,01000101
73,01001001,120,01111000,193,11000001
117,01110101,94,01011110,211,11010011
57,00111001,39,00100111,96,01100000
15,00001111,12,00001100,27,00011011
26,00011010,120,01111000,146,10010010
5,00000101,126,01111110,131,10000011
101,01100101,69,01000101,170,10101010
56,00111000,82,01010010,138,10001010
13,00001101,53,00110101,66,01000010
126,01111110,64,01000000,190,10111110
117,01110101,18,00010010,135,10000111
59,00111011,126,01111110,185,10111001
28,00011100,102,01100110,130,10000010
5,00000101,83,01010011,88,01011000
81,01010001,45,00101101,126,01111110
46,00101110,60,00111100,106,01101010
102,01100110,25,00011001,127,01111111
29,00011101,14,00001110,43,00101011
122,01111010,67,01000011,189,10111101
98,01100010,49,00110001,147,10010011
67,01000011,39,00100111,106,01101010
75,01001011,40,00101000,115,01110011
41,00101001,85,01010101,126,01111110
28,00011100,88,01011000,116,01110100
70,01000110,10,00001010,80,01010000
81,01010001,65,01000001,146,10010010
18,00010010,79,01001111,97,01100001
99,01100011,124,01111100,223,11011111
76,01001100,101,01100101,177,10110001
60,00111100,3,00000011,63,00111111
53,00110101,5,00000101,58,00111010
62,00111110,58,00111010,120,01111000
81,01010001,75,01001011,156,10011100
62,00111110,124,01111100,186,10111010
51,00110011,45,00101101,96,01100000
20,00010100,71,01000111,91,01011011
126,01111110,59,00111011,185,10111001
90,01011010,33,00100001,123,01111011
99,01100011,91,01011011,190,10111110
90,01011010,38,00100110,128,10000000
101,01100101,26,00011010,127,01111111
90,01011010,46,00101110,136,10001000
86,01010110,0,00000000,86,01010110
84,01010100,117,01110101,201,11001001
68,01000100,79,01001111,147,10010011
124,01111100,70,01000110,194,11000010
91,01011011,127,01111111,218,11011010
21,00010101,91,01011011,112,01110000
46,00101110,14,00001110,60,00111100
87,01010111,13,00001101,100,01100100
124,01111100,127,01111111,251,11111011
33,00100001,126,01111110,159,10011111
10,00001010,52,00110100,62,00111110
92,01011100,51,00110011,143,10001111
111,01101111,120,01111000,231,11100111
45,00101101,90,01011010,135,10000111
32,00100000,125,01111101,157,10011101
21,00010101,11,00001011,32,00100000
83,01010011,107,01101011,190,10111110
121,01111001,20,00010100,141,10001101
39,00100111,73,01001001,112,01110000
106,01101010,22,00010110,128,10000000
100,01100100,92,01011100,192,11000000
117,01110101,16,00010000,133,10000101
99,01100011,112,01110000,211,11010011
0,00000000,89,01011001,89,01011001
100,01100100,47,00101111,147,10010011
56,00111000,78,01001110,134,10000110
85,01010101,124,01111100,209,11010001
57,00111001,95,01011111,152,10011000
74,01001010,97,01100001,171,10101011
57,00111001,36,00100100,93,01011101
31,00011111,40,00101000,71,01000111
119,01110111,6,00000110,125,01111101
22,00010110,35,00100011,57,00111001
17,00010001,70,01000110,87,01010111
3,00000011,41,00101001,44,00101100
11,00001011,11,00001011,22,00010110
17,00010001,122,01111010,139,10001011
55,00110111,121,01111001,176,10110000
104,01101000,66,01000010,170,10101010
26,00011010,7,00000111,33,00100001
82,01010010,113,01110001,195,11000011
49,00110001,67,01000011,116,01110100
7,00000111,124,01111100,131,10000011
111,01101111,55,00110111,166,10100110
43,00101011,62,00111110,105,01101001
14,00001110,73,01001001,87,01010111
109,01101101,19,00010011,128,10000000
113,01110001,91,01011011,204,11001100
8,00001000,76,01001100,84,01010100
114,01110010,21,00010101,135,10000111
126,01111110,81,01010001,207,11001111
59,00111011,1,00000001,60,00111100
89,01011001,123,01111011,212,11010100
100,01100100,87,01010111,187,10111011
59,00111011,68,01000100,127,01111111
58,00111010,31,00011111,89,01011001
100,01100100,24,00011000,124,01111100
40,00101000,18,00010010,58,00111010
87,01010111,32,00100000,119,01110111
120,01111000,1,00000001,121,01111001
103,01100111,93,01011101,196,11000100
49,00110001,27,00011011,76,01001100
79,01001111,61,00111101,140,10001100
68,01000100,34,00100010,102,01100110
68,01000100,68,01000100,136,10001000
64,01000000,109,01101101,173,10101101
124,01111100,29,00011101,153,10011001
22,00010110,54,00110110,76,01001100
31,00011111,16,00010000,47,00101111
4,00000100,4,00000100,8,00001000
55,00110111,95,01011111,150,10010110
94,01011110,109,01101101,203,11001011
55,00110111,71,01000111,126,01111110
66,01000010,11,00001011,77,01001101
98,01100010,94,01011110,192,11000000
118,01110110,39,00100111,157,10011101
49,00110001,126,01111110,175,10101111
98,01100010,37,00100101,135,10000111
14,00001110,61,00111101,75,01001011
125,01111101,6,00000110,131,10000011
120,01111000,65,01000001,185,10111001
112,01110000,99,01100011,211,11010011
77,01001101,3,00000011,80,01010000
35,00100011,90,01011010,125,01111101
110,01101110,22,00010110,132,10000100
63,00111111,11,00001011,74,01001010
30,00011110,103,01100111,133,10000101
66,01000010,125,01111101,191,10111111
26,00011010,64,01000000,90,01011010
76,01001100,8,00001000,84,01010100
119,01110111,65,01000001,184,10111000
123,01111011,127,01111111,250,11111010
47,00101111,28,00011100,75,01001011
53,00110101,53,00110101,106,01101010
119,01110111,127,01111111,246,11110110
24,00011000,3,00000011,27,00011011
31,00011111,25,00011001,56,00111000
50,00110010,85,01010101,135,10000111
57,00111001,98,01100010,155,10011011
78,01001110,87,01010111,165,10100101
53,00110101,53,00110101,106,01101010
45,00101101,116,01110100,161,10100001
64,01000000,49,00110001,113,01110001
4,00000100,111,01101111,115,01110011
38,00100110,112,01110000,150,10010110
127,01111111,87,01010111,214,11010110
108,01101100,116,01110100,224,11100000
91,01011011,110,01101110,201,11001001
80,01010000,1,00000001,81,01010001
99,01100011,67,01000011,166,10100110
84,01010100,98,01100010,182,10110110
7,00000111,103,01100111,110,01101110
108,01101100,118,01110110,226,11100010
80,01010000,98,01100010,178,10110010
14,00001110,66,01000010,80,01010000
20,00010100,21,00010101,41,00101001
37,00100101,71,01000111,108,01101100
25,00011001,64,01000000,89,01011001
66,01000010,51,00110011,117,01110101
84,01010100,88,01011000,172,10101100
38,00100110,80,01010000,118,01110110
82,01010010,25,00011001,107,01101011
112,01110000,124,01111100,236,11101100
107,01101011,123,01111011,230,11100110
37,00100101,30,00011110,67,01000011
36,00100100,71,01000111,107,01101011
69,01000101,3,00000011,72,01001000
76,01001100,25,00011001,101,01100101
85,01010101,49,00110001,134,10000110
57,00111001,2,00000010,59,00111011
75,01001011,93,01011101,168,10101000
55,00110111,65,01000001,120,01111000
52,00110100,91,01011011,143,10001111
54,00110110,76,01001100,130,10000010
95,01011111,79,01001111,174,10101110
30,00011110,23,00010111,53,00110101
60,00111100,124,01111100,184,10111000
99,01100011,5,00000101,104,01101000
88,01011000,41,00101001,129,10000001
80,01010000,78,01001110,158,10011110
3,00000011,123,01111011,126,01111110
103,01100111,38,00100110,141,10001101
109,01101101,69,01000101,178,10110010
93,01011101,82,01010010,175,10101111
91,01011011,124,01111100,215,11010111
100,01100100,62,00111110,162,10100010
3,00000011,92,01011100,95,01011111
15,00001111,127,01111111,142,10001110
124,01111100,3,00000011,127,01111111
77,01001101,23,00010111,100,01100100
118,01110110,39,00100111,157,10011101
37,00100101,0,00000000,37,00100101
97,01100001,106,01101010,203,11001011
35,00100011,64,01000000,99,01100011
46,00101110,114,01110010,160,10100000
1,00000001,125,01111101,126,01111110
46,00101110,104,01101000,150,10010110
52,00110100,60,00111100,112,01110000
32,00100000,39,00100111,71,01000111
126,01111110,77,01001101,203,11001011
1,00000001,3,00000011,4,00000100
16,00010000,53,00110101,69,01000101
91,01011011,46,00101110,137,10001001
3,00000011,20,00010100,23,00010111
88,01011000,30,00011110,118,01110110
97,01100001,111,01101111,208,11010000
49,00110001,19,00010011,68,01000100
109,01101101,6,00000110,115,01110011
99,01100011,45,00101101,144,10010000
102,01100110,66,01000010,168,10101000
61,00111101,126,01111110,187,10111011
126,01111110,71,01000111,197,11000101
114,01110010,33,00100001,147,10010011
16,00010000,108,01101100,124,01111100
40,00101000,28,00011100,68,01000100
64,01000000,92,01011100,156,10011100
77,01001101,102,01100110,179,10110011
37,00100101,116,01110100,153,10011001
24,00011000,123,01111011,147,10010011
44,00101100,14,00001110,58,00111010
29,00011101,73,01001001,102,01100110
19,00010011,93,01011101,112,01110000
32,00100000,74,01001010,106,01101010
116,01110100,69,01000101,185,10111001
58,00111010,79,01001111,137,10001001
114,01110010,58,00111010,172,10101100
54,00110110,75,01001011,129,10000001
65,01000001,11,00001011,76,01001100
57,00111001,7,00000111,64,01000000
10,00001010,77,01001101,87,01010111
52,00110100,25,00011001,77,01001101
15,00001111,15,00001111,30,00011110
125,01111101,57,00111001,182,10110110
78,01001110,61,00111101,139,10001011
59,00111011,46,00101110,105,01101001
22,00010110,6,00000110,28,00011100
81,01010001,27,00011011,108,01101100
58,00111010,63,00111111,121,01111001
39,00100111,27,00011011,66,01000010
109,01101101,49,00110001,158,10011110
16,00010000,14,00001110,30,00011110
83,01010011,102,01100110,185,10111001
23,00010111,35,00100011,58,00111010
29,00011101,45,00101101,74,01001010
25,00011001,49,00110001,74,01001010
45,00101101,116,01110100,161,10100001
30,00011110,124,01111100,154,10011010
8,00001000,4,00000100,12,00001100
71,01000111,11,00001011,82,01010010
95,01011111,46,00101110,141,10001101
48,00110000,107,01101011,155,10011011
62,00111110,38,00100110,100,01100100
28,00011100,123,01111011,151,10010111
111,01101111,122,01111010,233,11101001
113,01110001,24,00011000,137,10001001
57,00111001,112,01110000,169,10101001
92,01011100,62,00111110,154,10011010
118,01110110,1,00000001,119,01110111
33,00100001,80,01010000,113,01110001
25,00011001,76,01001100,101,01100101
121,01111001,126,01111110,247,11110111
59,00111011,76,01001100,135,10000111
100,01100100,21,00010101,121,01111001
11,00001011,4,00000100,15,00001111
36,00100100,99,01100011,135,10000111
71,01000111,49,00110001,120,01111000
6,00000110,21,00010101,27,00011011
20,00010100,65,01000001,85,01010101
50,00110010,106,01101010,156,10011100
105,01101001,31,00011111,136,10001000
36,00100100,42,00101010,78,01001110
45,00101101,116,01110100,161,10100001
10,00001010,95,01011111,105,01101001
86,01010110,38,00100110,124,01111100
96,01100000,49,00110001,145,10010001
68,01000100,101,01100101,169,10101001
40,00101000,47,00101111,87,01010111
93,01011101,54,00110110,147,10010011
113,01110001,50,00110010,163,10100011
112,01110000,77,01001101,189,10111101
88,01011000,65,01000001,153,10011001
48,00110000,9,00001001,57,00111001
47,00101111,8,00001000,55,00110111
21,00010101,123,01111011,144,10010000
30,00011110,28,00011100,58,00111010
125,01111101,72,01001000,197,11000101
124,01111100,125,01111101,249,11111001
103,01100111,37,00100101,140,10001100
122,01111010,62,00111110,184,10111000
21,00010101,68,01000100,89,01011001
69,01000101,84,01010100,153,10011001
99,01100011,6,00000110,105,01101001
120,01111000,86,01010110,206,11001110
12,00001100,95,01011111,107,01101011
93,01011101,78,01001110,171,10101011
90,01011010,51,00110011,141,10001101
88,01011000,93,01011101,181,10110101
60,00111100,89,01011001,149,10010101
124,01111100,77,01001101,201,11001001
3,00000011,64,01000000,67,01000011
119,01110111,2,00000010,121,01111001
55,00110111,40,00101000,95,01011111
85,01010101,7,00000111,92,01011100
38,00100110,25,00011001,63,00111111
70,01000110,95,01011111,165,10100101
32,00100000,45,00101101,77,01001101
13,00001101,106,01101010,119,01110111
85,01010101,95,01011111,180,10110100
119,01110111,61,00111101,180,10110100
25,00011001,108,01101100,133,10000101
77,01001101,53,00110101,130,10000010
45,00101101,67,01000011,112,01110000
45,00101101,113,01110001,158,10011110
101,01100101,113,01110001,214,11010110
108,01101100,77,01001101,185,10111001
39,00100111,90,01011010,129,10000001
36,00100100,77,01001101,113,01110001
17,00010001,30,00011110,47,00101111
115,01110011,100,01100100,215,11010111
103,01100111,115,01110011,218,11011010
34,00100010,76,01001100,110,01101110
4,00000100,86,01010110,90,01011010
81,01010001,55,00110111,136,10001000
104,01101000,58,00111010,162,10100010
99,01100011,72,01001000,171,10101011
89,01011001,76,01001100,165,10100101
27,00011011,27,00011011,54,00110110
109,01101101,22,00010110,131,10000011
10,00001010,87,01010111,97,01100001
111,01101111,27,00011011,138,10001010
89,01011001,35,00100011,124,01111100
82,01010010,0,00000000,82,01010010
92,01011100,67,01000011,159,10011111
53,00110101,41,00101001,94,01011110
123,01111011,126,01111110,249,11111001
27,00011011,47,00101111,74,01001010
4,00000100,18,00010010,22,00010110
6,00000110,77,01001101,83,01010011
82,01010010,43,00101011,125,01111101
8,00001000,89,01011001,97,01100001
17,00010001,51,00110011,68,01000100
80,01010000,84,01010100,164,10100100
81,01010001,77,01001101,158,10011110
0,00000000,82,01010010,82,01010010
37,00100101,30,00011110,67,01000011
84,01010100,105,01101001,189,10111101
52,00110100,7,00000111,59,00111011
71,01000111,60,00111100,131,10000011
7,00000111,78,01001110,85,01010101
6,00000110,40,00101000,46,00101110
79,01001111,6,00000110,85,01010101
69,01000101,6,00000110,75,01001011
87,01010111,22,00010110,109,01101101
50,00110010,92,01011100,142,10001110
75,01001011,40,00101000,115,01110011
7,00000111,35,00100011,42,00101010
18,00010010,48,00110000,66,01000010
126,01111110,15,00001111,141,10001101
11,00001011,82,01010010,93,01011101
68,01000100,120,01111000,188,10111100
91,01011011,116,01110100,207,11001111
65,01000001,71,01000111,136,10001000
19,00010011,75,01001011,94,01011110
70,01000110,96,01100000,166,10100110
69,01000101,45,00101101,114,01110010
39,00100111,116,01110100,155,10011011
83,01010011,126,01111110,209,11010001
68,01000100,21,00010101,89,01011001
28,00011100,49,00110001,77,01001101
24,00011000,102,01100110,126,01111110
11,00001011,117,01110101,128,10000000
83,01010011,97,01100001,180,10110100
44,00101100,103,01100111,147,10010011
79,01001111,14,00001110,93,01011101
19,00010011,40,00101000,59,00111011
100,01100100,77,01001101,177,10110001
60,00111100,104,01101000,164,10100100
122,01111010,105,01101001,227,11100011
50,00110010,52,00110100,102,01100110
125,01111101,90,01011010,215,11010111
56,00111000,95,01011111,151,10010111
50,00110010,39,00100111,89,01011001
39,00100111,59,00111011,98,01100010
43,00101011,37,00100101,80,01010000
7,00000111,56,00111000,63,00111111
76,01001100,42,00101010,118,01110110
97,01100001,80,01010000,177,10110001
18,00010010,98,01100010,116,01110100
49,00110001,70,01000110,119,01110111
89,01011001,127,01111111,216,11011000
75,01001011,85,01010101,160,10100000
99,01100011,57,00111001,156,10011100
83,01010011,109,01101101,192,11000000
27,00011011,70,01000110,97,01100001
67,01000011,0,00000000,67,01000011
117,01110101,11,00001011,128,10000000
68,01000100,63,00111111,131,10000011
26,00011010,101,01100101,127,01111111
76,01001100,118,01110110,194,11000010
127,01111111,66,01000010,193,11000001
113,01110001,54,00110110,167,10100111
46,00101110,55,00110111,101,01100101
118,01110110,55,00110111,173,10101101
127,01111111,54,00110110,181,10110101
105,01101001,87,01010111,192,11000000
14,00001110,101,01100101,115,01110011
112,01110000,30,00011110,142,10001110
6,00000110,13,00001101,19,00010011
19,00010011,41,00101001,60,00111100
107,01101011,63,00111111,170,10101010
21,00010101,69,01000101,90,01011010
35,00100011,15,00001111,50,00110010
106,01101010,102,01100110,208,11010000
38,00100110,35,00100011,73,01001001
6,00000110,60,00111100,66,01000010
21,00010101,122,01111010,143,10001111
45,00101101,77,01001101,122,01111010
87,01010111,95,01011111,182,10110110
49,00110001,29,00011101,78,01001110
104,01101000,97,01100001,201,11001001
61,00111101,31,00011111,92,01011100
104,01101000,90,01011010,194,11000010
33,00100001,85,01010101,118,01110110
16,00010000,8,00001000,24,00011000
112,01110000,127,01111111,239,11101111
76,01001100,39,00100111,115,01110011
50,00110010,12,00001100,62,00111110
72,01001000,27,00011011,99,01100011
96,01100000,42,00101010,138,10001010
68,01000100,44,00101100,112,01110000
97,01100001,106,01101010,203,11001011
68,01000100,63,00111111,131,10000011
42,00101010,113,01110001,155,10011011
22,00010110,80,01010000,102,01100110
56,00111000,80,01010000,136,10001000
91,01011011,76,01001100,167,10100111
18,00010010,10,00001010,28,00011100
31,00011111,121,01111001,152,10011000
60,00111100,99,01100011,159,10011111
7,00000111,38,00100110,45,00101101
90,01011010,65,01000001,155,10011011
81,01010001,9,00001001,90,01011010
42,00101010,67,01000011,109,01101101
88,01011000,103,01100111,191,10111111
7,00000111,3,00000011,10,00001010
17,00010001,17,00010001,34,00100010
96,01100000,4,00000100,100,01100100
99,01100011,11,00001011,110,01101110
79,01001111,88,01011000,167,10100111
98,01100010,96,01100000,194,11000010
8,00001000,72,01001000,80,01010000
95,01011111,110,01101110,205,11001101
103,01100111,92,01011100,195,11000011
116,01110100,65,01000001,181,10110101
98,01100010,126,01111110,224,11100000
70,01000110,35,00100011,105,01101001
96,01100000,73,01001001,169,10101001
82,01010010,115,01110011,197,11000101
94,01011110,85,01010101,179,10110011
68,01000100,78,01001110,146,10010010
50,00110010,22,00010110,72,01001000
74,01001010,22,00010110,96,01100000
14,00001110,102,01100110,116,01110100
108,01101100,86,01010110,194,11000010
35,00100011,78,01001110,113,01110001
110,01101110,101,01100101,211,11010011
109,01101101,69,01000101,178,10110010
112,01110000,88,01011000,200,11001000
13,00001101,120,01111000,133,10000101
3,00000011,41,00101001,44,00101100
50,00110010,58,00111010,108,01101100
42,00101010,9,00001001,51,00110011
126,01111110,50,00110010,176,10110000
32,00100000,40,00101000,72,01001000
65,01000001,127,01111111,192,11000000
98,01100010,69,01000101,167,10100111
55,00110111,45,00101101,100,01100100
35,00100011,21,00010101,56,00111000
52,00110100,85,01010101,137,10001001
27,00011011,13,00001101,40,00101000
52,00110100,123,01111011,175,10101111
124,01111100,72,01001000,196,11000100
93,01011101,62,00111110,155,10011011
21,00010101,58,00111010,79,01001111
51,00110011,105,01101001,156,10011100
103,01100111,1,00000001,104,01101000
41,00101001,118,01110110,159,10011111
120,01111000,74,01001010,194,11000010
70,01000110,67,01000011,137,10001001
15,00001111,105,01101001,120,01111000
112,01110000,66,01000010,178,10110010
52,00110100,89,01011001,141,10001101
64,01000000,42,00101010,106,01101010
51,00110011,4,00000100,55,00110111
43,00101011,32,00100000,75,01001011
16,00010000,126,01111110,142,10001110
14,00001110,89,01011001,103,01100111
86,01010110,110,01101110,196,11000100
125,01111101,20,00010100,145,10010001
125,01111101,57,00111001,182,10110110
27,00011011,3,00000011,30,00011110
54,00110110,53,00110101,107,01101011
17,00010001,81,01010001,98,01100010
54,00110110,5,00000101,59,00111011
11,00001011,95,01011111,106,01101010
63,00111111,5,00000101,68,01000100
115,01110011,102,01100110,217,11011001
36,00100100,49,00110001,85,01010101
84,01010100,12,00001100,96,01100000
76,01001100,28,00011100,104,01101000
67,01000011,79,01001111,146,10010010
62,00111110,61,00111101,123,01111011
40,00101000,70,01000110,110,01101110
59,00111011,88,01011000,147,10010011
59,00111011,58,00111010,117,01110101
90,01011010,98,01100010,188,10111100
17,00010001,70,01000110,87,01010111
87,01010111,99,01100011,186,10111010
14,00001110,119,01110111,133,10000101
70,01000110,36,00100100,106,01101010
15,00001111,110,01101110,125,01111101
26,00011010,126,01111110,152,10011000
24,00011000,2,00000010,26,00011010
63,00111111,38,00100110,101,01100101
26,00011010,74,01001010,100,01100100
126,01111110,47,00101111,173,10101101
38,00100110,112,01110000,150,10010110
92,01011100,84,01010100,176,10110000
120,01111000,40,00101000,160,10100000
112,01110000,120,01111000,232,11101000
27,00011011,29,00011101,56,00111000
19,00010011,105,01101001,124,01111100
24,00011000,86,01010110,110,01101110
11,00001011,75,01001011,86,01010110
42,00101010,127,01111111,169,10101001
93,01011101,64,01000000,157,10011101
92,01011100,76,01001100,168,10101000
43,00101011,91,01011011,134,10000110
93,01011101,115,01110011,208,11010000
72,01001000,127,01111111,199,11000111
29,00011101,103,01100111,132,10000100
8,00001000,94,01011110,102,01100110
103,01100111,97,01100001,200,11001000
11,00001011,68,01000100,79,01001111
19,00010011,111,01101111,130,10000010
118,01110110,117,01110101,235,11101011
59,00111011,42,00101010,101,01100101
68,01000100,118,01110110,186,10111010
114,01110010,75,01001011,189,10111101
87,01010111,23,00010111,110,01101110
67,01000011,52,00110100,119,01110111
82,01010010,114,01110010,196,11000100
51,00110011,79,01001111,130,10000010
71,01000111,68,01000100,139,10001011
81,01010001,31,00011111,112,01110000
89,01011001,41,00101001,130,10000010
89,01011001,38,00100110,127,01111111
75,01001011,59,00111011,134,10000110
111,01101111,83,01010011,194,11000010
111,01101111,81,01010001,192,11000000
22,00010110,8,00001000,30,00011110
65,01000001,110,01101110,175,10101111
9,00001001,53,00110101,62,00111110
67,01000011,37,00100101,104,01101000
89,01011001,92,01011100,181,10110101
89,01011001,110,01101110,199,11000111
63,00111111,109,01101101,172,10101100
127,01111111,90,01011010,217,11011001
85,01010101,31,00011111,116,01110100
18,00010010,101,01100101,119,01110111
105,01101001,101,01100101,206,11001110
39,00100111,74,01001010,113,01110001
22,00010110,69,01000101,91,01011011
68,01000100,97,01100001,165,10100101
121,01111001,104,01101000,225,11100001
106,01101010,93,01011101,199,11000111
44,00101100,54,00110110,98,01100010
20,00010100,69,01000101,89,01011001
122,01111010,111,01101111,233,11101001
15,00001111,112,01110000,127,01111111
36,00100100,29,00011101,65,01000001
117,01110101,78,01001110,195,11000011
111,01101111,49,00110001,160,10100000
41,00101001,116,01110100,157,10011101
96,01100000,112,01110000,208,11010000
90,01011010,102,01100110,192,11000000
118,01110110,123,01111011,241,11110001
64,01000000,25,00011001,89,01011001
26,00011010,15,00001111,41,00101001
6,00000110,36,00100100,42,00101010
109,01101101,15,00001111,124,01111100
7,00000111,36,00100100,43,00101011
71,01000111,93,01011101,164,10100100
120,01111000,97,01100001,217,11011001
70,01000110,22,00010110,92,01011100
25,00011001,99,01100011,124,01111100
38,00100110,73,01001001,111,01101111
73,01001001,64,01000000,137,10001001
32,00100000,109,01101101,141,10001101
44,00101100,37,00100101,81,01010001
92,01011100,74,01001010,166,10100110
22,00010110,72,01001000,94,01011110
69,01000101,81,01010001,150,10010110
19,00010011,56,00111000,75,01001011
27,00011011,50,00110010,77,01001101
124,01111100,84,01010100,208,11010000
78,01001110,86,01010110,164,10100100
86,01010110,13,00001101,99,01100011
6,00000110,126,01111110,132,10000100
95,01011111,31,00011111,126,01111110
8,00001000,74,01001010,82,01010010
16,00010000,69,01000101,85,01010101
80,01010000,122,01111010,202,11001010
72,01001000,74,01001010,146,10010010
65,01000001,6,00000110,71,01000111
12,00001100,64,01000000,76,01001100
68,01000100,63,00111111,131,10000011
57,00111001,61,00111101,118,01110110
63,00111111,37,00100101,100,01100100
121,01111001,2,00000010,123,01111011
122,01111010,43,00101011,165,10100101
95,01011111,5,00000101,100,01100100
57,00111001,18,00010010,75,01001011
7,00000111,105,01101001,112,01110000
98,01100010,51,00110011,149,10010101
77,01001101,61,00111101,138,10001010
54,00110110,19,00010011,73,01001001
99,01100011,19,00010011,118,01110110
82,01010010,121,01111001,203,11001011
111,01101111,106,01101010,217,11011001
116,01110100,95,01011111,211,11010011
122,01111010,15,00001111,137,10001001
85,01010101,49,00110001,134,10000110
19,00010011,123,01111011,142,10001110
62,00111110,20,00010100,82,01010010
126,01111110,35,00100011,161,10100001
49,00110001,10,00001010,59,00111011
109,01101101,39,00100111,148,10010100
12,00001100,13,00001101,25,00011001
20,00010100,117,01110101,137,10001001
62,00111110,59,00111011,121,01111001
50,00110010,62,00111110,112,01110000
69,01000101,84,01010100,153,10011001
59,00111011,93,01011101,152,10011000
45,00101101,70,01000110,115,01110011
58,00111010,89,01011001,147,10010011
36,00100100,45,00101101,81,01010001
67,01000011,21,00010101,88,01011000
70,01000110,70,01000110,140,10001100
92,01011100,41,00101001,133,10000101
38,00100110,8,00001000,46,00101110
84,01010100,16,00010000,100,01100100
115,01110011,0,00000000,115,01110011
109,01101101,39,00100111,148,10010100
107,01101011,69,01000101,176,10110000
86,01010110,78,01001110,164,10100100
38,00100110,12,00001100,50,00110010
109,01101101,109,01101101,218,11011010
79,01001111,60,00111100,139,10001011
47,00101111,86,01010110,133,10000101
3,00000011,54,00110110,57,00111001
63,00111111,18,00010010,81,01010001
41,00101001,11,00001011,52,00110100
116,01110100,10,00001010,126,01111110
17,00010001,78,01001110,95,01011111
57,00111001,101,01100101,158,10011110
83,01010011,92,01011100,175,10101111
88,01011000,58,00111010,146,10010010
85,01010101,105,01101001,190,10111110
2,00000010,44,00101100,46,00101110
7,00000111,106,01101010,113,01110001
120,01111000,122,01111010,242,11110010
69,01000101,121,01111001,190,10111110
103,01100111,72,01001000,175,10101111
55,00110111,45,00101101,100,01100100
98,01100010,12,00001100,110,01101110
30,00011110,66,01000010,96,01100000
114,01110010,82,01010010,196,11000100
17,00010001,123,01111011,140,10001100
56,00111000,71,01000111,127,01111111
35,00100011,12,00001100,47,00101111
42,00101010,121,01111001,163,10100011
62,00111110,20,00010100,82,01010010
1,00000001,7,00000111,8,00001000
126,01111110,54,00110110,180,10110100
79,01001111,29,00011101,108,01101100
125,01111101,68,01000100,193,11000001
12,00001100,71,01000111,83,01010011
71,01000111,51,00110011,122,01111010
114,01110010,106,01101010,220,11011100
12,00001100,68,01000100,80,01010000
10,00001010,124,01111100,134,10000110
63,00111111,126,01111110,189,10111101
123,01111011,119,01110111,242,11110010
59,00111011,95,01011111,154,10011010
13,00001101,88,01011000,101,01100101
87,01010111,123,01111011,210,11010010
44,00101100,10,00001010,54,00110110
85,01010101,106,01101010,191,10111111
104,01101000,121,01111001,225,11100001
114,01110010,6,00000110,120,01111000
84,01010100,44,00101100,128,10000000
4,00000100,95,01011111,99,01100011
95,01011111,103,01100111,198,11000110
92,01011100,16,00010000,108,01101100
65,01000001,107,01101011,172,10101100
96,01100000,66,01000010,162,10100010
119,01110111,29,00011101,148,10010100
74,01001010,24,00011000,98,01100010
8,00001000,47,00101111,55,00110111
94,01011110,25,00011001,119,01110111
9,00001001,72,01001000,81,01010001
124,01111100,119,01110111,243,11110011
67,01000011,42,00101010,109,01101101
101,01100101,13,00001101,114,01110010
31,00011111,46,00101110,77,01001101
21,00010101,0,00000000,21,00010101
125,01111101,67,01000011,192,11000000
123,01111011,58,00111010,181,10110101
70,01000110,76,01001100,146,10010010
88,01011000,126,01111110,214,11010110
53,00110101,15,00001111,68,01000100
4,00000100,56,00111000,60,00111100
9,00001001,29,00011101,38,00100110
29,00011101,26,00011010,55,00110111
4,00000100,27,00011011,31,00011111
29,00011101,16,00010000,45,00101101
112,01110000,14,00001110,126,01111110
4,00000100,73,01001001,77,01001101
78,01001110,11,00001011,89,01011001
23,00010111,114,01110010,137,10001001
118,01110110,88,01011000,206,11001110
21,00010101,105,01101001,126,01111110
65,01000001,32,00100000,97,01100001
76,01001100,0,00000000,76,01001100
95,01011111,36,00100100,131,10000011
27,00011011,4,00000100,31,00011111
60,00111100,54,00110110,114,01110010
111,01101111,38,00100110,149,10010101
50,00110010,34,00100010,84,01010100
67,01000011,83,01010011,150,10010110
102,01100110,100,01100100,202,11001010
53,00110101,61,00111101,114,01110010
113,01110001,123,01111011,236,11101100
83,01010011,4,00000100,87,01010111
89,01011001,85,01010101,174,10101110
99,01100011,36,00100100,135,10000111
93,01011101,18,00010010,111,01101111
1,00000001,59,00111011,60,00111100
26,00011010,116,01110100,142,10001110
29,00011101,24,00011000,53,00110101
54,00110110,66,01000010,120,01111000
49,00110001,91,01011011,140,10001100
50,00110010,120,01111000,170,10101010
109,01101101,93,01011101,202,11001010
122,01111010,75,01001011,197,11000101
54,00110110,0,00000000,54,00110110
72,01001000,91,01011011,163,10100011
8,00001000,38,00100110,46,00101110
106,01101010,52,00110100,158,10011110
80,01010000,13,00001101,93,01011101
56,00111000,35,00100011,91,01011011
27,00011011,23,00010111,50,00110010
47,00101111,117,01110101,164,10100100
15,00001111,50,00110010,65,01000001
120,01111000,61,00111101,181,10110101
8,00001000,81,01010001,89,01011001
80,01010000,24,00011000,104,01101000
116,01110100,55,00110111,171,10101011
14,00001110,80,01010000,94,01011110
72,01001000,121,01111001,193,11000001
59,00111011,87,01010111,146,10010010
21,00010101,74,01001010,95,01011111
33,00100001,56,00111000,89,01011001
96,01100000,37,00100101,133,10000101
102,01100110,110,01101110,212,11010100
79,01001111,49,00110001,128,10000000
105,01101001,76,01001100,181,10110101
50,00110010,81,01010001,131,10000011
75,01001011,36,00100100,111,01101111
56,00111000,26,00011010,82,01010010
90,01011010,123,01111011,213,11010101
101,01100101,41,00101001,142,10001110
22,00010110,70,01000110,92,01011100
20,00010100,58,00111010,78,01001110
11,00001011,40,00101000,51,00110011
65,01000001,62,00111110,127,01111111
25,00011001,72,01001000,97,01100001
105,01101001,68,01000100,173,10101101
123,01111011,127,01111111,250,11111010
107,01101011,58,00111010,165,10100101
5,00000101,66,01000010,71,01000111
52,00110100,87,01010111,139,10001011
76,01001100,58,00111010,134,10000110
84,01010100,56,00111000,140,10001100
125,01111101,61,00111101,186,10111010
126,01111110,40,00101000,166,10100110
109,01101101,62,00111110,171,10101011
75,01001011,23,00010111,98,01100010
0,00000000,105,01101001,105,01101001
115,01110011,90,01011010,205,11001101
89,01011001,36,00100100,125,01111101
46,00101110,57,00111001,103,01100111
127,01111111,29,00011101,156,10011100
105,01101001,21,00010101,126,01111110
10,00001010,119,01110111,129,10000001
116,01110100,80,01010000,196,11000100
112,01110000,89,01011001,201,11001001
1,00000001,114,01110010,115,01110011
109,01101101,51,00110011,160,10100000
42,00101010,9,00001001,51,00110011
114,01110010,70,01000110,184,10111000
53,00110101,70,01000110,123,01111011
11,00001011,65,01000001,76,01001100
71,01000111,84,01010100,155,10011011
105,01101001,99,01100011,204,11001100
39,00100111,110,01101110,149,10010101
2,00000010,35,00100011,37,00100101
1,00000001,11,00001011,12,00001100
16,00010000,121,01111001,137,10001001
94,01011110,47,00101111,141,10001101
16,00010000,82,01010010,98,01100010
107,01101011,121,01111001,228,11100100
101,01100101,75,01001011,176,10110000
59,00111011,89,01011001,148,10010100
24,00011000,62,00111110,86,01010110
105,01101001,107,01101011,212,11010100
25,00011001,90,01011010,115,01110011
116,01110100,17,00010001,133,10000101
41,00101001,86,01010110,127,01111111
14,00001110,68,01000100,82,01010010
19,00010011,75,01001011,94,01011110
95,01011111,115,01110011,210,11010010
116,01110100,5,00000101,121,01111001
101,01100101,117,01110101,218,11011010
48,00110000,67,01000011,115,01110011
97,01100001,113,01110001,210,11010010
110,01101110,120,01111000,230,11100110
113,01110001,30,00011110,143,10001111
2,00000010,102,01100110,104,01101000
55,00110111,54,00110110,109,01101101
55,00110111,24,00011000,79,01001111
119,01110111,14,00001110,133,10000101
1,00000001,54,00110110,55,00110111
52,00110100,20,00010100,72,01001000
21,00010101,71,01000111,92,01011100
22,00010110,89,01011001,111,01101111
4,00000100,123,01111011,127,01111111
80,01010000,117,01110101,197,11000101
39,00100111,22,00010110,61,00111101
44,00101100,104,01101000,148,10010100
104,01101000,40,00101000,144,10010000
65,01000001,72,01001000,137,10001001
115,01110011,42,00101010,157,10011101
117,01110101,8,00001000,125,01111101
55,00110111,71,01000111,126,01111110
63,00111111,28,00011100,91,01011011
104,01101000,102,01100110,206,11001110
4,00000100,84,01010100,88,01011000
99,01100011,54,00110110,153,10011001
107,01101011,116,01110100,223,11011111
122,01111010,71,01000111,193,11000001
41,00101001,77,01001101,118,01110110
61,00111101,56,00111000,117,01110101
19,00010011,32,00100000,51,00110011
73,01001001,94,01011110,167,10100111
119,01110111,37,00100101,156,10011100
108,01101100,127,01111111,235,11101011
77,01001101,110,01101110,187,10111011
94,01011110,65,01000001,159,10011111
76,01001100,118,01110110,194,11000010
4,00000100,89,01011001,93,01011101
106,01101010,27,00011011,133,10000101
9,00001001,72,01001000,81,01010001
61,00111101,99,01100011,160,10100000
24,00011000,97,01100001,121,01111001
9,00001001,127,01111111,136,10001000
113,01110001,68,01000100,181,10110101
17,00010001,114,01110010,131,10000011
106,01101010,66,01000010,172,10101100
21,00010101,118,01110110,139,10001011
11,00001011,98,01100010,109,01101101
28,00011100,125,01111101,153,10011001
93,01011101,99,01100011,192,11000000
20,00010100,67,01000011,87,01010111
63,00111111,30,00011110,93,01011101
112,01110000,28,00011100,140,10001100
101,01100101,90,01011010,191,10111111
84,01010100,35,00100011,119,01110111
50,00110010,46,00101110,96,01100000
83,01010011,29,00011101,112,01110000
98,01100010,94,01011110,192,11000000
48,00110000,28,00011100,76,01001100
79,01001111,36,00100100,115,01110011
113,01110001,10,00001010,123,01111011
69,01000101,19,00010011,88,01011000
2,00000010,125,01111101,127,01111111
113,01110001,70,01000110,183,10110111
64,01000000,57,00111001,121,01111001
30,00011110,4,00000100,34,00100010
0,00000000,86,01010110,86,01010110
87,01010111,10,00001010,97,01100001
6,00000110,62,00111110,68,01000100
96,01100000,67,01000011,163,10100011
36,00100100,97,01100001,133,10000101
126,01111110,96,01100000,222,11011110
6,00000110,69,01000101,75,01001011
101,01100101,63,00111111,164,10100100
79,01001111,99,01100011,178,10110010
89,01011001,19,00010011,108,01101100
1,00000001,107,01101011,108,01101100
24,00011000,118,01110110,142,10001110
85,01010101,98,01100010,183,10110111
14,00001110,116,01110100,130,10000010
2,00000010,71,01000111,73,01001001
101,01100101,23,00010111,124,01111100
54,00110110,38,00100110,92,01011100
31,00011111,65,01000001,96,01100000
127,01111111,103,01100111,230,11100110
59,00111011,122,01111010,181,10110101
17,00010001,52,00110100,69,01000101
77,01001101,30,00011110,107,01101011
99,01100011,57,00111001,156,10011100
86,01010110,83,01010011,169,10101001
123,01111011,28,00011100,151,10010111
70,01000110,65,01000001,135,10000111
121,01111001,5,00000101,126,01111110
11,00001011,53,00110101,64,01000000
24,00011000,90,01011010,114,01110010
120,01111000,47,00101111,167,10100111
65,01000001,101,01100101,166,10100110
42,00101010,63,00111111,105,01101001
32,00100000,11,00001011,43,00101011
18,00010010,127,01111111,145,10010001
24,00011000,4,00000100,28,00011100
7,00000111,32,00100000,39,00100111
15,00001111,1,00000001,16,00010000
113,01110001,88,01011000,201,11001001
37,00100101,118,01110110,155,10011011
81,01010001,116,01110100,197,11000101
31,00011111,31,00011111,62,00111110
72,01001000,65,01000001,137,10001001
116,01110100,113,01110001,229,11100101
52,00110100,0,00000000,52,00110100
29,00011101,56,00111000,85,01010101
1,00000001,25,00011001,26,00011010
105,01101001,66,01000010,171,10101011
44,00101100,18,00010010,62,00111110
84,01010100,103,01100111,187,10111011
97,01100001,125,01111101,222,11011110
51,00110011,77,01001101,128,10000000
31,00011111,117,01110101,148,10010100
4,00000100,40,00101000,44,00101100
99,01100011,120,01111000,219,11011011
119,01110111,115,01110011,234,11101010
98,01100010,126,01111110,224,11100000
23,00010111,94,01011110,117,01110101
56,00111000,57,00111001,113,01110001
61,00111101,3,00000011,64,01000000
77,01001101,46,00101110,123,01111011
27,00011011,110,01101110,137,10001001
96,01100000,1,00000001,97,01100001
3,00000011,98,01100010,101,01100101
100,01100100,11,00001011,111,01101111
59,00111011,103,01100111,162,10100010
86,01010110,17,00010001,103,01100111
28,00011100,39,00100111,67,01000011
66,01000010,52,00110100,118,01110110
89,01011001,16,00010000,105,01101001
44,00101100,111,01101111,155,10011011
112,01110000,118,01110110,230,11100110
87,01010111,117,01110101,204,11001100
106,01101010,4,00000100,110,01101110
76,01001100,71,01000111,147,10010011
106,01101010,23,00010111,129,10000001
88,01011000,63,00111111,151,10010111
81,01010001,116,01110100,197,11000101
43,00101011,92,01011100,135,10000111
69,01000101,106,01101010,175,10101111
86,01010110,16,00010000,102,01100110
47,00101111,122,01111010,169,10101001
105,01101001,2,00000010,107,01101011
69,01000101,43,00101011,112,01110000
22,00010110,113,01110001,135,10000111
19,00010011,84,01010100,103,01100111
38,00100110,82,01010010,120,01111000
9,00001001,87,01010111,96,01100000
67,01000011,46,00101110,113,01110001
6,00000110,12,00001100,18,00010010
107,01101011,9,00001001,116,01110100
26,00011010,109,01101101,135,10000111
73,01001001,11,00001011,84,01010100
69,01000101,0,00000000,69,01000101
71,01000111,54,00110110,125,01111101
61,00111101,85,01010101,146,10010010
73,01001001,28,00011100,101,01100101
80,01010000,46,00101110,126,01111110
52,00110100,84,01010100,136,10001000
123,01111011,40,00101000,163,10100011
117,01110101,94,01011110,211,11010011
14,00001110,40,00101000,54,00110110
84,01010100,1,00000001,85,01010101
44,00101100,28,00011100,72,01001000
121,01111001,11,00001011,132,10000100
101,01100101,61,00111101,162,10100010
123,01111011,66,01000010,189,10111101
33,00100001,123,01111011,156,10011100
24,00011000,4,00000100,28,00011100
36,00100100,50,00110010,86,01010110
60,00111100,92,01011100,152,10011000
5,00000101,93,01011101,98,01100010
50,00110010,87,01010111,137,10001001
37,00100101,7,00000111,44,00101100
78,01001110,96,01100000,174,10101110
98,01100010,109,01101101,207,11001111
67,01000011,104,01101000,171,10101011
70,01000110,100,01100100,170,10101010
108,01101100,33,00100001,141,10001101
62,00111110,60,00111100,122,01111010
116,01110100,5,00000101,121,01111001
4,00000100,107,01101011,111,01101111
44,00101100,20,00010100,64,01000000
34,00100010,57,00111001,91,01011011
123,01111011,126,01111110,249,11111001
96,01100000,114,01110010,210,11010010
23,00010111,84,01010100,107,01101011
12,00001100,117,01110101,129,10000001
88,01011000,14,00001110,102,01100110
78,01001110,122,01111010,200,11001000
22,00010110,6,00000110,28,00011100
121,01111001,100,01100100,221,11011101
60,00111100,125,01111101,185,10111001
113,01110001,118,01110110,231,11100111
116,01110100,44,00101100,160,10100000
84,01010100,107,01101011,191,10111111
8,00001000,123,01111011,131,10000011
59,00111011,63,00111111,122,01111010
84,01010100,72,01001000,156,10011100
66,01000010,35,00100011,101,01100101
57,00111001,77,01001101,134,10000110
105,01101001,76,01001100,181,10110101
109,01101101,114,01110010,223,11011111
57,00111001,50,00110010,107,01101011
22,00010110,4,00000100,26,00011010
42,00101010,58,00111010,100,01100100
42,00101010,104,01101000,146,10010010
109,01101101,107,01101011,216,11011000
32,00100000,118,01110110,150,10010110
69,01000101,107,01101011,176,10110000
8,00001000,64,01000000,72,01001000
47,00101111,92,01011100,139,10001011
55,00110111,88,01011000,143,10001111
20,00010100,11,00001011,31,00011111
1,00000001,89,01011001,90,01011010
55,00110111,111,01101111,166,10100110
37,00100101,32,00100000,69,01000101
49,00110001,75,01001011,124,01111100
69,01000101,16,00010000,85,01010101
40,00101000,12,00001100,52,00110100
112,01110000,87,01010111,199,11000111
107,01101011,89,01011001,196,11000100
40,00101000,106,01101010,146,10010010
65,01000001,89,01011001,154,10011010
22,00010110,65,01000001,87,01010111
55,00110111,77,01001101,132,10000100
21,00010101,102,01100110,123,01111011
124,01111100,35,00100011,159,10011111
58,00111010,96,01100000,154,10011010
15,00001111,118,01110110,133,10000101
71,01000111,55,00110111,126,01111110
9,00001001,73,01001001,82,01010010
25,00011001,127,01111111,152,10011000
114,01110010,91,01011011,205,11001101
53,00110101,88,01011000,141,10001101
98,01100010,45,00101101,143,10001111
24,00011000,79,01001111,103,01100111
2,00000010,44,00101100,46,00101110
127,01111111,126,01111110,253,11111101
4,00000100,7,00000111,11,00001011
25,00011001,78,01001110,103,01100111
29,00011101,85,01010101,114,01110010
76,01001100,18,00010010,94,01011110
118,01110110,112,01110000,230,11100110
110,01101110,11,00001011,121,01111001
101,01100101,11,00001011,112,01110000
1,00000001,79,01001111,80,01010000
116,01110100,16,00010000,132,10000100
27,00011011,77,01001101,104,01101000
39,00100111,31,00011111,70,01000110
100,01100100,73,01001001,173,10101101
39,00100111,81,01010001,120,01111000
46,00101110,72,01001000,118,01110110
36,00100100,34,00100010,70,01000110
43,00101011,7,00000111,50,00110010
122,01111010,35,00100011,157,10011101
122,01111010,25,00011001,147,10010011
11,00001011,34,00100010,45,00101101
23,00010111,103,01100111,126,01111110
60,00111100,17,00010001,77,01001101
49,00110001,52,00110100,101,01100101
85,01010101,90,01011010,175,10101111
110,01101110,122,01111010,232,11101000
75,01001011,121,01111001,196,11000100
34,00100010,118,01110110,152,10011000
2,00000010,73,01001001,75,01001011
111,01101111,36,00100100,147,10010011
125,01111101,1,00000001,126,01111110
58,00111010,63,00111111,121,01111001
55,00110111,61,00111101,116,01110100
73,01001001,43,00101011,116,01110100
75,01001011,20,00010100,95,01011111
5,00000101,36,00100100,41,00101001
107,01101011,56,00111000,163,10100011
83,01010011,54,00110110,137,10001001
71,01000111,50,00110010,121,01111001
58,00111010,35,00100011,93,01011101
6,00000110,33,00100001,39,00100111
88,01011000,3,00000011,91,01011011
89,01011001,17,00010001,106,01101010
104,01101000,47,00101111,151,10010111
76,01001100,108,01101100,184,10111000
111,01101111,49,00110001,160,10100000
53,00110101,11,00001011,64,01000000
8,00001000,118,01110110,126,01111110
93,01011101,49,00110001,142,10001110
24,00011000,28,00011100,52,00110100
32,00100000,83,01010011,115,01110011
46,00101110,72,01001000,118,01110110
120,01111000,89,01011001,209,11010001
16,00010000,76,01001100,92,01011100
118,01110110,110,01101110,228,11100100
35,00100011,126,01111110,161,10100001
107,01101011,126,01111110,233,11101001
103,01100111,56,00111000,159,10011111
35,00100011,29,00011101,64,01000000
78,01001110,77,01001101,155,10011011
109,01101101,10,00001010,119,01110111
16,00010000,3,00000011,19,00010011
127,01111111,21,00010101,148,10010100
30,00011110,27,00011011,57,00111001
103,01100111,10,00001010,113,01110001
55,00110111,96,01100000,151,10010111
9,00001001,90,01011010,99,01100011
93,01011101,111,01101111,204,11001100
123,01111011,51,00110011,174,10101110
20,00010100,28,00011100,48,00110000
46,00101110,119,01110111,165,10100101
24,00011000,32,00100000,56,00111000
11,00001011,63,00111111,74,01001010
68,01000100,11,00001011,79,01001111
27,00011011,40,00101000,67,01000011
13,00001101,126,01111110,139,10001011
58,00111010,0,00000000,58,00111010
36,00100100,36,00100100,72,01001000
75,01001011,21,00010101,96,01100000
118,01110110,76,01001100,194,11000010
93,01011101,54,00110110,147,10010011
110,01101110,118,01110110,228,11100100
88,01011000,10,00001010,98,01100010
23,00010111,2,00000010,25,00011001
95,01011111,102,01100110,197,11000101
92,01011100,59,00111011,151,10010111
36,00100100,119,01110111,155,10011011
44,00101100,44,00101100,88,01011000
86,01010110,68,01000100,154,10011010
72,01001000,6,00000110,78,01001110
78,01001110,20,00010100,98,01100010
56,00111000,66,01000010,122,01111010
83,01010011,115,01110011,198,11000110
45,00101101,68,01000100,113,01110001
127,01111111,70,01000110,197,11000101
56,00111000,104,01101000,160,10100000
84,01010100,56,00111000,140,10001100
33,00100001,25,00011001,58,00111010
0,00000000,9,00001001,9,00001001
90,01011010,85,01010101,175,10101111
77,01001101,80,01010000,157,10011101
25,00011001,10,00001010,35,00100011
123,01111011,59,00111011,182,10110110
63,00111111,5,00000101,68,01000100
10,00001010,28,00011100,38,00100110
18,00010010,107,01101011,125,01111101
62,00111110,21,00010101,83,01010011
58,00111010,47,00101111,105,01101001
100,01100100,79,01001111,179,10110011
66,01000010,121,01111001,187,10111011
73,01001001,57,00111001,130,10000010
19,00010011,104,01101000,123,01111011
57,00111001,103,01100111,160,10100000
50,00110010,110,01101110,160,10100000
29,00011101,7,00000111,36,00100100
11,00001011,87,01010111,98,01100010
118,01110110,72,01001000,190,10111110
23,00010111,68,01000100,91,01011011
0,00000000,26,00011010,26,00011010
117,01110101,84,01010100,201,11001001
64,01000000,81,01010001,145,10010001
95,01011111,52,00110100,147,10010011
69,01000101,7,00000111,76,01001100
101,01100101,119,01110111,220,11011100
37,00100101,20,00010100,57,00111001
108,01101100,105,01101001,213,11010101
84,01010100,30,00011110,114,01110010
15,00001111,38,00100110,53,00110101
28,00011100,49,00110001,77,01001101
85,01010101,110,01101110,195,11000011
89,01011001,15,00001111,104,01101000
48,00110000,99,01100011,147,10010011
12,00001100,120,01111000,132,10000100
23,00010111,104,01101000,127,01111111
37,00100101,112,01110000,149,10010101
75,01001011,81,01010001,156,10011100
88,01011000,12,00001100,100,01100100
119,01110111,42,00101010,161,10100001
60,00111100,27,00011011,87,01010111
96,01100000,6,00000110,102,01100110
58,00111010,118,01110110,176,10110000
45,00101101,108,01101100,153,10011001
104,01101000,105,01101001,209,11010001
22,00010110,12,00001100,34,00100010
85,01010101,0,00000000,85,01010101
106,01101010,28,00011100,134,10000110
43,00101011,99,01100011,142,10001110
112,01110000,65,01000001,177,10110001
17,00010001,119,01110111,136,10001000
25,00011001,15,00001111,40,00101000
77,01001101,119,01110111,196,11000100
127,01111111,21,00010101,148,10010100
2,00000010,102,01100110,104,01101000
14,00001110,20,00010100,34,00100010
113,01110001,23,00010111,136,10001000
34,00100010,102,01100110,136,10001000
118,01110110,72,01001000,190,10111110
22,00010110,7,00000111,29,00011101
52,00110100,107,01101011,159,10011111
63,00111111,1,00000001,64,01000000
72,01001000,28,00011100,100,01100100
91,01011011,98,01100010,189,10111101
29,00011101,58,00111010,87,01010111
94,01011110,9,00001001,103,01100111
60,00111100,80,01010000,140,10001100
118,01110110,119,01110111,237,11101101
104,01101000,29,00011101,133,10000101
48,00110000,89,01011001,137,10001001
97,01100001,65,01000001,162,10100010
33,00100001,82,01010010,115,01110011
28,00011100,48,00110000,76,01001100
107,01101011,104,01101000,211,11010011
53,00110101,82,01010010,135,10000111
70,01000110,35,00100011,105,01101001
105,01101001,9,00001001,114,01110010
24,00011000,2,00000010,26,00011010
27,00011011,112,01110000,139,10001011
62,00111110,66,01000010,128,10000000
79,01001111,2,00000010,81,01010001
75,01001011,27,00011011,102,01100110
99,01100011,111,01101111,210,11010010
110,01101110,15,00001111,125,01111101
36,00100100,87,01010111,123,01111011
13,00001101,50,00110010,63,00111111
73,01001001,59,00111011,132,10000100
124,01111100,19,00010011,143,10001111
86,01010110,118,01110110,204,11001100
101,01100101,36,00100100,137,10001001
60,00111100,15,00001111,75,01001011
41,00101001,59,00111011,100,01100100
94,01011110,13,00001101,107,01101011
106,01101010,68,01000100,174,10101110
66,01000010,22,00010110,88,01011000
86,01010110,75,01001011,161,10100001
124,01111100,86,01010110,210,11010010
93,01011101,36,00100100,129,10000001
98,01100010,96,01100000,194,11000010
96,01100000,24,00011000,120,01111000
56,00111000,26,00011010,82,01010010
23,00010111,104,01101000,127,01111111
118,01110110,116,01110100,234,11101010
82,01010010,67,01000011,149,10010101
88,01011000,82,01010010,170,10101010
117,01110101,25,00011001,142,10001110
31,00011111,56,00111000,87,01010111
41,00101001,12,00001100,53,00110101
50,00110010,31,00011111,81,01010001
32,00100000,47,00101111,79,01001111
8,00001000,7,00000111,15,00001111
105,01101001,117,01110101,222,11011110
26,00011010,78,01001110,104,01101000
94,01011110,40,00101000,134,10000110
46,00101110,10,00001010,56,00111000
75,01001011,126,01111110,201,11001001
72,01001000,47,00101111,119,01110111
17,00010001,33,00100001,50,00110010
35,00100011,126,01111110,161,10100001
32,00100000,115,01110011,147,10010011
49,00110001,10,00001010,59,00111011
78,01001110,4,00000100,82,01010010
118,01110110,64,01000000,182,10110110
37,00100101,34,00100010,71,01000111
53,00110101,84,01010100,137,10001001
69,01000101,126,01111110,195,11000011
15,00001111,13,00001101,28,00011100
70,01000110,108,01101100,178,10110010
111,01101111,46,00101110,157,10011101
114,01110010,124,01111100,238,11101110
67,01000011,104,01101000,171,10101011
117,01110101,44,00101100,161,10100001
51,00110011,13,00001101,64,01000000
13,00001101,7,00000111,20,00010100
90,01011010,50,00110010,140,10001100
96,01100000,102,01100110,198,11000110
26,00011010,76,01001100,102,01100110
47,00101111,111,01101111,158,10011110
113,01110001,61,00111101,174,10101110
23,00010111,2,00000010,25,00011001
51,00110011,83,01010011,134,10000110
83,01010011,91,01011011,174,10101110
9,00001001,36,00100100,45,00101101
82,01010010,32,00100000,114,01110010
17,00010001,5,00000101,22,00010110
30,00011110,30,00011110,60,00111100
121,01111001,53,00110101,174,10101110
1,00000001,122,01111010,123,01111011
60,00111100,73,01001001,133,10000101
98,01100010,12,00001100,110,01101110
57,00111001,54,00110110,111,01101111
126,01111110,72,01001000,198,11000110
38,00100110,55,00110111,93,01011101
62,00111110,90,01011010,152,10011000
60,00111100,11,00001011,71,01000111
115,01110011,49,00110001,164,10100100
125,01111101,68,01000100,193,11000001
5,00000101,45,00101101,50,00110010
33,00100001,116,01110100,149,10010101
88,01011000,76,01001100,164,10100100
93,01011101,64,01000000,157,10011101
91,01011011,69,01000101,160,10100000
104,01101000,45,00101101,149,10010101
82,01010010,50,00110010,132,10000100
34,00100010,122,01111010,156,10011100
63,00111111,17,00010001,80,01010000
13,00001101,85,01010101,98,01100010
101,01100101,74,01001010,175,10101111
67,01000011,17,00010001,84,01010100
122,01111010,50,00110010,172,10101100
99,01100011,76,01001100,175,10101111
111,01101111,48,00110000,159,10011111
66,01000010,17,00010001,83,01010011
28,00011100,16,00010000,44,00101100
4,00000100,32,00100000,36,00100100
49,00110001,81,01010001,130,10000010
71,01000111,18,00010010,89,01011001
56,00111000,70,01000110,126,01111110
66,01000010,56,00111000,122,01111010
82,01010010,102,01100110,184,10111000
56,00111000,16,00010000,72,01001000
102,01100110,23,00010111,125,01111101
25,00011001,54,00110110,79,01001111
44,00101100,116,01110100,160,10100000
87,01010111,83,01010011,170,10101010
44,00101100,31,00011111,75,01001011
94,01011110,65,01000001,159,10011111
97,01100001,24,00011000,121,01111001
86,01010110,33,00100001,119,01110111
83,01010011,30,00011110,113,01110001
125,01111101,90,01011010,215,11010111
34,00100010,84,01010100,118,01110110
112,01110000,100,01100100,212,11010100
81,01010001,16,00010000,97,01100001
47,00101111,58,00111010,105,01101001
91,01011011,89,01011001,180,10110100
34,00100010,99,01100011,133,10000101
123,01111011,102,01100110,225,11100001
6,00000110,30,00011110,36,00100100
56,00111000,81,01010001,137,10001001
77,01001101,48,00110000,125,01111101
52,00110100,109,01101101,161,10100001
123,01111011,117,01110101,240,11110000
2,00000010,26,00011010,28,00011100
124,01111100,55,00110111,179,10110011
24,00011000,111,01101111,135,10000111
28,00011100,72,01001000,100,01100100
119,01110111,100,01100100,219,11011011
76,01001100,37,00100101,113,01110001
127,01111111,105,01101001,232,11101000
69,01000101,1,00000001,70,01000110
105,01101001,40,00101000,145,10010001
82,01010010,120,01111000,202,11001010
42,00101010,85,01010101,127,01111111
64,01000000,80,01010000,144,10010000
41,00101001,108,01101100,149,10010101
39,00100111,95,01011111,134,10000110
101,01100101,108,01101100,209,11010001
88,01011000,115,01110011,203,11001011
27,00011011,101,01100101,128,10000000
77,01001101,28,00011100,105,01101001
58,00111010,97,01100001,155,10011011
65,01000001,22,00010110,87,01010111
77,01001101,14,00001110,91,01011011
100,01100100,89,01011001,189,10111101
32,00100000,70,01000110,102,01100110
17,00010001,39,00100111,56,00111000
4,00000100,116,01110100,120,01111000
26,00011010,94,01011110,120,01111000
8,00001000,14,00001110,22,00010110
56,00111000,90,01011010,146,10010010
17,00010001,84,01010100,101,01100101
28,00011100,43,00101011,71,01000111
3,00000011,64,01000000,67,01000011
12,00001100,83,01010011,95,01011111
62,00111110,126,01111110,188,10111100
55,00110111,63,00111111,118,01110110
58,00111010,84,01010100,142,10001110
9,00001001,40,00101000,49,00110001
49,00110001,67,01000011,116,01110100
95,01011111,13,00001101,108,01101100
108,01101100,87,01010111,195,11000011
18,00010010,127,01111111,145,10010001
60,00111100,71,01000111,131,10000011
44,00101100,48,00110000,92,01011100
43,00101011,86,01010110,129,10000001
105,01101001,55,00110111,160,10100000
43,00101011,52,00110100,95,01011111
53,00110101,22,00010110,75,01001011
66,01000010,110,01101110,176,10110000
54,00110110,69,01000101,123,01111011
79,01001111,127,01111111,206,11001110
7,00000111,121,01111001,128,10000000
97,01100001,90,01011010,187,10111011
22,00010110,34,00100010,56,00111000
92,01011100,4,00000100,96,01100000
105,01101001,103,01100111,208,11010000
55,00110111,73,01001001,128,10000000
80,01010000,60,00111100,140,10001100
26,00011010,37,00100101,63,00111111
126,01111110,45,00101101,171,10101011
122,01111010,102,01100110,224,11100000
68,01000100,11,00001011,79,01001111
61,00111101,18,00010010,79,01001111
96,01100000,87,01010111,183,10110111
16,00010000,127,01111111,143,10001111
13,00001101,3,00000011,16,00010000
112,01110000,12,00001100,124,01111100
123,01111011,49,00110001,172,10101100
71,01000111,92,01011100,163,10100011
26,00011010,108,01101100,134,10000110
91,01011011,8,00001000,99,01100011
101,01100101,29,00011101,130,10000010
101,01100101,101,01100101,202,11001010
57,00111001,59,00111011,116,01110100
48,00110000,15,00001111,63,00111111
121,01111001,97,01100001,218,11011010
6,00000110,71,01000111,77,01001101
71,01000111,36,00100100,107,01101011
20,00010100,40,00101000,60,00111100
48,00110000,107,01101011,155,10011011
84,01010100,33,00100001,117,01110101
35,00100011,86,01010110,121,01111001
58,00111010,13,00001101,71,01000111
46,00101110,67,01000011,113,01110001
114,01110010,74,01001010,188,10111100
32,00100000,0,00000000,32,00100000
8,00001000,62,00111110,70,01000110
35,00100011,66,01000010,101,01100101
10,00001010,48,00110000,58,00111010
31,00011111,45,00101101,76,01001100
83,01010011,62,00111110,145,10010001
117,01110101,83,01010011,200,11001000
99,01100011,6,00000110,105,01101001
56,00111000,83,01010011,139,10001011
59,00111011,102,01100110,161,10100001
118,01110110,60,00111100,178,10110010
81,01010001,62,00111110,143,10001111
26,00011010,122,01111010,148,10010100
2,00000010,107,01101011,109,01101101
88,01011000,89,01011001,177,10110001
40,00101000,115,01110011,155,10011011
113,01110001,84,01010100,197,11000101
74,01001010,51,00110011,125,01111101
18,00010010,61,00111101,79,01001111
101,01100101,71,01000111,172,10101100
108,01101100,4,00000100,112,01110000
33,00100001,7,00000111,40,00101000
41,00101001,2,00000010,43,00101011
62,00111110,42,00101010,104,01101000
120,01111000,28,00011100,148,10010100
25,00011001,56,00111000,81,01010001
25,00011001,86,01010110,111,01101111
49,00110001,53,00110101,102,01100110
93,01011101,62,00111110,155,10011011
90,01011010,62,00111110,152,10011000
61,00111101,115,01110011,176,10110000
61,00111101,126,01111110,187,10111011
120,01111000,88,01011000,208,11010000
123,01111011,19,00010011,142,10001110
96,01100000,41,00101001,137,10001001
112,01110000,112,01110000,224,11100000
23,00010111,53,00110101,76,01001100
12,00001100,96,01100000,108,01101100
78,01001110,41,00101001,119,01110111
49,00110001,28,00011100,77,01001101
56,00111000,39,00100111,95,01011111
89,01011001,73,01001001,162,10100010
76,01001100,113,01110001,189,10111101
13,00001101,120,01111000,133,10000101
37,00100101,91,01011011,128,10000000
72,01001000,41,00101001,113,01110001
62,00111110,40,00101000,102,01100110
33,00100001,125,01111101,158,10011110
0,00000000,15,00001111,15,00001111
38,00100110,35,00100011,73,01001001
19,00010011,100,01100100,119,01110111
38,00100110,97,01100001,135,10000111
103,01100111,77,01001101,180,10110100
36,00100100,107,01101011,143,10001111
64,01000000,40,00101000,104,01101000
10,00001010,39,00100111,49,00110001
104,01101000,18,00010010,122,01111010
110,01101110,44,00101100,154,10011010
38,00100110,3,00000011,41,00101001
99,01100011,101,01100101,200,11001000
125,01111101,114,01110010,239,11101111
127,01111111,78,01001110,205,11001101
82,01010010,81,01010001,163,10100011
117,01110101,5,00000101,122,01111010
73,01001001,51,00110011,124,01111100
79,01001111,74,01001010,153,10011001
38,00100110,116,01110100,154,10011010
30,00011110,5,00000101,35,00100011
75,01001011,22,00010110,97,01100001
105,01101001,124,01111100,229,11100101
87,01010111,25,00011001,112,01110000
21,00010101,71,01000111,92,01011100
49,00110001,17,00010001,66,01000010
94,01011110,74,01001010,168,10101000
1,00000001,73,01001001,74,01001010
111,01101111,8,00001000,119,01110111
5,00000101,74,01001010,79,01001111
100,01100100,93,01011101,193,11000001
46,00101110,56,00111000,102,01100110
59,00111011,113,01110001,172,10101100
32,00100000,97,01100001,129,10000001
127,01111111,13,00001101,140,10001100
21,00010101,122,01111010,143,10001111
26,00011010,124,01111100,150,10010110
8,00001000,29,00011101,37,00100101
108,01101100,58,00111010,166,10100110
66,01000010,23,00010111,89,01011001
2,00000010,85,01010101,87,01010111
59,00111011,91,01011011,150,10010110
25,00011001,64,01000000,89,01011001
19,00010011,3,00000011,22,00010110
116,01110100,45,00101101,161,10100001
99,01100011,119,01110111,218,11011010
66,01000010,67,01000011,133,10000101
101,01100101,65,01000001,166,10100110
115,01110011,73,01001001,188,10111100
96,01100000,102,01100110,198,11000110
53,00110101,90,01011010,143,10001111
108,01101100,3,00000011,111,01101111
103,01100111,63,00111111,166,10100110
31,00011111,38,00100110,69,01000101
124,01111100,126,01111110,250,11111010
100,01100100,28,00011100,128,10000000
4,00000100,50,00110010,54,00110110
63,00111111,9,00001001,72,01001000
40,00101000,16,00010000,56,00111000
78,01001110,104,01101000,182,10110110
90,01011010,95,01011111,185,10111001
83,01010011,46,00101110,129,10000001
84,01010100,75,01001011,159,10011111
49,00110001,10,00001010,59,00111011
112,01110000,21,00010101,133,10000101
71,01000111,117,01110101,188,10111100
44,00101100,118,01110110,162,10100010
0,00000000,114,01110010,114,01110010
78,01001110,45,00101101,123,01111011
75,01001011,48,00110000,123,01111011
72,01001000,55,00110111,127,01111111
111,01101111,119,01110111,230,11100110
28,00011100,78,01001110,106,01101010
102,01100110,87,01010111,189,10111101
51,00110011,66,01000010,117,01110101
111,01101111,54,00110110,165,10100101
37,00100101,59,00111011,96,01100000
59,00111011,103,01100111,162,10100010
102,01100110,56,00111000,158,10011110
59,00111011,12,00001100,71,01000111
48,00110000,39,00100111,87,01010111
6,00000110,12,00001100,18,00010010
38,00100110,12,00001100,50,00110010
3,00000011,80,01010000,83,01010011
88,01011000,32,00100000,120,01111000
40,00101000,3,00000011,43,00101011
15,00001111,100,01100100,115,01110011
15,00001111,71,01000111,86,01010110
71,01000111,57,00111001,128,10000000
119,01110111,26,00011010,145,10010001
6,00000110,42,00101010,48,00110000
116,01110100,126,01111110,242,11110010
90,01011010,47,00101111,137,10001001
50,00110010,20,00010100,70,01000110
62,00111110,92,01011100,154,10011010
82,01010010,127,01111111,209,11010001
31,00011111,12,00001100,43,00101011
92,01011100,70,01000110,162,10100010
30,00011110,104,01101000,134,10000110
117,01110101,52,00110100,169,10101001
73,01001001,42,00101010,115,01110011
13,00001101,110,01101110,123,01111011
97,01100001,113,01110001,210,11010010
2,00000010,62,00111110,64,01000000
44,00101100,112,01110000,156,10011100
20,00010100,90,01011010,110,01101110
29,00011101,99,01100011,128,10000000
87,01010111,77,01001101,164,10100100
61,00111101,127,01111111,188,10111100
63,00111111,67,01000011,130,10000010
90,01011010,102,01100110,192,11000000
35,00100011,95,01011111,130,10000010
107,01101011,93,01011101,200,11001000
87,01010111,91,01011011,178,10110010
79,01001111,14,00001110,93,01011101
123,01111011,3,00000011,126,01111110
76,01001100,53,00110101,129,10000001
84,01010100,41,00101001,125,01111101
43,00101011,127,01111111,170,10101010
116,01110100,78,01001110,194,11000010
12,00001100,82,01010010,94,01011110
115,01110011,74,01001010,189,10111101
54,00110110,7,00000111,61,00111101
78,01001110,71,01000111,149,10010101
86,01010110,91,01011011,177,10110001
107,01101011,6,00000110,113,01110001
107,01101011,113,01110001,220,11011100
86,01010110,110,01101110,196,11000100
25,00011001,117,01110101,142,10001110
112,01110000,122,01111010,234,11101010
54,00110110,74,01001010,128,10000000
117,01110101,98,01100010,215,11010111
77,01001101,63,00111111,140,10001100
110,01101110,77,01001101,187,10111011
29,00011101,7,00000111,36,00100100
42,00101010,64,01000000,106,01101010
118,01110110,60,00111100,178,10110010
104,01101000,50,00110010,154,10011010
127,01111111,94,01011110,221,11011101
59,00111011,45,00101101,104,01101000
117,01110101,118,01110110,235,11101011
114,01110010,52,00110100,166,10100110
92,01011100,19,00010011,111,01101111
105,01101001,82,01010010,187,10111011
39,00100111,19,00010011,58,00111010
4,00000100,120,01111000,124,01111100
31,00011111,20,00010100,51,00110011
104,01101000,42,00101010,146,10010010
72,01001000,10,00001010,82,01010010
42,00101010,44,00101100,86,01010110
120,01111000,127,01111111,247,11110111
21,00010101,119,01110111,140,10001100
8,00001000,55,00110111,63,00111111
35,00100011,111,01101111,146,10010010
95,01011111,67,01000011,162,10100010
9,00001001,45,00101101,54,00110110
46,00101110,124,01111100,170,10101010
48,00110000,21,00010101,69,01000101
90,01011010,73,01001001,163,10100011
39,00100111,47,00101111,86,01010110
116,01110100,5,00000101,121,01111001
78,01001110,16,00010000,94,01011110
19,00010011,49,00110001,68,01000100
66,01000010,16,00010000,82,01010010
53,00110101,118,01110110,171,10101011
106,01101010,106,01101010,212,11010100
2,00000010,9,00001001,11,00001011
39,00100111,71,01000111,110,01101110
48,00110000,96,01100000,144,10010000
87,01010111,48,00110000,135,10000111
39,00100111,112,01110000,151,10010111
123,01111011,123,01111011,246,11110110
41,00101001,12,00001100,53,00110101
76,01001100,111,01101111,187,10111011
99,01100011,76,01001100,175,10101111
104,01101000,127,01111111,231,11100111
125,01111101,72,01001000,197,11000101
33,00100001,29,00011101,62,00111110
48,00110000,32,00100000,80,01010000
121,01111001,74,01001010,195,11000011
112,01110000,88,01011000,200,11001000
53,00110101,93,01011101,146,10010010
64,01000000,68,01000100,132,10000100
87,01010111,16,00010000,103,01100111
80,01010000,69,01000101,149,10010101
44,00101100,66,01000010,110,01101110
105,01101001,56,00111000,161,10100001
15,00001111,51,00110011,66,01000010
116,01110100,91,01011011,207,11001111
4,00000100,121,01111001,125,01111101
100,01100100,46,00101110,146,10010010
93,01011101,82,01010010,175,10101111
35,00100011,93,01011101,128,10000000
119,01110111,101,01100101,220,11011100
89,01011001,16,00010000,105,01101001
103,01100111,74,01001010,177,10110001
23,00010111,67,01000011,90,01011010
4,00000100,45,00101101,49,00110001
7,00000111,55,00110111,62,00111110
90,01011010,0,00000000,90,01011010
83,01010011,28,00011100,111,01101111
95,01011111,114,01110010,209,11010001
58,00111010,70,01000110,128,10000000
103,01100111,101,01100101,204,11001100
0,00000000,95,01011111,95,01011111
21,00010101,48,00110000,69,01000101
79,01001111,63,00111111,142,10001110
107,01101011,14,00001110,121,01111001
21,00010101,124,01111100,145,10010001
61,00111101,110,01101110,171,10101011
87,01010111,87,01010111,174,10101110
113,01110001,63,00111111,176,10110000
11,00001011,39,00100111,50,00110010
4,00000100,32,00100000,36,00100100
108,01101100,59,00111011,167,10100111
114,01110010,110,01101110,224,11100000
65,01000001,63,00111111,128,10000000
25,00011001,42,00101010,67,01000011
83,01010011,79,01001111,162,10100010
9,00001001,104,01101000,113,01110001
78,01001110,74,01001010,152,10011000
20,00010100,73,01001001,93,01011101
5,00000101,83,01010011,88,01011000
8,00001000,15,00001111,23,00010111
58,00111010,79,01001111,137,10001001
84,01010100,10,00001010,94,01011110
38,00100110,106,01101010,144,10010000
127,01111111,74,01001010,201,11001001
63,00111111,103,01100111,166,10100110
11,00001011,117,01110101,128,10000000
35,00100011,34,00100010,69,01000101
113,01110001,79,01001111,192,11000000
43,00101011,97,01100001,140,10001100
9,00001001,82,01010010,91,01011011
95,01011111,126,01111110,221,11011101
33,00100001,49,00110001,82,01010010
114,01110010,30,00011110,144,10010000
70,01000110,63,00111111,133,10000101
13,00001101,126,01111110,139,10001011
8,00001000,71,01000111,79,01001111
34,00100010,24,00011000,58,00111010
3,00000011,21,00010101,24,00011000
45,00101101,3,00000011,48,00110000
120,01111000,89,01011001,209,11010001
43,00101011,55,00110111,98,01100010
99,01100011,39,00100111,138,10001010
102,01100110,65,01000001,167,10100111
18,00010010,102,01100110,120,01111000
87,01010111,113,01110001,200,11001000
96,01100000,11,00001011,107,01101011
33,00100001,112,01110000,145,10010001
93,01011101,91,01011011,184,10111000
116,01110100,35,00100011,151,10010111
83,01010011,99,01100011,182,10110110
77,01001101,30,00011110,107,01101011
55,00110111,75,01001011,130,10000010
13,00001101,116,01110100,129,10000001
85,01010101,41,00101001,126,01111110
3,00000011,30,00011110,33,00100001
26,00011010,50,00110010,76,01001100
35,00100011,51,00110011,86,01010110
70,01000110,65,01000001,135,10000111
124,01111100,32,00100000,156,10011100
82,01010010,124,01111100,206,11001110
33,00100001,81,01010001,114,01110010
1,00000001,73,01001001,74,01001010
55,00110111,109,01101101,164,10100100
68,01000100,39,00100111,107,01101011
97,01100001,8,00001000,105,01101001
6,00000110,112,01110000,118,01110110
8,00001000,41,00101001,49,00110001
105,01101001,45,00101101,150,10010110
87,01010111,64,01000000,151,10010111
7,00000111,16,00010000,23,00010111
13,00001101,77,01001101,90,01011010
44,00101100,98,01100010,142,10001110
21,00010101,47,00101111,68,01000100
32,00100000,101,01100101,133,10000101
91,01011011,120,01111000,211,11010011
73,01001001,25,00011001,98,01100010
123,01111011,78,01001110,201,11001001
51,00110011,126,01111110,177,10110001
67,01000011,77,01001101,144,10010000
116,01110100,18,00010010,134,10000110
12,00001100,105,01101001,117,01110101
33,00100001,39,00100111,72,01001000
63,00111111,58,00111010,121,01111001
17,00010001,117,01110101,134,10000110
29,00011101,122,01111010,151,10010111
65,01000001,72,01001000,137,10001001
94,01011110,41,00101001,135,10000111
85,01010101,33,00100001,118,01110110
89,01011001,102,01100110,191,10111111
54,00110110,114,01110010,168,10101000
25,00011001,0,00000000,25,00011001
4,00000100,49,00110001,53,00110101
51,00110011,103,01100111,154,10011010
74,01001010,25,00011001,99,01100011
33,00100001,4,00000100,37,00100101
26,00011010,50,00110010,76,01001100
47,00101111,93,01011101,140,10001100
42,00101010,76,01001100,118,01110110
56,00111000,3,00000011,59,00111011
39,00100111,30,00011110,69,01000101
86,01010110,10,00001010,96,01100000
33,00100001,16,00010000,49,00110001
65,01000001,38,00100110,103,01100111
109,01101101,15,00001111,124,01111100
125,01111101,34,00100010,159,10011111
88,01011000,80,01010000,168,10101000
72,01001000,66,01000010,138,10001010
42,00101010,78,01001110,120,01111000
106,01101010,7,00000111,113,01110001
56,00111000,42,00101010,98,01100010
125,01111101,85,01010101,210,11010010
69,01000101,1,00000001,70,01000110
101,01100101,74,01001010,175,10101111
32,00100000,72,01001000,104,01101000
6,00000110,105,01101001,111,01101111
9,00001001,50,00110010,59,00111011
47,00101111,29,00011101,76,01001100
76,01001100,18,00010010,94,01011110
27,00011011,110,01101110,137,10001001
20,00010100,68,01000100,88,01011000
108,01101100,126,01111110,234,11101010
11,00001011,80,01010000,91,01011011
105,01101001,39,00100111,144,10010000
4,00000100,49,00110001,53,00110101
47,00101111,102,01100110,149,10010101
79,01001111,92,01011100,171,10101011
85,01010101,86,01010110,171,10101011
7,00000111,99,01100011,106,01101010
81,01010001,5,00000101,86,01010110
124,01111100,59,00111011,183,10110111
57,00111001,16,00010000,73,01001001
24,00011000,33,00100001,57,00111001
82,01010010,12,00001100,94,01011110
80,01010000,63,00111111,143,10001111
9,00001001,34,00100010,43,00101011
55,00110111,96,01100000,151,10010111
89,01011001,25,00011001,114,01110010
58,00111010,31,00011111,89,01011001
36,00100100,95,01011111,131,10000011
76,01001100,12,00001100,88,01011000
82,01010010,114,01110010,196,11000100
39,00100111,74,01001010,113,01110001
70,01000110,60,00111100,130,10000010
25,00011001,122,01111010,147,10010011
7,00000111,8,00001000,15,00001111
127,01111111,48,00110000,175,10101111
37,00100101,45,00101101,82,01010010
1,00000001,122,01111010,123,01111011
122,01111010,67,01000011,189,10111101
71,01000111,23,00010111,94,01011110
99,01100011,87,01010111,186,10111010
2,00000010,81,01010001,83,01010011
15,00001111,126,01111110,141,10001101
105,01101001,14,00001110,119,01110111
75,01001011,107,01101011,182,10110110
100,01100100,17,00010001,117,01110101
53,00110101,102,01100110,155,10011011
32,00100000,55,00110111,87,01010111
61,00111101,37,00100101,98,01100010
4,00000100,15,00001111,19,00010011
70,01000110,70,01000110,140,10001100
116,01110100,57,00111001,173,10101101
86,01010110,17,00010001,103,01100111
80,01010000,67,01000011,147,10010011
64,01000000,94,01011110,158,10011110
31,00011111,107,01101011,138,10001010
31,00011111,19,00010011,50,00110010
77,01001101,116,01110100,193,11000001
126,01111110,45,00101101,171,10101011
94,01011110,67,01000011,161,10100001
54,00110110,90,01011010,144,10010000
69,01000101,54,00110110,123,01111011
54,00110110,64,01000000,118,01110110
123,01111011,76,01001100,199,11000111
45,00101101,48,00110000,93,01011101
5,00000101,105,01101001,110,01101110
13,00001101,109,01101101,122,01111010
95,01011111,75,01001011,170,10101010
44,00101100,96,01100000,140,10001100
79,01001111,32,00100000,111,01101111
39,00100111,51,00110011,90,01011010
51,00110011,59,00111011,110,01101110
116,01110100,92,01011100,208,11010000
114,01110010,111,01101111,225,11100001
32,00100000,70,01000110,102,01100110
10,00001010,91,01011011,101,01100101
84,01010100,92,01011100,176,10110000
104,01101000,106,01101010,210,11010010
76,01001100,45,00101101,121,01111001
72,01001000,2,00000010,74,01001010
92,01011100,45,00101101,137,10001001
40,00101000,44,00101100,84,01010100
109,01101101,108,01101100,217,11011001
17,00010001,74,01001010,91,01011011
6,00000110,2,00000010,8,00001000
88,01011000,30,00011110,118,01110110
28,00011100,62,00111110,90,01011010
104,01101000,91,01011011,195,11000011
86,01010110,12,00001100,98,01100010
68,01000100,19,00010011,87,01010111
89,01011001,50,00110010,139,10001011
23,00010111,97,01100001,120,01111000
42,00101010,107,01101011,149,10010101
45,00101101,14,00001110,59,00111011
91,01011011,84,01010100,175,10101111
16,00010000,37,00100101,53,00110101
27,00011011,87,01010111,114,01110010
113,01110001,24,00011000,137,10001001
117,01110101,7,00000111,124,01111100
19,00010011,113,01110001,132,10000100
95,01011111,50,00110010,145,10010001
67,01000011,46,00101110,113,01110001
114,01110010,38,00100110,152,10011000
58,00111010,108,01101100,166,10100110
49,00110001,120,01111000,169,10101001
68,01000100,64,01000000,132,10000100
98,01100010,111,01101111,209,11010001
35,00100011,108,01101100,143,10001111
50,00110010,79,01001111,129,10000001
74,01001010,88,01011000,162,10100010
64,01000000,92,01011100,156,10011100
39,00100111,46,00101110,85,01010101
123,01111011,31,00011111,154,10011010
40,00101000,15,00001111,55,00110111
70,01000110,51,00110011,121,01111001
64,01000000,115,01110011,179,10110011
50,00110010,83,01010011,133,10000101
39,00100111,107,01101011,146,10010010
75,01001011,84,01010100,159,10011111
59,00111011,82,01010010,141,10001101
20,00010100,52,00110100,72,01001000
116,01110100,88,01011000,204,11001100
114,01110010,35,00100011,149,10010101
9,00001001,24,00011000,33,00100001
70,01000110,20,00010100,90,01011010
30,00011110,31,00011111,61,00111101
8,00001000,79,01001111,87,01010111
51,00110011,58,00111010,109,01101101
57,00111001,90,01011010,147,10010011
21,00010101,2,00000010,23,00010111
79,01001111,0,00000000,79,01001111
29,00011101,21,00010101,50,00110010
44,00101100,45,00101101,89,01011001
68,01000100,8,00001000,76,01001100
95,01011111,34,00100010,129,10000001
45,00101101,52,00110100,97,01100001
83,01010011,81,01010001,164,10100100
54,00110110,17,00010001,71,01000111
61,00111101,35,00100011,96,01100000
24,00011000,33,00100001,57,00111001
127,01111111,3,00000011,130,10000010
76,01001100,88,01011000,164,10100100
36,00100100,41,00101001,77,01001101
19,00010011,4,00000100,23,00010111
104,01101000,55,00110111,159,10011111
122,01111010,106,01101010,228,11100100
2,00000010,70,01000110,72,01001000
84,01010100,106,01101010,190,10111110
6,00000110,127,01111111,133,10000101
24,00011000,111,01101111,135,10000111
76,01001100,75,01001011,151,10010111
81,01010001,31,00011111,112,01110000
100,01100100,84,01010100,184,10111000
8,00001000,6,00000110,14,00001110
69,01000101,2,00000010,71,01000111
108,01101100,16,00010000,124,01111100
113,01110001,12,00001100,125,01111101
39,00100111,6,00000110,45,00101101
85,01010101,42,00101010,127,01111111
87,01010111,31,00011111,118,01110110
119,01110111,18,00010010,137,10001001
56,00111000,97,01100001,153,10011001
122,01111010,32,00100000,154,10011010
37,00100101,60,00111100,97,01100001
125,01111101,103,01100111,228,11100100
121,01111001,25,00011001,146,10010010
95,01011111,101,01100101,196,11000100
89,01011001,95,01011111,184,10111000
44,00101100,11,00001011,55,00110111
118,01110110,116,01110100,234,11101010
0,00000000,98,01100010,98,01100010
90,01011010,86,01010110,176,10110000
13,00001101,124,01111100,137,10001001
88,01011000,2,00000010,90,01011010
2,00000010,115,01110011,117,01110101
124,01111100,28,00011100,152,10011000
45,00101101,78,01001110,123,01111011
63,00111111,79,01001111,142,10001110
27,00011011,66,01000010,93,01011101
56,00111000,81,01010001,137,10001001
48,00110000,8,00001000,56,00111000
91,01011011,63,00111111,154,10011010
120,01111000,94,01011110,214,11010110
5,00000101,61,00111101,66,01000010
27,00011011,120,01111000,147,10010011
126,01111110,41,00101001,167,10100111
18,00010010,17,00010001,35,00100011
64,01000000,68,01000100,132,10000100
97,01100001,102,01100110,199,11000111
105,01101001,12,00001100,117,01110101
98,01100010,122,01111010,220,11011100
86,01010110,26,00011010,112,01110000
12,00001100,77,01001101,89,01011001
121,01111001,96,01100000,217,11011001
115,01110011,64,01000000,179,10110011
23,00010111,91,01011011,114,01110010
12,00001100,78,01001110,90,01011010
28,00011100,52,00110100,80,01010000
67,01000011,25,00011001,92,01011100
122,01111010,71,01000111,193,11000001
64,01000000,85,01010101,149,10010101
112,01110000,10,00001010,122,01111010
72,01001000,116,01110100,188,10111100
107,01101011,19,00010011,126,01111110
10,00001010,33,00100001,43,00101011
125,01111101,12,00001100,137,10001001
124,01111100,28,00011100,152,10011000
29,00011101,64,01000000,93,01011101
95,01011111,52,00110100,147,10010011
38,00100110,54,00110110,92,01011100
8,00001000,107,01101011,115,01110011
21,00010101,109,01101101,130,10000010
96,01100000,23,00010111,119,01110111
88,01011000,125,01111101,213,11010101
122,01111010,6,00000110,128,10000000
14,00001110,37,00100101,51,00110011
79,01001111,91,01011011,170,10101010
0,00000000,69,01000101,69,01000101
28,00011100,79,01001111,107,01101011
37,00100101,65,01000001,102,01100110
77,01001101,46,00101110,123,01111011
81,01010001,122,01111010,203,11001011
34,00100010,23,00010111,57,00111001
59,00111011,101,01100101,160,10100000
54,00110110,52,00110100,106,01101010
19,00010011,111,01101111,130,10000010
79,01001111,88,01011000,167,10100111
10,00001010,120,01111000,130,10000010
81,01010001,78,01001110,159,10011111
15,00001111,103,01100111,118,01110110
112,01110000,48,00110000,160,10100000
57,00111001,95,01011111,152,10011000
81,01010001,54,00110110,135,10000111
68,01000100,42,00101010,110,01101110
42,00101010,15,00001111,57,00111001
44,00101100,73,01001001,117,01110101
35,00100011,114,01110010,149,10010101
20,00010100,119,01110111,139,10001011
116,01110100,28,00011100,144,10010000
5,00000101,8,00001000,13,00001101
8,00001000,86,01010110,94,01011110
58,00111010,123,01111011,181,10110101
87,01010111,37,00100101,124,01111100
60,00111100,120,01111000,180,10110100
49,00110001,0,00000000,49,00110001
89,01011001,11,00001011,100,01100100
38,00100110,115,01110011,153,10011001
62,00111110,68,01000100,130,10000010
37,00100101,108,01101100,145,10010001
103,01100111,19,00010011,122,01111010
114,01110010,5,00000101,119,01110111
53,00110101,8,00001000,61,00111101
29,00011101,58,00111010,87,01010111
117,01110101,113,01110001,230,11100110
89,01011001,63,00111111,152,10011000
32,00100000,30,00011110,62,00111110
72,01001000,0,00000000,72,01001000
54,00110110,20,00010100,74,01001010
110,01101110,114,01110010,224,11100000
26,00011010,4,00000100,30,00011110
72,01001000,52,00110100,124,01111100
11,00001011,115,01110011,126,01111110
100,01100100,94,01011110,194,11000010
104,01101000,41,00101001,145,10010001
93,01011101,103,01100111,196,11000100
90,01011010,80,01010000,170,10101010
117,01110101,20,00010100,137,10001001
79,01001111,75,01001011,154,10011010
92,01011100,51,00110011,143,10001111
75,01001011,12,00001100,87,01010111
55,00110111,100,01100100,155,10011011
62,00111110,96,01100000,158,10011110
11,00001011,115,01110011,126,01111110
66,01000010,103,01100111,169,10101001
73,01001001,113,01110001,186,10111010
44,00101100,10,00001010,54,00110110
85,01010101,117,01110101,202,11001010
35,00100011,116,01110100,151,10010111
12,00001100,13,00001101,25,00011001
119,01110111,127,01111111,246,11110110
119,01110111,123,01111011,242,11110010
110,01101110,47,00101111,157,10011101
41,00101001,115,01110011,156,10011100
17,00010001,35,00100011,52,00110100
38,00100110,59,00111011,97,01100001
35,00100011,110,01101110,145,10010001
98,01100010,93,01011101,191,10111111
39,00100111,49,00110001,88,01011000
56,00111000,93,01011101,149,10010101
85,01010101,10,00001010,95,01011111
75,01001011,101,01100101,176,10110000
116,01110100,108,01101100,224,11100000
71,01000111,125,01111101,196,11000100
21,00010101,8,00001000,29,00011101
83,01010011,14,00001110,97,01100001
42,00101010,23,00010111,65,01000001
117,01110101,28,00011100,145,10010001
26,00011010,90,01011010,116,01110100
75,01001011,118,01110110,193,11000001
100,01100100,16,00010000,116,01110100
59,00111011,48,00110000,107,01101011
46,00101110,26,00011010,72,01001000
0,00000000,123,01111011,123,01111011
48,00110000,59,00111011,107,01101011
44,00101100,36,00100100,80,01010000
34,00100010,30,00011110,64,01000000
119,01110111,90,01011010,209,11010001
38,00100110,53,00110101,91,01011011
23,00010111,71,01000111,94,01011110
72,01001000,21,00010101,93,01011101
53,00110101,53,00110101,106,01101010
75,01001011,63,00111111,138,10001010
80,01010000,94,01011110,174,10101110
30,00011110,94,01011110,124,01111100
58,00111010,66,01000010,124,01111100
8,00001000,47,00101111,55,00110111
91,01011011,29,00011101,120,01111000
78,01001110,50,00110010,128,10000000
53,00110101,44,00101100,97,01100001
90,01011010,123,01111011,213,11010101
120,01111000,50,00110010,170,10101010
101,01100101,111,01101111,212,11010100
60,00111100,40,00101000,100,01100100
124,01111100,73,01001001,197,11000101
39,00100111,79,01001111,118,01110110
124,01111100,53,00110101,177,10110001
25,00011001,123,01111011,148,10010100
54,00110110,113,01110001,167,10100111
106,01101010,91,01011011,197,11000101
63,00111111,79,01001111,142,10001110
29,00011101,100,01100100,129,10000001
97,01100001,72,01001000,169,10101001
91,01011011,113,01110001,204,11001100
102,01100110,66,01000010,168,10101000
16,00010000,5,00000101,21,00010101
16,00010000,118,01110110,134,10000110
117,01110101,59,00111011,176,10110000
77,01001101,62,00111110,139,10001011
118,01110110,80,01010000,198,11000110
63,00111111,58,00111010,121,01111001
88,01011000,70,01000110,158,10011110
7,00000111,44,00101100,51,00110011
54,00110110,84,01010100,138,10001010
25,00011001,62,00111110,87,01010111
87,01010111,55,00110111,142,10001110
80,01010000,26,00011010,106,01101010
38,00100110,121,01111001,159,10011111
84,01010100,57,00111001,141,10001101
98,01100010,12,00001100,110,01101110
120,01111000,52,00110100,172,10101100
50,00110010,121,01111001,171,10101011
31,00011111,65,01000001,96,01100000
69,01000101,117,01110101,186,10111010
117,01110101,99,01100011,216,11011000
45,00101101,9,00001001,54,00110110
50,00110010,43,00101011,93,01011101
112,01110000,89,01011001,201,11001001
20,00010100,43,00101011,63,00111111
90,01011010,57,00111001,147,10010011
84,01010100,125,01111101,209,11010001
99,01100011,61,00111101,160,10100000
108,01101100,62,00111110,170,10101010
52,00110100,66,01000010,118,01110110
76,01001100,17,00010001,93,01011101
21,00010101,38,00100110,59,00111011
99,01100011,125,01111101,224,11100000
0,00000000,75,01001011,75,01001011
79,01001111,50,00110010,129,10000001
29,00011101,91,01011011,120,01111000
101,01100101,49,00110001,150,10010110
4,00000100,58,00111010,62,00111110
108,01101100,1,00000001,109,01101101
121,01111001,82,01010010,203,11001011
14,00001110,70,01000110,84,01010100
34,00100010,66,01000010,100,01100100
31,00011111,111,01101111,142,10001110
1,00000001,57,00111001,58,00111010
56,00111000,12,00001100,68,01000100
44,00101100,109,01101101,153,10011001
98,01100010,27,00011011,125,01111101
81,01010001,116,01110100,197,11000101
99,01100011,124,01111100,223,11011111
79,01001111,91,01011011,170,10101010
36,00100100,13,00001101,49,00110001
107,01101011,13,00001101,120,01111000
40,00101000,88,01011000,128,10000000
75,01001011,31,00011111,106,01101010
104,01101000,106,01101010,210,11010010
24,00011000,22,00010110,46,00101110
52,00110100,53,00110101,105,01101001
34,00100010,29,00011101,63,00111111
82,01010010,79,01001111,161,10100001
74,01001010,38,00100110,112,01110000
74,01001010,78,01001110,152,10011000
88,01011000,111,01101111,199,11000111
66,01000010,125,01111101,191,10111111
116,01110100,78,01001110,194,11000010
111,01101111,123,01111011,234,11101010
100,01100100,95,01011111,195,11000011
121,01111001,90,01011010,211,11010011
122,01111010,107,01101011,229,11100101
28,00011100,113,01110001,141,10001101
30,00011110,21,00010101,51,00110011
95,01011111,81,01010001,176,10110000
127,01111111,22,00010110,149,10010101
5,00000101,28,00011100,33,00100001
13,00001101,83,01010011,96,01100000
50,00110010,65,01000001,115,01110011
0,00000000,23,00010111,23,00010111
106,01101010,77,01001101,183,10110111
33,00100001,75,01001011,108,01101100
75,01001011,57,00111001,132,10000100
13,00001101,67,01000011,80,01010000
107,01101011,6,00000110,113,01110001
62,00111110,24,00011000,86,01010110
91,01011011,115,01110011,206,11001110
53,00110101,93,01011101,146,10010010
81,01010001,14,00001110,95,01011111
111,01101111,93,01011101,204,11001100
32,00100000,53,00110101,85,01010101
5,00000101,12,00001100,17,00010001
77,01001101,15,00001111,92,01011100
34,00100010,75,01001011,109,01101101
111,01101111,48,00110000,159,10011111
43,00101011,111,01101111,154,10011010
104,01101000,0,00000000,104,01101000
66,01000010,81,01010001,147,10010011
18,00010010,91,01011011,109,01101101
29,00011101,109,01101101,138,10001010
4,00000100,91,01011011,95,01011111
81,01010001,79,01001111,160,10100000
117,01110101,14,00001110,131,10000011
117,01110101,37,00100101,154,10011010
116,01110100,0,00000000,116,01110100
69,01000101,51,00110011,120,01111000
28,00011100,126,01111110,154,10011010
36,00100100,33,00100001,69,01000101
61,00111101,122,01111010,183,10110111
52,00110100,93,01011101,145,10010001
1,00000001,110,01101110,111,01101111
89,01011001,45,00101101,134,10000110
59,00111011,43,00101011,102,01100110
18,00010010,88,01011000,106,01101010
5,00000101,67,01000011,72,01001000
9,00001001,58,00111010,67,01000011
73,01001001,122,01111010,195,11000011
110,01101110,69,01000101,179,10110011
6,00000110,2,00000010,8,00001000
72,01001000,46,00101110,118,01110110
32,00100000,124,01111100,156,10011100
29,00011101,102,01100110,131,10000011
22,00010110,80,01010000,102,01100110
54,00110110,118,01110110,172,10101100
29,00011101,86,01010110,115,01110011
17,00010001,59,00111011,76,01001100
61,00111101,105,01101001,166,10100110
124,01111100,34,00100010,158,10011110
42,00101010,95,01011111,137,10001001
52,00110100,76,01001100,128,10000000
34,00100010,86,01010110,120,01111000
83,01010011,66,01000010,149,10010101
87,01010111,1,00000001,88,01011000
58,00111010,90,01011010,148,10010100
55,00110111,125,01111101,180,10110100
34,00100010,85,01010101,119,01110111
13,00001101,55,00110111,68,01000100
83,01010011,23,00010111,106,01101010
37,00100101,29,00011101,66,01000010
114,01110010,65,01000001,179,10110011
6,00000110,121,01111001,127,01111111
66,01000010,92,01011100,158,10011110
2,00000010,50,00110010,52,00110100
54,00110110,9,00001001,63,00111111
69,01000101,105,01101001,174,10101110
103,01100111,89,01011001,192,11000000
20,00010100,92,01011100,112,01110000
96,01100000,54,00110110,150,10010110
108,01101100,42,00101010,150,10010110
90,01011010,110,01101110,200,11001000
17,00010001,67,01000011,84,01010100
63,00111111,26,00011010,89,01011001
78,01001110,124,01111100,202,11001010
88,01011000,96,01100000,184,10111000
92,01011100,61,00111101,153,10011001
52,00110100,19,00010011,71,01000111
36,00100100,107,01101011,143,10001111
93,01011101,6,00000110,99,01100011
104,01101000,98,01100010,202,11001010
110,01101110,32,00100000,142,10001110
126,01111110,99,01100011,225,11100001
63,00111111,126,01111110,189,10111101
92,01011100,84,01010100,176,10110000
21,00010101,107,01101011,128,10000000
15,00001111,28,00011100,43,00101011
26,00011010,11,00001011,37,00100101
11,00001011,5,00000101,16,00010000
120,01111000,15,00001111,135,10000111
34,00100010,77,01001101,111,01101111
75,01001011,119,01110111,194,11000010
72,01001000,106,01101010,178,10110010
105,01101001,25,00011001,130,10000010
19,00010011,69,01000101,88,01011000
115,01110011,64,01000000,179,10110011
76,01001100,9,00001001,85,01010101
0,00000000,55,00110111,55,00110111
34,00100010,4,00000100,38,00100110
112,01110000,9,00001001,121,01111001
107,01101011,73,01001001,180,10110100
49,00110001,110,01101110,159,10011111
10,00001010,107,01101011,117,01110101
103,01100111,127,01111111,230,11100110
119,01110111,85,01010101,204,11001100
59,00111011,41,00101001,100,01100100
40,00101000,112,01110000,152,10011000
29,00011101,60,00111100,89,01011001
94,01011110,109,01101101,203,11001011
5,00000101,84,01010100,89,01011001
18,00010010,21,00010101,39,00100111
119,01110111,66,01000010,185,10111001
19,00010011,1,00000001,20,00010100
22,00010110,112,01110000,134,10000110
41,00101001,10,00001010,51,00110011
20,00010100,62,00111110,82,01010010
71,01000111,112,01110000,183,10110111
55,00110111,90,01011010,145,10010001
23,00010111,40,00101000,63,00111111
106,01101010,99,01100011,205,11001101
111,01101111,121,01111001,232,11101000
72,01001000,34,00100010,106,01101010
27,00011011,4,00000100,31,00011111
68,01000100,18,00010010,86,01010110
9,00001001,104,01101000,113,01110001
7,00000111,50,00110010,57,00111001
30,00011110,78,01001110,108,01101100
84,01010100,61,00111101,145,10010001
125,01111101,59,00111011,184,10111000
118,01110110,85,01010101,203,11001011
26,00011010,117,01110101,143,10001111
99,01100011,71,01000111,170,10101010
110,01101110,70,01000110,180,10110100
11,00001011,92,01011100,103,01100111
122,01111010,111,01101111,233,11101001
39,00100111,71,01000111,110,01101110
31,00011111,113,01110001,144,10010000
123,01111011,59,00111011,182,10110110
79,01001111,10,00001010,89,01011001
28,00011100,116,01110100,144,10010000
6,00000110,89,01011001,95,01011111
26,00011010,54,00110110,80,01010000
17,00010001,103,01100111,120,01111000
12,00001100,90,01011010,102,01100110
99,01100011,66,01000010,165,10100101
125,01111101,67,01000011,192,11000000
28,00011100,67,01000011,95,01011111
98,01100010,123,01111011,221,11011101
54,00110110,20,00010100,74,01001010
112,01110000,1,00000001,113,01110001
103,01100111,84,01010100,187,10111011
94,01011110,32,00100000,126,01111110
29,00011101,15,00001111,44,00101100
6,00000110,41,00101001,47,00101111
10,00001010,90,01011010,100,01100100
5,00000101,15,00001111,20,00010100
92,01011100,67,01000011,159,10011111
125,01111101,59,00111011,184,10111000
53,00110101,87,01010111,140,10001100
122,01111010,72,01001000,194,11000010
42,00101010,91,01011011,133,10000101
120,01111000,37,00100101,157,10011101
25,00011001,114,01110010,139,10001011
17,00010001,96,01100000,113,01110001
87,01010111,78,01001110,165,10100101
79,01001111,71,01000111,150,10010110
85,01010101,29,00011101,114,01110010
124,01111100,33,00100001,157,10011101
71,01000111,87,01010111,158,10011110
3,00000011,3,00000011,6,00000110
2,00000010,99,01100011,101,01100101
4,00000100,62,00111110,66,01000010
26,00011010,9,00001001,35,00100011
79,01001111,0,00000000,79,01001111
80,01010000,88,01011000,168,10101000
60,00111100,116,01110100,176,10110000
72,01001000,17,00010001,89,01011001
2,00000010,36,00100100,38,00100110
11,00001011,72,01001000,83,01010011
55,00110111,18,00010010,73,01001001
26,00011010,23,00010111,49,00110001
12,00001100,19,00010011,31,00011111
39,00100111,95,01011111,134,10000110
125,01111101,6,00000110,131,10000011
50,00110010,89,01011001,139,10001011
121,01111001,12,00001100,133,10000101
64,01000000,58,00111010,122,01111010
34,00100010,35,00100011,69,01000101
118,01110110,40,00101000,158,10011110
126,01111110,2,00000010,128,10000000
102,01100110,64,01000000,166,10100110
68,01000100,69,01000101,137,10001001
99,01100011,100,01100100,199,11000111
73,01001001,45,00101101,118,01110110
81,01010001,93,01011101,174,10101110
64,01000000,12,00001100,76,01001100
52,00110100,95,01011111,147,10010011
111,01101111,18,00010010,129,10000001
67,01000011,13,00001101,80,01010000
2,00000010,80,01010000,82,01010010
21,00010101,41,00101001,62,00111110
88,01011000,46,00101110,134,10000110
8,00001000,50,00110010,58,00111010
48,00110000,111,01101111,159,10011111
106,01101010,36,00100100,142,10001110
59,00111011,100,01100100,159,10011111
91,01011011,90,01011010,181,10110101
14,00001110,40,00101000,54,00110110
4,00000100,35,00100011,39,00100111
66,01000010,19,00010011,85,01010101
28,00011100,18,00010010,46,00101110
76,01001100,23,00010111,99,01100011
79,01001111,110,01101110,189,10111101
43,00101011,15,00001111,58,00111010
126,01111110,98,01100010,224,11100000
102,01100110,45,00101101,147,10010011
97,01100001,116,01110100,213,11010101
59,00111011,26,00011010,85,01010101
25,00011001,39,00100111,64,01000000
65,01000001,63,00111111,128,10000000
42,00101010,82,01010010,124,01111100
109,01101101,75,01001011,184,10111000
37,00100101,60,00111100,97,01100001
80,01010000,98,01100010,178,10110010
107,01101011,28,00011100,135,10000111
12,00001100,2,00000010,14,00001110
46,00101110,106,01101010,152,10011000
45,00101101,10,00001010,55,00110111
36,00100100,72,01001000,108,01101100
51,00110011,58,00111010,109,01101101
115,01110011,127,01111111,242,11110010
119,01110111,16,00010000,135,10000111
126,01111110,48,00110000,174,10101110
24,00011000,89,01011001,113,01110001
100,01100100,127,01111111,227,11100011
93,01011101,0,00000000,93,01011101
61,00111101,96,01100000,157,10011101
42,00101010,3,00000011,45,00101101
48,00110000,40,00101000,88,01011000
104,01101000,113,01110001,217,11011001
30,00011110,41,00101001,71,01000111
121,01111001,27,00011011,148,10010100
74,01001010,57,00111001,131,10000011
63,00111111,73,01001001,136,10001000
34,00100010,41,00101001,75,01001011
24,00011000,122,01111010,146,10010010
16,00010000,7,00000111,23,00010111
48,00110000,114,01110010,162,10100010
34,00100010,79,01001111,113,01110001
68,01000100,122,01111010,190,10111110
102,01100110,40,00101000,142,10001110
7,00000111,42,00101010,49,00110001
35,00100011,116,01110100,151,10010111
75,01001011,76,01001100,151,10010111
96,01100000,115,01110011,211,11010011
107,01101011,71,01000111,178,10110010
40,00101000,104,01101000,144,10010000
45,00101101,79,01001111,124,01111100
81,01010001,74,01001010,155,10011011
122,01111010,91,01011011,213,11010101
112,01110000,18,00010010,130,10000010
118,01110110,113,01110001,231,11100111
118,01110110,39,00100111,157,10011101
65,01000001,15,00001111,80,01010000
109,01101101,124,01111100,233,11101001
117,01110101,58,00111010,175,10101111
87,01010111,70,01000110,157,10011101
54,00110110,29,00011101,83,01010011
77,01001101,95,01011111,172,10101100
69,01000101,78,01001110,147,10010011
91,01011011,33,00100001,124,01111100
29,00011101,123,01111011,152,10011000
26,00011010,35,00100011,61,00111101
120,01111000,116,01110100,236,11101100
24,00011000,59,00111011,83,01010011
101,01100101,6,00000110,107,01101011
126,01111110,66,01000010,192,11000000
36,00100100,113,01110001,149,10010101
59,00111011,60,00111100,119,01110111
110,01101110,55,00110111,165,10100101
36,00100100,15,00001111,51,00110011
29,00011101,92,01011100,121,01111001
38,00100110,4,00000100,42,00101010
88,01011000,125,01111101,213,11010101
45,00101101,100,01100100,145,10010001
1,00000001,91,01011011,92,01011100
70,01000110,32,00100000,102,01100110
19,00010011,102,01100110,121,01111001
33,00100001,119,01110111,152,10011000
45,00101101,112,01110000,157,10011101
4,00000100,114,01110010,118,01110110
67,01000011,2,00000010,69,01000101
46,00101110,113,01110001,159,10011111
121,01111001,42,00101010,163,10100011
66,01000010,124,01111100,190,10111110
33,00100001,73,01001001,106,01101010
14,00001110,81,01010001,95,01011111
45,00101101,77,01001101,122,01111010
18,00010010,36,00100100,54,00110110
122,01111010,18,00010010,140,10001100
117,01110101,86,01010110,203,11001011
15,00001111,55,00110111,70,01000110
118,01110110,78,01001110,196,11000100
93,01011101,124,01111100,217,11011001
103,01100111,11,00001011,114,01110010
83,01010011,93,01011101,176,10110000
49,00110001,60,00111100,109,01101101
104,01101000,4,00000100,108,01101100
27,00011011,120,01111000,147,10010011
97,01100001,90,01011010,187,10111011
48,00110000,116,01110100,164,10100100
78,01001110,6,00000110,84,01010100
113,01110001,66,01000010,179,10110011
8,00001000,0,00000000,8,00001000
44,00101100,112,01110000,156,10011100
63,00111111,12,00001100,75,01001011
19,00010011,55,00110111,74,01001010
119,01110111,107,01101011,226,11100010
0,00000000,83,01010011,83,01010011
5,00000101,96,01100000,101,01100101
64,01000000,58,00111010,122,01111010
30,00011110,63,00111111,93,01011101
83,01010011,99,01100011,182,10110110
123,01111011,119,01110111,242,11110010
120,01111000,27,00011011,147,10010011
77,01001101,17,00010001,94,01011110
37,00100101,49,00110001,86,01010110
68,01000100,93,01011101,161,10100001
17,00010001,96,01100000,113,01110001
43,00101011,83,01010011,126,01111110
104,01101000,100,01100100,204,11001100
107,01101011,82,01010010,189,10111101
71,01000111,102,01100110,173,10101101
82,01010010,1,00000001,83,01010011
62,00111110,50,00110010,112,01110000
12,00001100,2,00000010,14,00001110
114,01110010,95,01011111,209,11010001
86,01010110,49,00110001,135,10000111
9,00001001,46,00101110,55,00110111
116,01110100,118,01110110,234,11101010
111,01101111,35,00100011,146,10010010
90,01011010,112,01110000,202,11001010
38,00100110,102,01100110,140,10001100
62,00111110,115,01110011,177,10110001
42,00101010,49,00110001,91,01011011
6,00000110,120,01111000,126,01111110
80,01010000,5,00000101,85,01010101
57,00111001,80,01010000,137,10001001
28,00011100,72,01001000,100,01100100
38,00100110,127,01111111,165,10100101
79,01001111,41,00101001,120,01111000
57,00111001,119,01110111,176,10110000
43,00101011,87,01010111,130,10000010
28,00011100,45,00101101,73,01001001
4,00000100,80,01010000,84,01010100
70,01000110,86,01010110,156,10011100
91,01011011,49,00110001,140,10001100
119,01110111,47,00101111,166,10100110
109,01101101,115,01110011,224,11100000
108,01101100,54,00110110,162,10100010
33,00100001,127,01111111,160,10100000
26,00011010,66,01000010,92,01011100
121,01111001,111,01101111,232,11101000
13,00001101,63,00111111,76,01001100
75,01001011,14,00001110,89,01011001
124,01111100,10,00001010,134,10000110
73,01001001,25,00011001,98,01100010
10,00001010,26,00011010,36,00100100
124,01111100,122,01111010,246,11110110
17,00010001,85,01010101,102,01100110
35,00100011,34,00100010,69,01000101
32,00100000,61,00111101,93,01011101
58,00111010,64,01000000,122,01111010
68,01000100,15,00001111,83,01010011
105,01101001,25,00011001,130,10000010
124,01111100,60,00111100,184,10111000
12,00001100,50,00110010,62,00111110
67,01000011,24,00011000,91,01011011
121,01111001,67,01000011,188,10111100
77,01001101,53,00110101,130,10000010
6,00000110,37,00100101,43,00101011
71,01000111,71,01000111,142,10001110
55,00110111,63,00111111,118,01110110
49,00110001,89,01011001,138,10001010
9,00001001,57,00111001,66,01000010
71,01000111,74,01001010,145,10010001
38,00100110,79,01001111,117,01110101
82,01010010,85,01010101,167,10100111
34,00100010,35,00100011,69,01000101
81,01010001,63,00111111,144,10010000
27,00011011,87,01010111,114,01110010
35,00100011,85,01010101,120,01111000
105,01101001,33,00100001,138,10001010
32,00100000,80,01010000,112,01110000
103,01100111,86,01010110,189,10111101
75,01001011,23,00010111,98,01100010
91,01011011,70,01000110,161,10100001
5,00000101,104,01101000,109,01101101
118,01110110,78,01001110,196,11000100
13,00001101,49,00110001,62,00111110
61,00111101,111,01101111,172,10101100
96,01100000,1,00000001,97,01100001
100,01100100,34,00100010,134,10000110
59,00111011,122,01111010,181,10110101
0,00000000,33,00100001,33,00100001
10,00001010,1,00000001,11,00001011
75,01001011,47,00101111,122,01111010
113,01110001,126,01111110,239,11101111
59,00111011,98,01100010,157,10011101
66,01000010,44,00101100,110,01101110
74,01001010,36,00100100,110,01101110
62,00111110,17,00010001,79,01001111
121,01111001,105,01101001,226,11100010
58,00111010,8,00001000,66,01000010
0,00000000,124,01111100,124,01111100
34,00100010,84,01010100,118,01110110
39,00100111,9,00001001,48,00110000
34,00100010,91,01011011,125,01111101
114,01110010,4,00000100,118,01110110
66,01000010,11,00001011,77,01001101
125,01111101,118,01110110,243,11110011
16,00010000,78,01001110,94,01011110
46,00101110,121,01111001,167,10100111
34,00100010,110,01101110,144,10010000
85,01010101,9,00001001,94,01011110
23,00010111,46,00101110,69,01000101
30,00011110,88,01011000,118,01110110
63,00111111,1,00000001,64,01000000
96,01100000,73,01001001,169,10101001
65,01000001,67,01000011,132,10000100
70,01000110,118,01110110,188,10111100
88,01011000,60,00111100,148,10010100
3,00000011,53,00110101,56,00111000
65,01000001,86,01010110,151,10010111
115,01110011,1,00000001,116,01110100
0,00000000,54,00110110,54,00110110
102,01100110,76,01001100,178,10110010
67,01000011,12,00001100,79,01001111
55,00110111,102,01100110,157,10011101
37,00100101,14,00001110,51,00110011
45,00101101,37,00100101,82,01010010
55,00110111,81,01010001,136,10001000
50,00110010,102,01100110,152,10011000
39,00100111,72,01001000,111,01101111
45,00101101,96,01100000,141,10001101
24,00011000,33,00100001,57,00111001
117,01110101,53,00110101,170,10101010
59,00111011,31,00011111,90,01011010
1,00000001,93,01011101,94,01011110
36,00100100,49,00110001,85,01010101
62,00111110,115,01110011,177,10110001
98,01100010,106,01101010,204,11001100
127,01111111,37,00100101,164,10100100
58,00111010,113,01110001,171,10101011
109,01101101,4,00000100,113,01110001
96,01100000,3,00000011,99,01100011
126,01111110,99,01100011,225,11100001
14,00001110,108,01101100,122,01111010
61,00111101,113,01110001,174,10101110
4,00000100,6,00000110,10,00001010
115,01110011,108,01101100,223,11011111
126,01111110,35,00100011,161,10100001
119,01110111,53,00110101,172,10101100
124,01111100,27,00011011,151,10010111
61,00111101,45,00101101,106,01101010
8,00001000,65,01000001,73,01001001
43,00101011,107,01101011,150,10010110
63,00111111,32,00100000,95,01011111
23,00010111,104,01101000,127,01111111
25,00011001,125,01111101,150,10010110
113,01110001,110,01101110,223,11011111
66,01000010,117,01110101,183,10110111
120,01111000,35,00100011,155,10011011
92,01011100,75,01001011,167,10100111
50,00110010,49,00110001,99,01100011
65,01000001,37,00100101,102,01100110
28,00011100,5,00000101,33,00100001
62,00111110,97,01100001,159,10011111
49,00110001,90,01011010,139,10001011
8,00001000,38,00100110,46,00101110
40,00101000,12,00001100,52,00110100
126,01111110,79,01001111,205,11001101
47,00101111,86,01010110,133,10000101
10,00001010,119,01110111,129,10000001
35,00100011,19,00010011,54,00110110
34,00100010,56,00111000,90,01011010
9,00001001,89,01011001,98,01100010
126,01111110,52,00110100,178,10110010
70,01000110,39,00100111,109,01101101
75,01001011,12,00001100,87,01010111
98,01100010,32,00100000,130,10000010
53,00110101,122,01111010,175,10101111
80,01010000,67,01000011,147,10010011
78,01001110,100,01100100,178,10110010
55,00110111,81,01010001,136,10001000
73,01001001,61,00111101,134,10000110
34,00100010,27,00011011,61,00111101
28,00011100,45,00101101,73,01001001
10,00001010,5,00000101,15,00001111
95,01011111,79,01001111,174,10101110
44,00101100,77,01001101,121,01111001
55,00110111,70,01000110,125,01111101
15,00001111,7,00000111,22,00010110
108,01101100,82,01010010,190,10111110
37,00100101,25,00011001,62,00111110
59,00111011,28,00011100,87,01010111
50,00110010,90,01011010,140,10001100
72,01001000,47,00101111,119,01110111
59,00111011,29,00011101,88,01011000
19,00010011,35,00100011,54,00110110
114,01110010,57,00111001,171,10101011
35,00100011,29,00011101,64,01000000
80,01010000,68,01000100,148,10010100
99,01100011,50,00110010,149,10010101
48,00110000,63,00111111,111,01101111
36,00100100,85,01010101,121,01111001
3,00000011,9,00001001,12,00001100
34,00100010,50,00110010,84,01010100
79,01001111,37,00100101,116,01110100
12,00001100,74,01001010,86,01010110
20,00010100,81,01010001,101,01100101
84,01010100,22,00010110,106,01101010
15,00001111,99,01100011,114,01110010
90,01011010,2,00000010,92,01011100
19,00010011,80,01010000,99,01100011
126,01111110,51,00110011,177,10110001
100,01100100,78,01001110,178,10110010
102,01100110,50,00110010,152,10011000
87,01010111,59,00111011,146,10010010
43,00101011,4,00000100,47,00101111
50,00110010,10,00001010,60,00111100
108,01101100,30,00011110,138,10001010
32,00100000,36,00100100,68,01000100
18,00010010,23,00010111,41,00101001
90,01011010,101,01100101,191,10111111
47,00101111,35,00100011,82,01010010
48,00110000,127,01111111,175,10101111
44,00101100,61,00111101,105,01101001
95,01011111,26,00011010,121,01111001
101,01100101,116,01110100,217,11011001
46,00101110,33,00100001,79,01001111
126,01111110,56,00111000,182,10110110
120,01111000,101,01100101,221,11011101
71,01000111,40,00101000,111,01101111
18,00010010,105,01101001,123,01111011
31,00011111,126,01111110,157,10011101
124,01111100,63,00111111,187,10111011
30,00011110,74,01001010,104,01101000
29,00011101,83,01010011,112,01110000
37,00100101,17,00010001,54,00110110
9,00001001,14,00001110,23,00010111
7,00000111,123,01111011,130,10000010
14,00001110,49,00110001,63,00111111
27,00011011,27,00011011,54,00110110
32,00100000,50,00110010,82,01010010
97,01100001,96,01100000,193,11000001
118,01110110,103,01100111,221,11011101
119,01110111,96,01100000,215,11010111
87,01010111,69,01000101,156,10011100
81,01010001,121,01111001,202,11001010
99,01100011,100,01100100,199,11000111
0,00000000,28,00011100,28,00011100
44,00101100,65,01000001,109,01101101
112,01110000,48,00110000,160,10100000
62,00111110,68,01000100,130,10000010
125,01111101,36,00100100,161,10100001
126,01111110,94,01011110,220,11011100
0,00000000,53,00110101,53,00110101
114,01110010,42,00101010,156,10011100
21,00010101,18,00010010,39,00100111
43,00101011,118,01110110,161,10100001
97,01100001,0,00000000,97,01100001
126,01111110,46,00101110,172,10101100
71,01000111,44,00101100,115,01110011
119,01110111,78,01001110,197,11000101
34,00100010,88,01011000,122,01111010
115,01110011,62,00111110,177,10110001
67,01000011,63,00111111,130,10000010
67,01000011,106,01101010,173,10101101
11,00001011,106,01101010,117,01110101
40,00101000,105,01101001,145,10010001
35,00100011,66,01000010,101,01100101
100,01100100,77,01001101,177,10110001
13,00001101,97,01100001,110,01101110
46,00101110,66,01000010,112,01110000
92,01011100,44,00101100,136,10001000
16,00010000,121,01111001,137,10001001
33,00100001,48,00110000,81,01010001
56,00111000,83,01010011,139,10001011
54,00110110,67,01000011,121,01111001
86,01010110,84,01010100,170,10101010
70,01000110,12,00001100,82,01010010
51,00110011,36,00100100,87,01010111
89,01011001,40,00101000,129,10000001
70,01000110,113,01110001,183,10110111
24,00011000,55,00110111,79,01001111
41,00101001,59,00111011,100,01100100
117,01110101,6,00000110,123,01111011
46,00101110,120,01111000,166,10100110
102,01100110,65,01000001,167,10100111
93,01011101,68,01000100,161,10100001
25,00011001,40,00101000,65,01000001
27,00011011,80,01010000,107,01101011
75,01001011,81,01010001,156,10011100
114,01110010,112,01110000,226,11100010
56,00111000,78,01001110,134,10000110
56,00111000,102,01100110,158,10011110
17,00010001,105,01101001,122,01111010
111,01101111,42,00101010,153,10011001
32,00100000,77,01001101,109,01101101
119,01110111,8,00001000,127,01111111
30,00011110,121,01111001,151,10010111
80,01010000,65,01000001,145,10010001
51,00110011,94,01011110,145,10010001
0,00000000,70,01000110,70,01000110
52,00110100,84,01010100,136,10001000
43,00101011,88,01011000,131,10000011
101,01100101,107,01101011,208,11010000
99,01100011,54,00110110,153,10011001
18,00010010,30,00011110,48,00110000
6,00000110,97,01100001,103,01100111
86,01010110,63,00111111,149,10010101
115,01110011,92,01011100,207,11001111
88,01011000,20,00010100,108,01101100
29,00011101,2,00000010,31,00011111
121,01111001,86,01010110,207,11001111
65,01000001,115,01110011,180,10110100
68,01000100,119,01110111,187,10111011
119,01110111,58,00111010,177,10110001
124,01111100,45,00101101,169,10101001
52,00110100,55,00110111,107,01101011
4,00000100,85,01010101,89,01011001
122,01111010,102,01100110,224,11100000
44,00101100,49,00110001,93,01011101
49,00110001,55,00110111,104,01101000
79,01001111,127,01111111,206,11001110
8,00001000,28,00011100,36,00100100
68,01000100,33,00100001,101,01100101
116,01110100,36,00100100,152,10011000
114,01110010,66,01000010,180,10110100
110,01101110,92,01011100,202,11001010
49,00110001,47,00101111,96,01100000
63,00111111,64,01000000,127,01111111
30,00011110,115,01110011,145,10010001
5,00000101,17,00010001,22,00010110
21,00010101,96,01100000,117,01110101
101,01100101,67,01000011,168,10101000
48,00110000,123,01111011,171,10101011
70,01000110,25,00011001,95,01011111
46,00101110,123,01111011,169,10101001
116,01110100,46,00101110,162,10100010
5,00000101,100,01100100,105,01101001
39,00100111,117,01110101,156,10011100
64,01000000,29,00011101,93,01011101
56,00111000,81,01010001,137,10001001
74,01001010,127,01111111,201,11001001
125,01111101,17,00010001,142,10001110
2,00000010,26,00011010,28,00011100
51,00110011,44,00101100,95,01011111
105,01101001,68,01000100,173,10101101
88,01011000,77,01001101,165,10100101
106,01101010,3,00000011,109,01101101
98,01100010,4,00000100,102,01100110
46,00101110,75,01001011,121,01111001
58,00111010,86,01010110,144,10010000
8,00001000,86,01010110,94,01011110
14,00001110,108,01101100,122,01111010
13,00001101,9,00001001,22,00010110
81,01010001,50,00110010,131,10000011
8,00001000,112,01110000,120,01111000
89,01011001,73,01001001,162,10100010
110,01101110,32,00100000,142,10001110
33,00100001,91,01011011,124,01111100
37,00100101,39,00100111,76,01001100
18,00010010,4,00000100,22,00010110
53,00110101,6,00000110,59,00111011
15,00001111,48,00110000,63,00111111
10,00001010,116,01110100,126,01111110
58,00111010,4,00000100,62,00111110
71,01000111,51,00110011,122,01111010
97,01100001,25,00011001,122,01111010
61,00111101,39,00100111,100,01100100
46,00101110,118,01110110,164,10100100
118,01110110,5,00000101,123,01111011
102,01100110,72,01001000,174,10101110
20,00010100,67,01000011,87,01010111
116,01110100,97,01100001,213,11010101
48,00110000,25,00011001,73,01001001
91,01011011,14,00001110,105,01101001
26,00011010,100,01100100,126,01111110
124,01111100,56,00111000,180,10110100
104,01101000,3,00000011,107,01101011
110,01101110,47,00101111,157,10011101
41,00101001,36,00100100,77,01001101
15,00001111,8,00001000,23,00010111
95,01011111,42,00101010,137,10001001
54,00110110,27,00011011,81,01010001
80,01010000,47,00101111,127,01111111
47,00101111,123,01111011,170,10101010
80,01010000,26,00011010,106,01101010
82,01010010,86,01010110,168,10101000
0,00000000,57,00111001,57,00111001
94,01011110,68,01000100,162,10100010
84,01010100,95,01011111,179,10110011
43,00101011,60,00111100,103,01100111
43,00101011,74,01001010,117,01110101
33,00100001,46,00101110,79,01001111
19,00010011,44,00101100,63,00111111
1,00000001,11,00001011,12,00001100
53,00110101,81,01010001,134,10000110
7,00000111,121,01111001,128,10000000
116,01110100,5,00000101,121,01111001
98,01100010,13,00001101,111,01101111
117,01110101,88,01011000,205,11001101
57,00111001,96,01100000,153,10011001
126,01111110,9,00001001,135,10000111
76,01001100,52,00110100,128,10000000
75,01001011,125,01111101,200,11001000
9,00001001,120,01111000,129,10000001
23,00010111,86,01010110,109,01101101
18,00010010,2,00000010,20,00010100
5,00000101,113,01110001,118,01110110
16,00010000,17,00010001,33,00100001
15,00001111,18,00010010,33,00100001
51,00110011,103,01100111,154,10011010
106,01101010,82,01010010,188,10111100
118,01110110,10,00001010,128,10000000
108,01101100,93,01011101,201,11001001
103,01100111,91,01011011,194,11000010
19,00010011,81,01010001,100,01100100
8,00001000,47,00101111,55,00110111
1,00000001,89,01011001,90,01011010
33,00100001,26,00011010,59,00111011
69,01000101,125,01111101,194,11000010
8,00001000,23,00010111,31,00011111
105,01101001,87,01010111,192,11000000
119,01110111,101,01100101,220,11011100
16,00010000,87,01010111,103,01100111
66,01000010,67,01000011,133,10000101
127,01111111,95,01011111,222,11011110
10,00001010,41,00101001,51,00110011
63,00111111,117,01110101,180,10110100
22,00010110,98,01100010,120,01111000
55,00110111,127,01111111,182,10110110
69,01000101,50,00110010,119,01110111
101,01100101,82,01010010,183,10110111
116,01110100,82,01010010,198,11000110
22,00010110,64,01000000,86,01010110
83,01010011,87,01010111,170,10101010
82,01010010,26,00011010,108,01101100
14,00001110,120,01111000,134,10000110
8,00001000,98,01100010,106,01101010
45,00101101,33,00100001,78,01001110
43,00101011,80,01010000,123,01111011
57,00111001,9,00001001,66,01000010
1,00000001,111,01101111,112,01110000
96,01100000,44,00101100,140,10001100
104,01101000,85,01010101,189,10111101
73,01001001,118,01110110,191,10111111
64,01000000,65,01000001,129,10000001
0,00000000,16,00010000,16,00010000
42,00101010,117,01110101,159,10011111
94,01011110,94,01011110,188,10111100
48,00110000,46,00101110,94,01011110
104,01101000,60,00111100,164,10100100
50,00110010,8,00001000,58,00111010
40,00101000,70,01000110,110,01101110
59,00111011,85,01010101,144,10010000
10,00001010,55,00110111,65,01000001
4,00000100,19,00010011,23,00010111
6,00000110,113,01110001,119,01110111
108,01101100,69,01000101,177,10110001
97,01100001,106,01101010,203,11001011
45,00101101,4,00000100,49,00110001
105,01101001,3,00000011,108,01101100
73,01001001,2,00000010,75,01001011
105,01101001,11,00001011,116,01110100
76,01001100,70,01000110,146,10010010
114,01110010,114,01110010,228,11100100
4,00000100,40,00101000,44,00101100
13,00001101,57,00111001,70,01000110
74,01001010,74,01001010,148,10010100
74,01001010,12,00001100,86,01010110
69,01000101,80,01010000,149,10010101
43,00101011,83,01010011,126,01111110
18,00010010,70,01000110,88,01011000
123,01111011,90,01011010,213,11010101
110,01101110,6,00000110,116,01110100
2,00000010,29,00011101,31,00011111
66,01000010,53,00110101,119,01110111
2,00000010,18,00010010,20,00010100
23,00010111,7,00000111,30,00011110
19,00010011,101,01100101,120,01111000
92,01011100,113,01110001,205,11001101
69,01000101,116,01110100,185,10111001
123,01111011,69,01000101,192,11000000
50,00110010,57,00111001,107,01101011
99,01100011,108,01101100,207,11001111
31,00011111,3,00000011,34,00100010
17,00010001,46,00101110,63,00111111
73,01001001,9,00001001,82,01010010
69,01000101,34,00100010,103,01100111
125,01111101,103,01100111,228,11100100
32,00100000,95,01011111,127,01111111
105,01101001,96,01100000,201,11001001
25,00011001,83,01010011,108,01101100
31,00011111,51,00110011,82,01010010
7,00000111,52,00110100,59,00111011
86,01010110,15,00001111,101,01100101
50,00110010,48,00110000,98,01100010
36,00100100,90,01011010,126,01111110
38,00100110,102,01100110,140,10001100
98,01100010,24,00011000,122,01111010
105,01101001,94,01011110,199,11000111
1,00000001,41,00101001,42,00101010
119,01110111,120,01111000,239,11101111
88,01011000,91,01011011,179,10110011
43,00101011,16,00010000,59,00111011
76,01001100,73,01001001,149,10010101
65,01000001,75,01001011,140,10001100
46,00101110,122,01111010,168,10101000
8,00001000,18,00010010,26,00011010
16,00010000,40,00101000,56,00111000
106,01101010,114,01110010,220,11011100
89,01011001,8,00001000,97,01100001
110,01101110,118,01110110,228,11100100
90,01011010,2,00000010,92,01011100
24,00011000,62,00111110,86,01010110
75,01001011,104,01101000,179,10110011
70,01000110,61,00111101,131,10000011
109,01101101,2,00000010,111,01101111
81,01010001,0,00000000,81,01010001
21,00010101,32,00100000,53,00110101
58,00111010,108,01101100,166,10100110
28,00011100,76,01001100,104,01101000
59,00111011,125,01111101,184,10111000
28,00011100,101,01100101,129,10000001
123,01111011,126,01111110,249,11111001
87,01010111,50,00110010,137,10001001
89,01011001,54,00110110,143,10001111
107,01101011,15,00001111,122,01111010
76,01001100,109,01101101,185,10111001
104,01101000,79,01001111,183,10110111
90,01011010,39,00100111,129,10000001
4,00000100,50,00110010,54,00110110
1,00000001,111,01101111,112,01110000
31,00011111,125,01111101,156,10011100
112,01110000,113,01110001,225,11100001
57,00111001,127,01111111,184,10111000
4,00000100,110,01101110,114,01110010
85,01010101,77,01001101,162,10100010
27,00011011,68,01000100,95,01011111
68,01000100,44,00101100,112,01110000
125,01111101,6,00000110,131,10000011
31,00011111,122,01111010,153,10011001
122,01111010,120,01111000,242,11110010
4,00000100,47,00101111,51,00110011
72,01001000,32,00100000,104,01101000
105,01101001,109,01101101,214,11010110
8,00001000,116,01110100,124,01111100
26,00011010,62,00111110,88,01011000
12,00001100,76,01001100,88,01011000
55,00110111,37,00100101,92,01011100
74,01001010,7,00000111,81,01010001
83,01010011,23,00010111,106,01101010
0,00000000,108,01101100,108,01101100
113,01110001,82,01010010,195,11000011
100,01100100,98,01100010,198,11000110
117,01110101,1,00000001,118,01110110
127,01111111,88,01011000,215,11010111
116,01110100,40,00101000,156,10011100
108,01101100,103,01100111,211,11010011
23,00010111,35,00100011,58,00111010
32,00100000,62,00111110,94,01011110
84,01010100,40,00101000,124,01111100
93,01011101,88,01011000,181,10110101
45,00101101,69,01000101,114,01110010
23,00010111,80,01010000,103,01100111
106,01101010,67,01000011,173,10101101
120,01111000,118,01110110,238,11101110
13,00001101,0,00000000,13,00001101
111,01101111,33,00100001,144,10010000
59,00111011,50,00110010,109,01101101
13,00001101,72,01001000,85,01010101
18,00010010,45,00101101,63,00111111
68,01000100,114,01110010,182,10110110
32,00100000,120,01111000,152,10011000
93,01011101,77,01001101,170,10101010
56,00111000,77,01001101,133,10000101
120,01111000,5,00000101,125,01111101
67,01000011,88,01011000,155,10011011
57,00111001,94,01011110,151,10010111
69,01000101,79,01001111,148,10010100
21,00010101,120,01111000,141,10001101
27,00011011,77,01001101,104,01101000
27,00011011,109,01101101,136,10001000
119,01110111,92,01011100,211,11010011
76,01001100,47,00101111,123,01111011
37,00100101,4,00000100,41,00101001
67,01000011,107,01101011,174,10101110
90,01011010,15,00001111,105,01101001
30,00011110,53,00110101,83,01010011
45,00101101,55,00110111,100,01100100
2,00000010,110,01101110,112,01110000
118,01110110,24,00011000,142,10001110
82,01010010,24,00011000,106,01101010
20,00010100,90,01011010,110,01101110
95,01011111,75,01001011,170,10101010
105,01101001,6,00000110,111,01101111
116,01110100,74,01001010,190,10111110
56,00111000,124,01111100,180,10110100
48,00110000,47,00101111,95,01011111
70,01000110,53,00110101,123,01111011
39,00100111,94,01011110,133,10000101
102,01100110,84,01010100,186,10111010
48,00110000,5,00000101,53,00110101
33,00100001,26,00011010,59,00111011
92,01011100,51,00110011,143,10001111
121,01111001,78,01001110,199,11000111
121,01111001,16,00010000,137,10001001
109,01101101,83,01010011,192,11000000
75,01001011,13,00001101,88,01011000
57,00111001,53,00110101,110,01101110
37,00100101,29,00011101,66,01000010
107,01101011,40,00101000,147,10010011
31,00011111,91,01011011,122,01111010
91,01011011,2,00000010,93,01011101
85,01010101,126,01111110,211,11010011
63,00111111,86,01010110,149,10010101
126,01111110,93,01011101,219,11011011
108,01101100,38,00100110,146,10010010
46,00101110,24,00011000,70,01000110
76,01001100,93,01011101,169,10101001
17,00010001,76,01001100,93,01011101
68,01000100,9,00001001,77,01001101
18,00010010,38,00100110,56,00111000
89,01011001,79,01001111,168,10101000
88,01011000,119,01110111,207,11001111
83,01010011,23,00010111,106,01101010
105,01101001,60,00111100,165,10100101
52,00110100,18,00010010,70,01000110
70,01000110,72,01001000,142,10001110
10,00001010,24,00011000,34,00100010
109,01101101,44,00101100,153,10011001
107,01101011,1,00000001,108,01101100
83,01010011,114,01110010,197,11000101
50,00110010,38,00100110,88,01011000
27,00011011,19,00010011,46,00101110
67,01000011,122,01111010,189,10111101
72,01001000,86,01010110,158,10011110
58,00111010,62,00111110,120,01111000
12,00001100,64,01000000,76,01001100
16,00010000,24,00011000,40,00101000
114,01110010,95,01011111,209,11010001
96,01100000,99,01100011,195,11000011
69,01000101,117,01110101,186,10111010
54,00110110,122,01111010,176,10110000
69,01000101,61,00111101,130,10000010
1,00000001,24,00011000,25,00011001
12,00001100,49,00110001,61,00111101
41,00101001,54,00110110,95,01011111
83,01010011,54,00110110,137,10001001
31,00011111,106,01101010,137,10001001
71,01000111,20,00010100,91,01011011
26,00011010,29,00011101,55,00110111
51,00110011,77,01001101,128,10000000
83,01010011,82,01010010,165,10100101
64,01000000,105,01101001,169,10101001
97,01100001,36,00100100,133,10000101
90,01011010,125,01111101,215,11010111
26,00011010,126,01111110,152,10011000
101,01100101,11,00001011,112,01110000
123,01111011,8,00001000,131,10000011
122,01111010,90,01011010,212,11010100
29,00011101,109,01101101,138,10001010
63,00111111,60,00111100,123,01111011
23,00010111,82,01010010,105,01101001
112,01110000,22,00010110,134,10000110
99,01100011,103,01100111,202,11001010
43,00101011,17,00010001,60,00111100
62,00111110,88,01011000,150,10010110
20,00010100,22,00010110,42,00101010
73,01001001,42,00101010,115,01110011
85,01010101,125,01111101,210,11010010
61,00111101,77,01001101,138,10001010
47,00101111,109,01101101,156,10011100
113,01110001,126,01111110,239,11101111
5,00000101,29,00011101,34,00100010
43,00101011,65,01000001,108,01101100
91,01011011,67,01000011,158,10011110
25,00011001,16,00010000,41,00101001
80,01010000,108,01101100,188,10111100
47,00101111,62,00111110,109,01101101
11,00001011,72,01001000,83,01010011
30,00011110,111,01101111,141,10001101
46,00101110,20,00010100,66,01000010
75,01001011,28,00011100,103,01100111
18,00010010,68,01000100,86,01010110
70,01000110,21,00010101,91,01011011
107,01101011,120,01111000,227,11100011
5,00000101,1,00000001,6,00000110
94,01011110,75,01001011,169,10101001
93,01011101,107,01101011,200,11001000
0,00000000,108,01101100,108,01101100
18,00010010,65,01000001,83,01010011
84,01010100,57,00111001,141,10001101
115,01110011,95,01011111,210,11010010
115,01110011,38,00100110,153,10011001
91,01011011,109,01101101,200,11001000
14,00001110,29,00011101,43,00101011
124,01111100,94,01011110,218,11011010
1,00000001,59,00111011,60,00111100
6,00000110,77,01001101,83,01010011
37,00100101,34,00100010,71,01000111
26,00011010,52,00110100,78,01001110
3,00000011,33,00100001,36,00100100
85,01010101,104,01101000,189,10111101
62,00111110,118,01110110,180,10110100
24,00011000,40,00101000,64,01000000
126,01111110,71,01000111,197,11000101
39,00100111,105,01101001,144,10010000
121,01111001,66,01000010,187,10111011
42,00101010,7,00000111,49,00110001
96,01100000,63,00111111,159,10011111
73,01001001,27,00011011,100,01100100
12,00001100,125,01111101,137,10001001
1,00000001,17,00010001,18,00010010
29,00011101,82,01010010,111,01101111
1,00000001,58,00111010,59,00111011
100,01100100,71,01000111,171,10101011
118,01110110,63,00111111,181,10110101
86,01010110,119,01110111,205,11001101
59,00111011,126,01111110,185,10111001
107,01101011,21,00010101,128,10000000
44,00101100,83,01010011,127,01111111
100,01100100,36,00100100,136,10001000
54,00110110,30,00011110,84,01010100
98,01100010,127,01111111,225,11100001
113,01110001,60,00111100,173,10101101
123,01111011,42,00101010,165,10100101
94,01011110,50,00110010,144,10010000
61,00111101,72,01001000,133,10000101
91,01011011,107,01101011,198,11000110
68,01000100,39,00100111,107,01101011
51,00110011,42,00101010,93,01011101
114,01110010,77,01001101,191,10111111
36,00100100,106,01101010,142,10001110
45,00101101,107,01101011,152,10011000
72,01001000,11,00001011,83,01010011
17,00010001,79,01001111,96,01100000
18,00010010,64,01000000,82,01010010
119,01110111,54,00110110,173,10101101
52,00110100,81,01010001,133,10000101
105,01101001,42,00101010,147,10010011
87,01010111,30,00011110,117,01110101
25,00011001,61,00111101,86,01010110
5,00000101,15,00001111,20,00010100
105,01101001,21,00010101,126,01111110
16,00010000,18,00010010,34,00100010
9,00001001,35,00100011,44,00101100
41,00101001,82,01010010,123,01111011
67,01000011,66,01000010,133,10000101
15,00001111,16,00010000,31,00011111
10,00001010,105,01101001,115,01110011
36,00100100,112,01110000,148,10010100
67,01000011,83,01010011,150,10010110
101,01100101,25,00011001,126,01111110
48,00110000,26,00011010,74,01001010
9,00001001,86,01010110,95,01011111
26,00011010,121,01111001,147,10010011
0,00000000,65,01000001,65,01000001
81,01010001,116,01110100,197,11000101
81,01010001,111,01101111,192,11000000
111,01101111,54,00110110,165,10100101
112,01110000,63,00111111,175,10101111
62,00111110,54,00110110,116,01110100
7,00000111,27,00011011,34,00100010
122,01111010,104,01101000,226,11100010
30,00011110,99,01100011,129,10000001
34,00100010,46,00101110,80,01010000
35,00100011,81,01010001,116,01110100
87,01010111,110,01101110,197,11000101
52,00110100,94,01011110,146,10010010
20,00010100,126,01111110,146,10010010
82,01010010,68,01000100,150,10010110
116,01110100,36,00100100,152,10011000
5,00000101,68,01000100,73,01001001
64,01000000,113,01110001,177,10110001
59,00111011,31,00011111,90,01011010
56,00111000,83,01010011,139,10001011
80,01010000,104,01101000,184,10111000
16,00010000,13,00001101,29,00011101
39,00100111,116,01110100,155,10011011
111,01101111,123,01111011,234,11101010
3,00000011,100,01100100,103,01100111
25,00011001,86,01010110,111,01101111
29,00011101,67,01000011,96,01100000
65,01000001,30,00011110,95,01011111
86,01010110,34,00100010,120,01111000
104,01101000,107,01101011,211,11010011
20,00010100,109,01101101,129,10000001
12,00001100,88,01011000,100,01100100
2,00000010,43,00101011,45,00101101
90,01011010,28,00011100,118,01110110
62,00111110,47,00101111,109,01101101
100,01100100,44,00101100,144,10010000
10,00001010,67,01000011,77,01001101
27,00011011,78,01001110,105,01101001
78,01001110,35,00100011,113,01110001
31,00011111,43,00101011,74,01001010
32,00100000,85,01010101,117,01110101
39,00100111,20,00010100,59,00111011
97,01100001,111,01101111,208,11010000
24,00011000,37,00100101,61,00111101
6,00000110,37,00100101,43,00101011
51,00110011,62,00111110,113,01110001
52,00110100,28,00011100,80,01010000
42,00101010,101,01100101,143,10001111
100,01100100,65,01000001,165,10100101
42,00101010,28,00011100,70,01000110
57,00111001,44,00101100,101,01100101
9,00001001,86,01010110,95,01011111
97,01100001,8,00001000,105,01101001
79,01001111,33,00100001,112,01110000
120,01111000,121,01111001,241,11110001
26,00011010,113,01110001,139,10001011
124,01111100,40,00101000,164,10100100
126,01111110,27,00011011,153,10011001
84,01010100,100,01100100,184,10111000
87,01010111,79,01001111,166,10100110
83,01010011,3,00000011,86,01010110
2,00000010,53,00110101,55,00110111
104,01101000,18,00010010,122,01111010
41,00101001,52,00110100,93,01011101
71,01000111,122,01111010,193,11000001
35,00100011,122,01111010,157,10011101
77,01001101,90,01011010,167,10100111
42,00101010,79,01001111,121,01111001
82,01010010,93,01011101,175,10101111
109,01101101,66,01000010,175,10101111
99,01100011,127,01111111,226,11100010
29,00011101,14,00001110,43,00101011
49,00110001,102,01100110,151,10010111
36,00100100,43,00101011,79,01001111
77,01001101,12,00001100,89,01011001
30,00011110,48,00110000,78,01001110
94,01011110,82,01010010,176,10110000
92,01011100,12,00001100,104,01101000
124,01111100,76,01001100,200,11001000
44,00101100,5,00000101,49,00110001
121,01111001,75,01001011,196,11000100
121,01111001,8,00001000,129,10000001
47,00101111,40,00101000,87,01010111
75,01001011,111,01101111,186,10111010
54,00110110,81,01010001,135,10000111
27,00011011,5,00000101,32,00100000
56,00111000,18,00010010,74,01001010
59,00111011,76,01001100,135,10000111
127,01111111,48,00110000,175,10101111
48,00110000,50,00110010,98,01100010
47,00101111,66,01000010,113,01110001
15,00001111,72,01001000,87,01010111
73,01001001,100,01100100,173,10101101
105,01101001,111,01101111,216,11011000
60,00111100,127,01111111,187,10111011
13,00001101,44,00101100,57,00111001
48,00110000,94,01011110,142,10001110
16,00010000,24,00011000,40,00101000
32,00100000,26,00011010,58,00111010
4,00000100,117,01110101,121,01111001
111,01101111,72,01001000,183,10110111
76,01001100,118,01110110,194,11000010
44,00101100,12,00001100,56,00111000
121,01111001,28,00011100,149,10010101
5,00000101,123,01111011,128,10000000
12,00001100,81,01010001,93,01011101
40,00101000,113,01110001,153,10011001
61,00111101,96,01100000,157,10011101
66,01000010,16,00010000,82,01010010
21,00010101,88,01011000,109,01101101
109,01101101,0,00000000,109,01101101
78,01001110,59,00111011,137,10001001
64,01000000,100,01100100,164,10100100
106,01101010,117,01110101,223,11011111
71,01000111,118,01110110,189,10111101
27,00011011,49,00110001,76,01001100
2,00000010,110,01101110,112,01110000
52,00110100,39,00100111,91,01011011
0,00000000,97,01100001,97,01100001
44,00101100,49,00110001,93,01011101
18,00010010,27,00011011,45,00101101
36,00100100,2,00000010,38,00100110
74,01001010,66,01000010,140,10001100
17,00010001,101,01100101,118,01110110
35,00100011,12,00001100,47,00101111
115,01110011,95,01011111,210,11010010
31,00011111,52,00110100,83,01010011
77,01001101,77,01001101,154,10011010
102,01100110,23,00010111,125,01111101
80,01010000,93,01011101,173,10101101
8,00001000,86,01010110,94,01011110
84,01010100,9,00001001,93,01011101
73,01001001,3,00000011,76,01001100
103,01100111,31,00011111,134,10000110
90,01011010,32,00100000,122,01111010
7,00000111,41,00101001,48,00110000
4,00000100,109,01101101,113,01110001
114,01110010,14,00001110,128,10000000
15,00001111,106,01101010,121,01111001
77,01001101,63,00111111,140,10001100
54,00110110,24,00011000,78,01001110
17,00010001,108,01101100,125,01111101
5,00000101,116,01110100,121,01111001
109,01101101,61,00111101,170,10101010
121,01111001,125,01111101,246,11110110
38,00100110,37,00100101,75,01001011
82,01010010,44,00101100,126,01111110
92,01011100,62,00111110,154,10011010
113,01110001,67,01000011,180,10110100
108,01101100,38,00100110,146,10010010
100,01100100,43,00101011,143,10001111
3,00000011,6,00000110,9,00001001
111,01101111,49,00110001,160,10100000
12,00001100,21,00010101,33,00100001
16,00010000,108,01101100,124,01111100
57,00111001,114,01110010,171,10101011
9,00001001,37,00100101,46,00101110
5,00000101,73,01001001,78,01001110
123,01111011,117,01110101,240,11110000
71,01000111,113,01110001,184,10111000
104,01101000,66,01000010,170,10101010
98,01100010,38,00100110,136,10001000
125,01111101,59,00111011,184,10111000
120,01111000,20,00010100,140,10001100
45,00101101,15,00001111,60,00111100
17,00010001,42,00101010,59,00111011
116,01110100,64,01000000,180,10110100
100,01100100,5,00000101,105,01101001
90,01011010,10,00001010,100,01100100
92,01011100,14,00001110,106,01101010
41,00101001,115,01110011,156,10011100
111,01101111,74,01001010,185,10111001
19,00010011,30,00011110,49,00110001
99,01100011,0,00000000,99,01100011
105,01101001,56,00111000,161,10100001
24,00011000,69,01000101,93,01011101
16,00010000,60,00111100,76,01001100
122,01111010,116,01110100,238,11101110
83,01010011,108,01101100,191,10111111
108,01101100,34,00100010,142,10001110
49,00110001,67,01000011,116,01110100
47,00101111,46,00101110,93,01011101
104,01101000,59,00111011,163,10100011
46,00101110,90,01011010,136,10001000
66,01000010,18,00010010,84,01010100
19,00010011,101,01100101,120,01111000
103,01100111,57,00111001,160,10100000
72,01001000,56,00111000,128,10000000
106,01101010,88,01011000,194,11000010
60,00111100,104,01101000,164,10100100
110,01101110,3,00000011,113,01110001
91,01011011,17,00010001,108,01101100
25,00011001,15,00001111,40,00101000
11,00001011,100,01100100,111,01101111
121,01111001,75,01001011,196,11000100
77,01001101,60,00111100,137,10001001
85,01010101,39,00100111,124,01111100
73,01001001,100,01100100,173,10101101
109,01101101,114,01110010,223,11011111
43,00101011,49,00110001,92,01011100
39,00100111,0,00000000,39,00100111
31,00011111,23,00010111,54,00110110
109,01101101,109,01101101,218,11011010
10,00001010,31,00011111,41,00101001
80,01010000,127,01111111,207,11001111
108,01101100,114,01110010,222,11011110
77,01001101,122,01111010,199,11000111
91,01011011,38,00100110,129,10000001
34,00100010,11,00001011,45,00101101
69,01000101,38,00100110,107,01101011
120,01111000,69,01000101,189,10111101
112,01110000,120,01111000,232,11101000
21,00010101,33,00100001,54,00110110
53,00110101,32,00100000,85,01010101
49,00110001,42,00101010,91,01011011
57,00111001,97,01100001,154,10011010
14,00001110,125,01111101,139,10001011
40,00101000,122,01111010,162,10100010
24,00011000,14,00001110,38,00100110
13,00001101,116,01110100,129,10000001
82,01010010,81,01010001,163,10100011
101,01100101,72,01001000,173,10101101
26,00011010,82,01010010,108,01101100
124,01111100,117,01110101,241,11110001
26,00011010,39,00100111,65,01000001
62,00111110,32,00100000,94,01011110
101,01100101,85,01010101,186,10111010
7,00000111,103,01100111,110,01101110
102,01100110,17,00010001,119,01110111
87,01010111,53,00110101,140,10001100
123,01111011,19,00010011,142,10001110
36,00100100,72,01001000,108,01101100
73,01001001,49,00110001,122,01111010
125,01111101,33,00100001,158,10011110
43,00101011,5,00000101,48,00110000
17,00010001,59,00111011,76,01001100
116,01110100,79,01001111,195,11000011
96,01100000,55,00110111,151,10010111
10,00001010,74,01001010,84,01010100
46,00101110,117,01110101,163,10100011
37,00100101,102,01100110,139,10001011
80,01010000,4,00000100,84,01010100
37,00100101,41,00101001,78,01001110
54,00110110,41,00101001,95,01011111
78,01001110,25,00011001,103,01100111
37,00100101,50,00110010,87,01010111
116,01110100,124,01111100,240,11110000
102,01100110,48,00110000,150,10010110
27,00011011,89,01011001,116,01110100
116,01110100,67,01000011,183,10110111
47,00101111,51,00110011,98,01100010
24,00011000,16,00010000,40,00101000
25,00011001,108,01101100,133,10000101
97,01100001,52,00110100,149,10010101
35,00100011,19,00010011,54,00110110
123,01111011,2,00000010,125,01111101
121,01111001,76,01001100,197,11000101
114,01110010,62,00111110,176,10110000
33,00100001,56,00111000,89,01011001
12,00001100,72,01001000,84,01010100
59,00111011,86,01010110,145,10010001
61,00111101,111,01101111,172,10101100
112,01110000,73,01001001,185,10111001
40,00101000,28,00011100,68,01000100
123,01111011,89,01011001,212,11010100
30,00011110,120,01111000,150,10010110
38,00100110,127,01111111,165,10100101
118,01110110,67,01000011,185,10111001
74,01001010,9,00001001,83,01010011
63,00111111,125,01111101,188,10111100
115,01110011,120,01111000,235,11101011
29,00011101,111,01101111,140,10001100
4,00000100,34,00100010,38,00100110
61,00111101,110,01101110,171,10101011
103,01100111,39,00100111,142,10001110
34,00100010,112,01110000,146,10010010
8,00001000,87,01010111,95,01011111
43,00101011,90,01011010,133,10000101
45,00101101,59,00111011,104,01101000
2,00000010,39,00100111,41,00101001
30,00011110,65,01000001,95,01011111
21,00010101,74,01001010,95,01011111
43,00101011,7,00000111,50,00110010
40,00101000,97,01100001,137,10001001
65,01000001,105,01101001,170,10101010
74,01001010,127,01111111,201,11001001
34,00100010,26,00011010,60,00111100
74,01001010,25,00011001,99,01100011
24,00011000,86,01010110,110,01101110
46,00101110,126,01111110,172,10101100
11,00001011,25,00011001,36,00100100
28,00011100,97,01100001,125,01111101
76,01001100,61,00111101,137,10001001
36,00100100,53,00110101,89,01011001
49,00110001,47,00101111,96,01100000
126,01111110,54,00110110,180,10110100
120,01111000,97,01100001,217,11011001
84,01010100,23,00010111,107,01101011
34,00100010,70,01000110,104,01101000
59,00111011,29,00011101,88,01011000
38,00100110,25,00011001,63,00111111
15,00001111,74,01001010,89,01011001
7,00000111,116,01110100,123,01111011
67,01000011,106,01101010,173,10101101
68,01000100,55,00110111,123,01111011
32,00100000,93,01011101,125,01111101
100,01100100,118,01110110,218,11011010
50,00110010,122,01111010,172,10101100
4,00000100,41,00101001,45,00101101
105,01101001,11,00001011,116,01110100
12,00001100,6,00000110,18,00010010
25,00011001,79,01001111,104,01101000
96,01100000,46,00101110,142,10001110
86,01010110,55,00110111,141,10001101
64,01000000,117,01110101,181,10110101
43,00101011,9,00001001,52,00110100
82,01010010,101,01100101,183,10110111
109,01101101,3,00000011,112,01110000
26,00011010,36,00100100,62,00111110
8,00001000,82,01010010,90,01011010
94,01011110,80,01010000,174,10101110
108,01101100,40,00101000,148,10010100
39,00100111,109,01101101,148,10010100
52,00110100,53,00110101,105,01101001
30,00011110,39,00100111,69,01000101
74,01001010,107,01101011,181,10110101
114,01110010,20,00010100,134,10000110
34,00100010,105,01101001,139,10001011
66,01000010,95,01011111,161,10100001
6,00000110,60,00111100,66,01000010
71,01000111,96,01100000,167,10100111
38,00100110,101,01100101,139,10001011
44,00101100,68,01000100,112,01110000
117,01110101,60,00111100,177,10110001
113,01110001,23,00010111,136,10001000
45,00101101,37,00100101,82,01010010
24,00011000,58,00111010,82,01010010
94,01011110,52,00110100,146,10010010
101,01100101,66,01000010,167,10100111
126,01111110,92,01011100,218,11011010
62,00111110,74,01001010,136,10001000
71,01000111,6,00000110,77,01001101
88,01011000,68,01000100,156,10011100
6,00000110,10,00001010,16,00010000
66,01000010,89,01011001,155,10011011
114,01110010,92,01011100,206,11001110
32,00100000,79,01001111,111,01101111
61,00111101,78,01001110,139,10001011
1,00000001,12,00001100,13,00001101
83,01010011,25,00011001,108,01101100
77,01001101,67,01000011,144,10010000
107,01101011,78,01001110,185,10111001
22,00010110,106,01101010,128,10000000
51,00110011,31,00011111,82,01010010
18,00010010,48,00110000,66,01000010
5,00000101,11,00001011,16,00010000
117,01110101,67,01000011,184,10111000
122,01111010,51,00110011,173,10101101
39,00100111,76,01001100,115,01110011
7,00000111,120,01111000,127,01111111
66,01000010,105,01101001,171,10101011
57,00111001,59,00111011,116,01110100
45,00101101,41,00101001,86,01010110
79,01001111,25,00011001,104,01101000
56,00111000,120,01111000,176,10110000
27,00011011,24,00011000,51,00110011
125,01111101,70,01000110,195,11000011
41,00101001,46,00101110,87,01010111
105,01101001,67,01000011,172,10101100
68,01000100,53,00110101,121,01111001
16,00010000,84,01010100,100,01100100
42,00101010,110,01101110,152,10011000
106,01101010,96,01100000,202,11001010
4,00000100,1,00000001,5,00000101
83,01010011,90,01011010,173,10101101
17,00010001,13,00001101,30,00011110
104,01101000,24,00011000,128,10000000
109,01101101,81,01010001,190,10111110
112,01110000,7,00000111,119,01110111
57,00111001,12,00001100,69,01000101
36,00100100,72,01001000,108,01101100
18,00010010,78,01001110,96,01100000
120,01111000,49,00110001,169,10101001
69,01000101,122,01111010,191,10111111
6,00000110,87,01010111,93,01011101
72,01001000,77,01001101,149,10010101
20,00010100,103,01100111,123,01111011
112,01110000,75,01001011,187,10111011
89,01011001,116,01110100,205,11001101
77,01001101,65,01000001,142,10001110
5,00000101,67,01000011,72,01001000
124,01111100,16,00010000,140,10001100
110,01101110,122,01111010,232,11101000
96,01100000,84,01010100,180,10110100
43,00101011,108,01101100,151,10010111
97,01100001,0,00000000,97,01100001
111,01101111,45,00101101,156,10011100
15,00001111,16,00010000,31,00011111
42,00101010,2,00000010,44,00101100
16,00010000,84,01010100,100,01100100
37,00100101,44,00101100,81,01010001
37,00100101,42,00101010,79,01001111
1,00000001,102,01100110,103,01100111
114,01110010,58,00111010,172,10101100
2,00000010,14,00001110,16,00010000
105,01101001,76,01001100,181,10110101
90,01011010,32,00100000,122,01111010
111,01101111,91,01011011,202,11001010
70,01000110,42,00101010,112,01110000
59,00111011,104,01101000,163,10100011
93,01011101,103,01100111,196,11000100
107,01101011,39,00100111,146,10010010
81,01010001,46,00101110,127,01111111
104,01101000,93,01011101,197,11000101
52,00110100,48,00110000,100,01100100
73,01001001,117,01110101,190,10111110
81,01010001,63,00111111,144,10010000
74,01001010,12,00001100,86,01010110
125,01111101,111,01101111,236,11101100
126,01111110,95,01011111,221,11011101
1,00000001,25,00011001,26,00011010
24,00011000,77,01001101,101,01100101
105,01101001,94,01011110,199,11000111
113,01110001,44,00101100,157,10011101
55,00110111,106,01101010,161,10100001
40,00101000,117,01110101,157,10011101
108,01101100,30,00011110,138,10001010
57,00111001,19,00010011,76,01001100
92,01011100,48,00110000,140,10001100
6,00000110,108,01101100,114,01110010
74,01001010,118,01110110,192,11000000
40,00101000,83,01010011,123,01111011
112,01110000,56,00111000,168,10101000
6,00000110,37,00100101,43,00101011
80,01010000,5,00000101,85,01010101
34,00100010,12,00001100,46,00101110
93,01011101,114,01110010,207,11001111
20,00010100,93,01011101,113,01110001
10,00001010,91,01011011,101,01100101
50,00110010,124,01111100,174,10101110
97,01100001,106,01101010,203,11001011
74,01001010,93,01011101,167,10100111
10,00001010,15,00001111,25,00011001
54,00110110,17,00010001,71,01000111
93,01011101,80,01010000,173,10101101
56,00111000,76,01001100,132,10000100
92,01011100,4,00000100,96,01100000
6,00000110,109,01101101,115,01110011
62,00111110,119,01110111,181,10110101
50,00110010,49,00110001,99,01100011
44,00101100,42,00101010,86,01010110
30,00011110,83,01010011,113,01110001
18,00010010,34,00100010,52,00110100
29,00011101,78,01001110,107,01101011
14,00001110,108,01101100,122,01111010
122,01111010,2,00000010,124,01111100
122,01111010,65,01000001,187,10111011
7,00000111,113,01110001,120,01111000
34,00100010,88,01011000,122,01111010
31,00011111,109,01101101,140,10001100
65,01000001,124,01111100,189,10111101
100,01100100,69,01000101,169,10101001
36,00100100,9,00001001,45,00101101
55,00110111,71,01000111,126,01111110
54,00110110,67,01000011,121,01111001
17,00010001,98,01100010,115,01110011
106,01101010,88,01011000,194,11000010
61,00111101,47,00101111,108,01101100
94,01011110,100,01100100,194,11000010
40,00101000,31,00011111,71,01000111
9,00001001,107,01101011,116,01110100
16,00010000,82,01010010,98,01100010
22,00010110,73,01001001,95,01011111
127,01111111,29,00011101,156,10011100
67,01000011,68,01000100,135,10000111
9,00001001,117,01110101,126,01111110
80,01010000,90,01011010,170,10101010
31,00011111,71,01000111,102,01100110
24,00011000,81,01010001,105,01101001
102,01100110,1,00000001,103,01100111
101,01100101,27,00011011,128,10000000
36,00100100,70,01000110,106,01101010
58,00111010,77,01001101,135,10000111
5,00000101,112,01110000,117,01110101
55,00110111,24,00011000,79,01001111
6,00000110,110,01101110,116,01110100
106,01101010,113,01110001,219,11011011
118,01110110,81,01010001,199,11000111
124,01111100,50,00110010,174,10101110
77,01001101,102,01100110,179,10110011
69,01000101,104,01101000,173,10101101
6,00000110,84,01010100,90,01011010
51,00110011,28,00011100,79,01001111
45,00101101,93,01011101,138,10001010
49,00110001,31,00011111,80,01010000
120,01111000,105,01101001,225,11100001
37,00100101,127,01111111,164,10100100
91,01011011,56,00111000,147,10010011
64,01000000,42,00101010,106,01101010
85,01010101,40,00101000,125,01111101
75,01001011,5,00000101,80,01010000
105,01101001,10,00001010,115,01110011
34,00100010,88,01011000,122,01111010
11,00001011,34,00100010,45,00101101
31,00011111,68,01000100,99,01100011
27,00011011,39,00100111,66,01000010
20,00010100,25,00011001,45,00101101
66,01000010,1,00000001,67,01000011
105,01101001,15,00001111,120,01111000
19,00010011,46,00101110,65,01000001
84,01010100,96,01100000,180,10110100
78,01001110,44,00101100,122,01111010
105,01101001,7,00000111,112,01110000
9,00001001,12,00001100,21,00010101
83,01010011,56,00111000,139,10001011
38,00100110,45,00101101,83,01010011
99,01100011,46,00101110,145,10010001
48,00110000,57,00111001,105,01101001
18,00010010,50,00110010,68,01000100
35,00100011,8,00001000,43,00101011
126,01111110,102,01100110,228,11100100
87,01010111,16,00010000,103,01100111
8,00001000,59,00111011,67,01000011
117,01110101,108,01101100,225,11100001
51,00110011,24,00011000,75,01001011
12,00001100,40,00101000,52,00110100
21,00010101,91,01011011,112,01110000
25,00011001,33,00100001,58,00111010
76,01001100,116,01110100,192,11000000
107,01101011,105,01101001,212,11010100
2,00000010,35,00100011,37,00100101
24,00011000,71,01000111,95,01011111
11,00001011,56,00111000,67,01000011
39,00100111,79,01001111,118,01110110
40,00101000,75,01001011,115,01110011
98,01100010,97,01100001,195,11000011
38,00100110,112,01110000,150,10010110
4,00000100,76,01001100,80,01010000
34,00100010,28,00011100,62,00111110
109,01101101,77,01001101,186,10111010
111,01101111,37,00100101,148,10010100
74,01001010,98,01100010,172,10101100
59,00111011,99,01100011,158,10011110
69,01000101,87,01010111,156,10011100
114,01110010,25,00011001,139,10001011
22,00010110,30,00011110,52,00110100
90,01011010,51,00110011,141,10001101
45,00101101,62,00111110,107,01101011
98,01100010,23,00010111,121,01111001
114,01110010,112,01110000,226,11100010
35,00100011,14,00001110,49,00110001
29,00011101,78,01001110,107,01101011
83,01010011,34,00100010,117,01110101
45,00101101,54,00110110,99,01100011
97,01100001,61,00111101,158,10011110
90,01011010,68,01000100,158,10011110
83,01010011,109,01101101,192,11000000
31,00011111,118,01110110,149,10010101
30,00011110,110,01101110,140,10001100
34,00100010,119,01110111,153,10011001
112,01110000,33,00100001,145,10010001
3,00000011,31,00011111,34,00100010
18,00010010,125,01111101,143,10001111
112,01110000,29,00011101,141,10001101
33,00100001,87,01010111,120,01111000
61,00111101,79,01001111,140,10001100
93,01011101,69,01000101,162,10100010
5,00000101,125,01111101,130,10000010
4,00000100,13,00001101,17,00010001
38,00100110,97,01100001,135,10000111
83,01010011,115,01110011,198,11000110
30,00011110,116,01110100,146,10010010
3,00000011,125,01111101,128,10000000
93,01011101,12,00001100,105,01101001
19,00010011,15,00001111,34,00100010
13,00001101,98,01100010,111,01101111
84,01010100,27,00011011,111,01101111
83,01010011,94,01011110,177,10110001
109,01101101,83,01010011,192,11000000
94,01011110,97,01100001,191,10111111
115,01110011,21,00010101,136,10001000
81,01010001,67,01000011,148,10010100
23,00010111,14,00001110,37,00100101
116,01110100,55,00110111,171,10101011
98,01100010,17,00010001,115,01110011
101,01100101,66,01000010,167,10100111
86,01010110,57,00111001,143,10001111
63,00111111,15,00001111,78,01001110
6,00000110,100,01100100,106,01101010
85,01010101,75,01001011,160,10100000
75,01001011,51,00110011,126,01111110
110,01101110,70,01000110,180,10110100
87,01010111,18,00010010,105,01101001
13,00001101,115,01110011,128,10000000
119,01110111,88,01011000,207,11001111
71,01000111,119,01110111,190,10111110
37,00100101,98,01100010,135,10000111
3,00000011,125,01111101,128,10000000
50,00110010,82,01010010,132,10000100
23,00010111,97,01100001,120,01111000
53,00110101,69,01000101,122,01111010
47,00101111,94,01011110,141,10001101
25,00011001,53,00110101,78,01001110
113,01110001,3,00000011,116,01110100
8,00001000,9,00001001,17,00010001
126,01111110,88,01011000,214,11010110
49,00110001,44,00101100,93,01011101
30,00011110,75,01001011,105,01101001
62,00111110,2,00000010,64,01000000
48,00110000,84,01010100,132,10000100
47,00101111,11,00001011,58,00111010
96,01100000,28,00011100,124,01111100
115,01110011,101,01100101,216,11011000
107,01101011,37,00100101,144,10010000
38,00100110,54,00110110,92,01011100
35,00100011,10,00001010,45,00101101
63,00111111,25,00011001,88,01011000
53,00110101,91,01011011,144,10010000
84,01010100,58,00111010,142,10001110
127,01111111,77,01001101,204,11001100
90,01011010,22,00010110,112,01110000
54,00110110,67,01000011,121,01111001
22,00010110,29,00011101,51,00110011
63,00111111,57,00111001,120,01111000
111,01101111,114,01110010,225,11100001
101,01100101,44,00101100,145,10010001
0,00000000,102,01100110,102,01100110
76,01001100,79,01001111,155,10011011
10,00001010,108,01101100,118,01110110
75,01001011,101,01100101,176,10110000
109,01101101,119,01110111,228,11100100
81,01010001,71,01000111,152,10011000
21,00010101,23,00010111,44,00101100
99,01100011,10,00001010,109,01101101
46,00101110,117,01110101,163,10100011
17,00010001,11,00001011,28,00011100
39,00100111,40,00101000,79,01001111
63,00111111,8,00001000,71,01000111
55,00110111,18,00010010,73,01001001
44,00101100,6,00000110,50,00110010
100,01100100,109,01101101,209,11010001
95,01011111,17,00010001,112,01110000
108,01101100,2,00000010,110,01101110
50,00110010,7,00000111,57,00111001
85,01010101,1,00000001,86,01010110
15,00001111,70,01000110,85,01010101
111,01101111,10,00001010,121,01111001
58,00111010,73,01001001,131,10000011
40,00101000,118,01110110,158,10011110
56,00111000,77,01001101,133,10000101
70,01000110,122,01111010,192,11000000
24,00011000,10,00001010,34,00100010
114,01110010,122,01111010,236,11101100
46,00101110,34,00100010,80,01010000
64,01000000,93,01011101,157,10011101
113,01110001,29,00011101,142,10001110
117,01110101,75,01001011,192,11000000
89,01011001,92,01011100,181,10110101
24,00011000,79,01001111,103,01100111
40,00101000,30,00011110,70,01000110
112,01110000,96,01100000,208,11010000
124,01111100,39,00100111,163,10100011
107,01101011,61,00111101,168,10101000
97,01100001,97,01100001,194,11000010
93,01011101,111,01101111,204,11001100
15,00001111,117,01110101,132,10000100
14,00001110,58,00111010,72,01001000
118,01110110,55,00110111,173,10101101
76,01001100,21,00010101,97,01100001
61,00111101,4,00000100,65,01000001
1,00000001,83,01010011,84,01010100
16,00010000,23,00010111,39,00100111
114,01110010,18,00010010,132,10000100
123,01111011,44,00101100,167,10100111
24,00011000,88,01011000,112,01110000
80,01010000,31,00011111,111,01101111
32,00100000,95,01011111,127,01111111
79,01001111,20,00010100,99,01100011
36,00100100,56,00111000,92,01011100
30,00011110,104,01101000,134,10000110
93,01011101,107,01101011,200,11001000
117,01110101,48,00110000,165,10100101
30,00011110,84,01010100,114,01110010
48,00110000,112,01110000,160,10100000
51,00110011,49,00110001,100,01100100
92,01011100,120,01111000,212,11010100
90,01011010,81,01010001,171,10101011
70,01000110,29,00011101,99,01100011
51,00110011,1,00000001,52,00110100
6,00000110,54,00110110,60,00111100
53,00110101,117,01110101,170,10101010
45,00101101,119,01110111,164,10100100
1,00000001,84,01010100,85,01010101
61,00111101,93,01011101,154,10011010
113,01110001,105,01101001,218,11011010
114,01110010,17,00010001,131,10000011
29,00011101,102,01100110,131,10000011
119,01110111,59,00111011,178,10110010
71,01000111,84,01010100,155,10011011
91,01011011,89,01011001,180,10110100
8,00001000,76,01001100,84,01010100
87,01010111,69,01000101,156,10011100
125,01111101,94,01011110,219,11011011
35,00100011,27,00011011,62,00111110
121,01111001,93,01011101,214,11010110
111,01101111,92,01011100,203,11001011
24,00011000,74,01001010,98,01100010
23,00010111,84,01010100,107,01101011
124,01111100,1,00000001,125,01111101
103,01100111,6,00000110,109,01101101
117,01110101,98,01100010,215,11010111
89,01011001,30,00011110,119,01110111
14,00001110,108,01101100,122,01111010
39,00100111,106,01101010,145,10010001
30,00011110,18,00010010,48,00110000
2,00000010,19,00010011,21,00010101
119,01110111,121,01111001,240,11110000
61,00111101,96,01100000,157,10011101
16,00010000,103,01100111,119,01110111
58,00111010,101,01100101,159,10011111
40,00101000,99,01100011,139,10001011
74,01001010,47,00101111,121,01111001
97,01100001,67,01000011,164,10100100
85,01010101,13,00001101,98,01100010
104,01101000,36,00100100,140,10001100
94,01011110,43,00101011,137,10001001
81,01010001,125,01111101,206,11001110
122,01111010,41,00101001,163,10100011
28,00011100,108,01101100,136,10001000
34,00100010,58,00111010,92,01011100
122,01111010,78,01001110,200,11001000
124,01111100,70,01000110,194,11000010
87,01010111,127,01111111,214,11010110
25,00011001,28,00011100,53,00110101
116,01110100,35,00100011,151,10010111
69,01000101,127,01111111,196,11000100
117,01110101,105,01101001,222,11011110
0,00000000,4,00000100,4,00000100
68,01000100,99,01100011,167,10100111
73,01001001,28,00011100,101,01100101
109,01101101,2,00000010,111,01101111
50,00110010,46,00101110,96,01100000
18,00010010,87,01010111,105,01101001
113,01110001,119,01110111,232,11101000
87,01010111,37,00100101,124,01111100
47,00101111,101,01100101,148,10010100
38,00100110,48,00110000,86,01010110
94,01011110,48,00110000,142,10001110
5,00000101,69,01000101,74,01001010
2,00000010,18,00010010,20,00010100
19,00010011,103,01100111,122,01111010
28,00011100,110,01101110,138,10001010
9,00001001,122,01111010,131,10000011
78,01001110,64,01000000,142,10001110
11,00001011,9,00001001,20,00010100
62,00111110,51,00110011,113,01110001
91,01011011,75,01001011,166,10100110
66,01000010,99,01100011,165,10100101
76,01001100,18,00010010,94,01011110
7,00000111,65,01000001,72,01001000
121,01111001,30,00011110,151,10010111
7,00000111,78,01001110,85,01010101
32,00100000,103,01100111,135,10000111
97,01100001,74,01001010,171,10101011
92,01011100,103,01100111,195,11000011
17,00010001,2,00000010,19,00010011
119,01110111,23,00010111,142,10001110
36,00100100,106,01101010,142,10001110
79,01001111,6,00000110,85,01010101
22,00010110,77,01001101,99,01100011
122,01111010,88,01011000,210,11010010
63,00111111,57,00111001,120,01111000
90,01011010,124,01111100,214,11010110
31,00011111,21,00010101,52,00110100
8,00001000,104,01101000,112,01110000
69,01000101,118,01110110,187,10111011
25,00011001,59,00111011,84,01010100
73,01001001,113,01110001,186,10111010
10,00001010,15,00001111,25,00011001
39,00100111,30,00011110,69,01000101
68,01000100,104,01101000,172,10101100
12,00001100,115,01110011,127,01111111
69,01000101,104,01101000,173,10101101
8,00001000,93,01011101,101,01100101
81,01010001,13,00001101,94,01011110
74,01001010,13,00001101,87,01010111
3,00000011,44,00101100,47,00101111
71,01000111,74,01001010,145,10010001
92,01011100,50,00110010,142,10001110
29,00011101,83,01010011,112,01110000
18,00010010,32,00100000,50,00110010
99,01100011,116,01110100,215,11010111
57,00111001,82,01010010,139,10001011
3,00000011,83,01010011,86,01010110
44,00101100,114,01110010,158,10011110
1,00000001,27,00011011,28,00011100
91,01011011,24,00011000,115,01110011
52,00110100,35,00100011,87,01010111
93,01011101,40,00101000,133,10000101
83,01010011,19,00010011,102,01100110
122,01111010,28,00011100,150,10010110
12,00001100,46,00101110,58,00111010
93,01011101,68,01000100,161,10100001
27,00011011,118,01110110,145,10010001
61,00111101,91,01011011,152,10011000
44,00101100,80,01010000,124,01111100
88,01011000,41,00101001,129,10000001
69,01000101,93,01011101,162,10100010
70,01000110,8,00001000,78,01001110
118,01110110,99,01100011,217,11011001
111,01101111,62,00111110,173,10101101
9,00001001,35,00100011,44,00101100
77,01001101,26,00011010,103,01100111
72,01001000,60,00111100,132,10000100
125,01111101,100,01100100,225,11100001
7,00000111,42,00101010,49,00110001
34,00100010,111,01101111,145,10010001
91,01011011,55,00110111,146,10010010
116,01110100,78,01001110,194,11000010
23,00010111,89,01011001,112,01110000
37,00100101,72,01001000,109,01101101
85,01010101,36,00100100,121,01111001
23,00010111,103,01100111,126,01111110
29,00011101,12,00001100,41,00101001
64,01000000,102,01100110,166,10100110
40,00101000,120,01111000,160,10100000
93,01011101,3,00000011,96,01100000
127,01111111,71,01000111,198,11000110
34,00100010,63,00111111,97,01100001
7,00000111,52,00110100,59,00111011
117,01110101,16,00010000,133,10000101
114,01110010,80,01010000,194,11000010
33,00100001,42,00101010,75,01001011
34,00100010,126,01111110,160,10100000
0,00000000,78,01001110,78,01001110
47,00101111,38,00100110,85,01010101
0,00000000,9,00001001,9,00001001
123,01111011,113,01110001,236,11101100
9,00001001,42,00101010,51,00110011
0,00000000,120,01111000,120,01111000
62,00111110,55,00110111,117,01110101
2,00000010,76,01001100,78,01001110
30,00011110,44,00101100,74,01001010
78,01001110,29,00011101,107,01101011
3,00000011,36,00100100,39,00100111
44,00101100,84,01010100,128,10000000
104,01101000,75,01001011,179,10110011
119,01110111,12,00001100,131,10000011
83,01010011,127,01111111,210,11010010
74,01001010,28,00011100,102,01100110
66,01000010,28,00011100,94,01011110
90,01011010,62,00111110,152,10011000
125,01111101,13,00001101,138,10001010
7,00000111,96,01100000,103,01100111
97,01100001,124,01111100,221,11011101
68,01000100,50,00110010,118,01110110
113,01110001,2,00000010,115,01110011
65,01000001,113,01110001,178,10110010
58,00111010,51,00110011,109,01101101
40,00101000,127,01111111,167,10100111
65,01000001,95,01011111,160,10100000
16,00010000,87,01010111,103,01100111
127,01111111,92,01011100,219,11011011
29,00011101,42,00101010,71,01000111
9,00001001,89,01011001,98,01100010
107,01101011,116,01110100,223,11011111
104,01101000,121,01111001,225,11100001
71,01000111,100,01100100,171,10101011
114,01110010,38,00100110,152,10011000
79,01001111,17,00010001,96,01100000
41,00101001,63,00111111,104,01101000
18,00010010,11,00001011,29,00011101
127,01111111,90,01011010,217,11011001
44,00101100,53,00110101,97,01100001
85,01010101,105,01101001,190,10111110
97,01100001,101,01100101,198,11000110
22,00010110,111,01101111,133,10000101
23,00010111,107,01101011,130,10000010
18,00010010,69,01000101,87,01010111
121,01111001,2,00000010,123,01111011
51,00110011,117,01110101,168,10101000
116,01110100,46,00101110,162,10100010
89,01011001,83,01010011,172,10101100
101,01100101,73,01001001,174,10101110
24,00011000,34,00100010,58,00111010
48,00110000,63,00111111,111,01101111
87,01010111,84,01010100,171,10101011
97,01100001,81,01010001,178,10110010
118,01110110,82,01010010,200,11001000
66,01000010,69,01000101,135,10000111
83,01010011,55,00110111,138,10001010
85,01010101,49,00110001,134,10000110
118,01110110,96,01100000,214,11010110
77,01001101,54,00110110,131,10000011
107,01101011,72,01001000,179,10110011
44,00101100,127,01111111,171,10101011
88,01011000,110,01101110,198,11000110
15,00001111,6,00000110,21,00010101
53,00110101,10,00001010,63,00111111
90,01011010,119,01110111,209,11010001
103,01100111,80,01010000,183,10110111
68,01000100,92,01011100,160,10100000
9,00001001,117,01110101,126,01111110
110,01101110,56,00111000,166,10100110
52,00110100,88,01011000,140,10001100
23,00010111,43,00101011,66,01000010
11,00001011,68,01000100,79,01001111
116,01110100,28,00011100,144,10010000
98,01100010,22,00010110,120,01111000
95,01011111,39,00100111,134,10000110
82,01010010,88,01011000,170,10101010
124,01111100,44,00101100,168,10101000
36,00100100,64,01000000,100,01100100
106,01101010,124,01111100,230,11100110
12,00001100,75,01001011,87,01010111
110,01101110,106,01101010,216,11011000
120,01111000,56,00111000,176,10110000
124,01111100,100,01100100,224,11100000
105,01101001,40,00101000,145,10010001
75,01001011,99,01100011,174,10101110
101,01100101,115,01110011,216,11011000
8,00001000,13,00001101,21,00010101
108,01101100,34,00100010,142,10001110
31,00011111,45,00101101,76,01001100
66,01000010,29,00011101,95,01011111
112,01110000,70,01000110,182,10110110
121,01111001,64,01000000,185,10111001
125,01111101,125,01111101,250,11111010
113,01110001,63,00111111,176,10110000
83,01010011,24,00011000,107,01101011
123,01111011,32,00100000,155,10011011
34,00100010,123,01111011,157,10011101
59,00111011,124,01111100,183,10110111
54,00110110,43,00101011,97,01100001
87,01010111,77,01001101,164,10100100
38,00100110,43,00101011,81,01010001
116,01110100,120,01111000,236,11101100
33,00100001,17,00010001,50,00110010
1,00000001,37,00100101,38,00100110
61,00111101,80,01010000,141,10001101
86,01010110,121,01111001,207,11001111
50,00110010,96,01100000,146,10010010
91,01011011,14,00001110,105,01101001
74,01001010,22,00010110,96,01100000
12,00001100,60,00111100,72,01001000
110,01101110,74,01001010,184,10111000
35,00100011,101,01100101,136,10001000
90,01011010,81,01010001,171,10101011
39,00100111,127,01111111,166,10100110
37,00100101,97,01100001,134,10000110
21,00010101,81,01010001,102,01100110
53,00110101,104,01101000,157,10011101
115,01110011,81,01010001,196,11000100
12,00001100,102,01100110,114,01110010
79,01001111,7,00000111,86,01010110
33,00100001,127,01111111,160,10100000
28,00011100,5,00000101,33,00100001
37,00100101,99,01100011,136,10001000
47,00101111,62,00111110,109,01101101
105,01101001,25,00011001,130,10000010
17,00010001,10,00001010,27,00011011
26,00011010,29,00011101,55,00110111
17,00010001,106,01101010,123,01111011
67,01000011,5,00000101,72,01001000
85,01010101,65,01000001,150,10010110
51,00110011,110,01101110,161,10100001
111,01101111,39,00100111,150,10010110
95,01011111,120,01111000,215,11010111
102,01100110,49,00110001,151,10010111
20,00010100,7,00000111,27,00011011
88,01011000,104,01101000,192,11000000
99,01100011,67,01000011,166,10100110
55,00110111,78,01001110,133,10000101
27,00011011,19,00010011,46,00101110
101,01100101,69,01000101,170,10101010
29,00011101,62,00111110,91,01011011
95,01011111,48,00110000,143,10001111
104,01101000,67,01000011,171,10101011
60,00111100,34,00100010,94,01011110
29,00011101,48,00110000,77,01001101
40,00101000,51,00110011,91,01011011
85,01010101,1,00000001,86,01010110
113,01110001,52,00110100,165,10100101
75,01001011,97,01100001,172,10101100
97,01100001,77,01001101,174,10101110
38,00100110,102,01100110,140,10001100
108,01101100,5,00000101,113,01110001
7,00000111,26,00011010,33,00100001
75,01001011,113,01110001,188,10111100
84,01010100,119,01110111,203,11001011
101,01100101,3,00000011,104,01101000
88,01011000,120,01111000,208,11010000
42,00101010,87,01010111,129,10000001
11,00001011,58,00111010,69,01000101
28,00011100,98,01100010,126,01111110
62,00111110,57,00111001,119,01110111
100,01100100,29,00011101,129,10000001
104,01101000,59,00111011,163,10100011
41,00101001,34,00100010,75,01001011
0,00000000,39,00100111,39,00100111
89,01011001,124,01111100,213,11010101
34,00100010,52,00110100,86,01010110
105,01101001,70,01000110,175,10101111
3,00000011,68,01000100,71,01000111
123,01111011,38,00100110,161,10100001
10,00001010,14,00001110,24,00011000
95,01011111,113,01110001,208,11010000
36,00100100,72,01001000,108,01101100
110,01101110,31,00011111,141,10001101
96,01100000,57,00111001,153,10011001
86,01010110,14,00001110,100,01100100
29,00011101,15,00001111,44,00101100
114,01110010,21,00010101,135,10000111
42,00101010,29,00011101,71,01000111
0,00000000,98,01100010,98,01100010
51,00110011,81,01010001,132,10000100
78,01001110,113,01110001,191,10111111
60,00111100,20,00010100,80,01010000
39,00100111,1,00000001,40,00101000
93,01011101,103,01100111,196,11000100
31,00011111,27,00011011,58,00111010
74,01001010,63,00111111,137,10001001
70,01000110,64,01000000,134,10000110
42,00101010,27,00011011,69,01000101
102,01100110,18,00010010,120,01111000
50,00110010,38,00100110,88,01011000
31,00011111,50,00110010,81,01010001
112,01110000,53,00110101,165,10100101
52,00110100,93,01011101,145,10010001
65,01000001,43,00101011,108,01101100
42,00101010,36,00100100,78,01001110
82,01010010,25,00011001,107,01101011
117,01110101,62,00111110,179,10110011
64,01000000,41,00101001,105,01101001
91,01011011,118,01110110,209,11010001
58,00111010,89,01011001,147,10010011
103,01100111,34,00100010,137,10001001
2,00000010,120,01111000,122,01111010
25,00011001,32,00100000,57,00111001
59,00111011,85,01010101,144,10010000
125,01111101,5,00000101,130,10000010
41,00101001,97,01100001,138,10001010
66,01000010,120,01111000,186,10111010
80,01010000,5,00000101,85,01010101
41,00101001,123,01111011,164,10100100
4,00000100,19,00010011,23,00010111
64,01000000,56,00111000,120,01111000
87,01010111,72,01001000,159,10011111
14,00001110,122,01111010,136,10001000
62,00111110,54,00110110,116,01110100
36,00100100,81,01010001,117,01110101
57,00111001,121,01111001,178,10110010
21,00010101,74,01001010,95,01011111
101,01100101,2,00000010,103,01100111
28,00011100,116,01110100,144,10010000
109,01101101,31,00011111,140,10001100
33,00100001,121,01111001,154,10011010
71,01000111,97,01100001,168,10101000
68,01000100,8,00001000,76,01001100
80,01010000,83,01010011,163,10100011
41,00101001,90,01011010,131,10000011
118,01110110,68,01000100,186,10111010
45,00101101,60,00111100,105,01101001
28,00011100,10,00001010,38,00100110
25,00011001,121,01111001,146,10010010
86,01010110,81,01010001,167,10100111
113,01110001,83,01010011,196,11000100
43,00101011,123,01111011,166,10100110
51,00110011,20,00010100,71,01000111
89,01011001,31,00011111,120,01111000
64,01000000,65,01000001,129,10000001
116,01110100,67,01000011,183,10110111
40,00101000,9,00001001,49,00110001
56,00111000,91,01011011,147,10010011
112,01110000,100,01100100,212,11010100
80,01010000,29,00011101,109,01101101
5,00000101,10,00001010,15,00001111
55,00110111,10,00001010,65,01000001
1,00000001,19,00010011,20,00010100
33,00100001,121,01111001,154,10011010
40,00101000,64,01000000,104,01101000
47,00101111,26,00011010,73,01001001
116,01110100,52,00110100,168,10101000
25,00011001,51,00110011,76,01001100
89,01011001,71,01000111,160,10100000
51,00110011,28,00011100,79,01001111
16,00010000,32,00100000,48,00110000
0,00000000,23,00010111,23,00010111
88,01011000,54,00110110,142,10001110
49,00110001,119,01110111,168,10101000
64,01000000,89,01011001,153,10011001
15,00001111,48,00110000,63,00111111
32,00100000,59,00111011,91,01011011
27,00011011,44,00101100,71,01000111
54,00110110,23,00010111,77,01001101
35,00100011,77,01001101,112,01110000
48,00110000,4,00000100,52,00110100
57,00111001,122,01111010,179,10110011
57,00111001,90,01011010,147,10010011
77,01001101,120,01111000,197,11000101
23,00010111,45,00101101,68,01000100
91,01011011,71,01000111,162,10100010
34,00100010,110,01101110,144,10010000
60,00111100,63,00111111,123,01111011
116,01110100,98,01100010,214,11010110
86,01010110,63,00111111,149,10010101
12,00001100,110,01101110,122,01111010
80,01010000,94,01011110,174,10101110
9,00001001,35,00100011,44,00101100
28,00011100,15,00001111,43,00101011
58,00111010,59,00111011,117,01110101
32,00100000,61,00111101,93,01011101
77,01001101,6,00000110,83,01010011
32,00100000,66,01000010,98,01100010
89,01011001,38,00100110,127,01111111
4,00000100,126,01111110,130,10000010
86,01010110,121,01111001,207,11001111
96,01100000,93,01011101,189,10111101
32,00100000,42,00101010,74,01001010
24,00011000,85,01010101,109,01101101
0,00000000,73,01001001,73,01001001
22,00010110,96,01100000,118,01110110
102,01100110,27,00011011,129,10000001
106,01101010,123,01111011,229,11100101
71,01000111,118,01110110,189,10111101
26,00011010,122,01111010,148,10010100
60,00111100,4,00000100,64,01000000
78,01001110,55,00110111,133,10000101
56,00111000,111,01101111,167,10100111
21,00010101,55,00110111,76,01001100
98,01100010,115,01110011,213,11010101
93,01011101,111,01101111,204,11001100
43,00101011,53,00110101,96,01100000
32,00100000,93,01011101,125,01111101
123,01111011,35,00100011,158,10011110
79,01001111,37,00100101,116,01110100
54,00110110,86,01010110,140,10001100
36,00100100,36,00100100,72,01001000
27,00011011,77,01001101,104,01101000
127,01111111,122,01111010,249,11111001
3,00000011,38,00100110,41,00101001
114,01110010,32,00100000,146,10010010
94,01011110,76,01001100,170,10101010
35,00100011,73,01001001,108,01101100
50,00110010,46,00101110,96,01100000
94,01011110,116,01110100,210,11010010
89,01011001,119,01110111,208,11010000
62,00111110,13,00001101,75,01001011
3,00000011,32,00100000,35,00100011
46,00101110,76,01001100,122,01111010
111,01101111,55,00110111,166,10100110
104,01101000,124,01111100,228,11100100
124,01111100,59,00111011,183,10110111
49,00110001,33,00100001,82,01010010
42,00101010,34,00100010,76,01001100
91,01011011,94,01011110,185,10111001
29,00011101,31,00011111,60,00111100
76,01001100,40,00101000,116,01110100
97,01100001,7,00000111,104,01101000
41,00101001,116,01110100,157,10011101
24,00011000,32,00100000,56,00111000
9,00001001,103,01100111,112,01110000
33,00100001,49,00110001,82,01010010
107,01101011,96,01100000,203,11001011
68,01000100,108,01101100,176,10110000
90,01011010,71,01000111,161,10100001
114,01110010,51,00110011,165,10100101
70,01000110,21,00010101,91,01011011
45,00101101,27,00011011,72,01001000
8,00001000,61,00111101,69,01000101
124,01111100,94,01011110,218,11011010
3,00000011,68,01000100,71,01000111
12,00001100,5,00000101,17,00010001
53,00110101,22,00010110,75,01001011
117,01110101,110,01101110,227,11100011
34,00100010,59,00111011,93,01011101
33,00100001,124,01111100,157,10011101
55,00110111,54,00110110,109,01101101
101,01100101,33,00100001,134,10000110
121,01111001,74,01001010,195,11000011
5,00000101,123,01111011,128,10000000
95,01011111,52,00110100,147,10010011
118,01110110,98,01100010,216,11011000
50,00110010,97,01100001,147,10010011
106,01101010,59,00111011,165,10100101
27,00011011,4,00000100,31,00011111
97,01100001,96,01100000,193,11000001
11,00001011,49,00110001,60,00111100
103,01100111,121,01111001,224,11100000
107,01101011,101,01100101,208,11010000
127,01111111,107,01101011,234,11101010
11,00001011,36,00100100,47,00101111
64,01000000,103,01100111,167,10100111
68,01000100,1,00000001,69,01000101
45,00101101,125,01111101,170,10101010
24,00011000,37,00100101,61,00111101
88,01011000,47,00101111,135,10000111
21,00010101,56,00111000,77,01001101
118,01110110,50,00110010,168,10101000
0,00000000,24,00011000,24,00011000
96,01100000,85,01010101,181,10110101
30,00011110,82,01010010,112,01110000
59,00111011,111,01101111,170,10101010
60,00111100,17,00010001,77,01001101
64,01000000,18,00010010,82,01010010
116,01110100,58,00111010,174,10101110
77,01001101,74,01001010,151,10010111
71,01000111,81,01010001,152,10011000
8,00001000,42,00101010,50,00110010
91,01011011,74,01001010,165,10100101
62,00111110,48,00110000,110,01101110
40,00101000,29,00011101,69,01000101
107,01101011,26,00011010,133,10000101
126,01111110,89,01011001,215,11010111
112,01110000,54,00110110,166,10100110
75,01001011,37,00100101,112,01110000
26,00011010,36,00100100,62,00111110
16,00010000,109,01101101,125,01111101
72,01001000,5,00000101,77,01001101
76,01001100,5,00000101,81,01010001
37,00100101,3,00000011,40,00101000
122,01111010,15,00001111,137,10001001
55,00110111,99,01100011,154,10011010
106,01101010,77,01001101,183,10110111
28,00011100,87,01010111,115,01110011
53,00110101,102,01100110,155,10011011
121,01111001,102,01100110,223,11011111
108,01101100,24,00011000,132,10000100
55,00110111,109,01101101,164,10100100
45,00101101,61,00111101,106,01101010
66,01000010,41,00101001,107,01101011
50,00110010,26,00011010,76,01001100
75,01001011,42,00101010,117,01110101
1,00000001,101,01100101,102,01100110
89,01011001,92,01011100,181,10110101
63,00111111,44,00101100,107,01101011
56,00111000,93,01011101,149,10010101
37,00100101,104,01101000,141,10001101
95,01011111,101,01100101,196,11000100
53,00110101,84,01010100,137,10001001
63,00111111,71,01000111,134,10000110
5,00000101,67,01000011,72,01001000
16,00010000,20,00010100,36,00100100
67,01000011,98,01100010,165,10100101
122,01111010,29,00011101,151,10010111
123,01111011,90,01011010,213,11010101
75,01001011,47,00101111,122,01111010
123,01111011,19,00010011,142,10001110
103,01100111,43,00101011,146,10010010
123,01111011,40,00101000,163,10100011
32,00100000,63,00111111,95,01011111
117,01110101,9,00001001,126,01111110
52,00110100,49,00110001,101,01100101
68,01000100,74,01001010,142,10001110
84,01010100,61,00111101,145,10010001
83,01010011,107,01101011,190,10111110
72,01001000,62,00111110,134,10000110
29,00011101,111,01101111,140,10001100
51,00110011,67,01000011,118,01110110
52,00110100,8,00001000,60,00111100
115,01110011,39,00100111,154,10011010
59,00111011,125,01111101,184,10111000
66,01000010,59,00111011,125,01111101
101,01100101,24,00011000,125,01111101
100,01100100,29,00011101,129,10000001
94,01011110,80,01010000,174,10101110
9,00001001,7,00000111,16,00010000
57,00111001,113,01110001,170,10101010
1,00000001,95,01011111,96,01100000
10,00001010,9,00001001,19,00010011
40,00101000,31,00011111,71,01000111
87,01010111,6,00000110,93,01011101
123,01111011,92,01011100,215,11010111
121,01111001,1,00000001,122,01111010
15,00001111,94,01011110,109,01101101
11,00001011,116,01110100,127,01111111
60,00111100,95,01011111,155,10011011
46,00101110,53,00110101,99,01100011
104,01101000,81,01010001,185,10111001
66,01000010,15,00001111,81,01010001
48,00110000,105,01101001,153,10011001
81,01010001,114,01110010,195,11000011
43,00101011,125,01111101,168,10101000
52,00110100,14,00001110,66,01000010
40,00101000,59,00111011,99,01100011
100,01100100,86,01010110,186,10111010
61,00111101,25,00011001,86,01010110
70,01000110,54,00110110,124,01111100
111,01101111,55,00110111,166,10100110
113,01110001,20,00010100,133,10000101
92,01011100,108,01101100,200,11001000
6,00000110,5,00000101,11,00001011
26,00011010,42,00101010,68,01000100
109,01101101,58,00111010,167,10100111
113,01110001,114,01110010,227,11100011
16,00010000,87,01010111,103,01100111
27,00011011,121,01111001,148,10010100
25,00011001,37,00100101,62,00111110
89,01011001,58,00111010,147,10010011
114,01110010,118,01110110,232,11101000
103,01100111,64,01000000,167,10100111
82,01010010,89,01011001,171,10101011
98,01100010,79,01001111,177,10110001
12,00001100,9,00001001,21,00010101
71,01000111,90,01011010,161,10100001
25,00011001,2,00000010,27,00011011
108,01101100,115,01110011,223,11011111
125,01111101,56,00111000,181,10110101
99,01100011,40,00101000,139,10001011
71,01000111,31,00011111,102,01100110
82,01010010,75,01001011,157,10011101
123,01111011,127,01111111,250,11111010
44,00101100,127,01111111,171,10101011
44,00101100,76,01001100,120,01111000
43,00101011,111,01101111,154,10011010
108,01101100,122,01111010,230,11100110
50,00110010,70,01000110,120,01111000
46,00101110,110,01101110,156,10011100
79,01001111,95,01011111,174,10101110
72,01001000,25,00011001,97,01100001
111,01101111,116,01110100,227,11100011
124,01111100,39,00100111,163,10100011
46,00101110,19,00010011,65,01000001
69,01000101,74,01001010,143,10001111
92,01011100,70,01000110,162,10100010
92,01011100,121,01111001,213,11010101
42,00101010,67,01000011,109,01101101
58,00111010,87,01010111,145,10010001
66,01000010,75,01001011,141,10001101
34,00100010,53,00110101,87,01010111
71,01000111,37,00100101,108,01101100
60,00111100,104,01101000,164,10100100
101,01100101,56,00111000,157,10011101
78,01001110,68,01000100,146,10010010
56,00111000,39,00100111,95,01011111
120,01111000,124,01111100,244,11110100
79,01001111,62,00111110,141,10001101
45,00101101,27,00011011,72,01001000
12,00001100,104,01101000,116,01110100
74,01001010,36,00100100,110,01101110
123,01111011,66,01000010,189,10111101
7,00000111,101,01100101,108,01101100
46,00101110,33,00100001,79,01001111
37,00100101,105,01101001,142,10001110
23,00010111,81,01010001,104,01101000
24,00011000,57,00111001,81,01010001
57,00111001,52,00110100,109,01101101
49,00110001,76,01001100,125,01111101
102,01100110,85,01010101,187,10111011
93,01011101,29,00011101,122,01111010
57,00111001,100,01100100,157,10011101
44,00101100,42,00101010,86,01010110
78,01001110,98,01100010,176,10110000
126,01111110,69,01000101,195,11000011
10,00001010,27,00011011,37,00100101
93,01011101,15,00001111,108,01101100
91,01011011,24,00011000,115,01110011
47,00101111,93,01011101,140,10001100
53,00110101,108,01101100,161,10100001
13,00001101,90,01011010,103,01100111
47,00101111,49,00110001,96,01100000
29,00011101,124,01111100,153,10011001
9,00001001,121,01111001,130,10000010
83,01010011,43,00101011,126,01111110
70,01000110,50,00110010,120,01111000
33,00100001,51,00110011,84,01010100
26,00011010,86,01010110,112,01110000
53,00110101,45,00101101,98,01100010
108,01101100,88,01011000,196,11000100
91,01011011,81,01010001,172,10101100
12,00001100,12,00001100,24,00011000
108,01101100,33,00100001,141,10001101
77,01001101,27,00011011,104,01101000
12,00001100,97,01100001,109,01101101
68,01000100,103,01100111,171,10101011
73,01001001,99,01100011,172,10101100
5,00000101,114,01110010,119,01110111
84,01010100,98,01100010,182,10110110
15,00001111,127,01111111,142,10001110
19,00010011,61,00111101,80,01010000
30,00011110,68,01000100,98,01100010
5,00000101,65,01000001,70,01000110
38,00100110,85,01010101,123,01111011
74,01001010,78,01001110,152,10011000
51,00110011,76,01001100,127,01111111
32,00100000,124,01111100,156,10011100
45,00101101,13,00001101,58,00111010
102,01100110,65,01000001,167,10100111
118,01110110,9,00001001,127,01111111
50,00110010,105,01101001,155,10011011
29,00011101,95,01011111,124,01111100
72,01001000,47,00101111,119,01110111
15,00001111,38,00100110,53,00110101
4,00000100,45,00101101,49,00110001
78,01001110,3,00000011,81,01010001
87,01010111,60,00111100,147,10010011
88,01011000,100,01100100,188,10111100
23,00010111,41,00101001,64,01000000
12,00001100,19,00010011,31,00011111
4,00000100,50,00110010,54,00110110
116,01110100,83,01010011,199,11000111
17,00010001,102,01100110,119,01110111
48,00110000,66,01000010,114,01110010
114,01110010,43,00101011,157,10011101
94,01011110,93,01011101,187,10111011
104,01101000,23,00010111,127,01111111
56,00111000,62,00111110,118,01110110
118,01110110,68,01000100,186,10111010
83,01010011,119,01110111,202,11001010
23,00010111,16,00010000,39,00100111
71,01000111,20,00010100,91,01011011
77,01001101,118,01110110,195,11000011
113,01110001,101,01100101,214,11010110
31,00011111,35,00100011,66,01000010
59,00111011,103,01100111,162,10100010
67,01000011,120,01111000,187,10111011
84,01010100,24,00011000,108,01101100
108,01101100,64,01000000,172,10101100
46,00101110,12,00001100,58,00111010
15,00001111,92,01011100,107,01101011
38,00100110,125,01111101,163,10100011
92,01011100,11,00001011,103,01100111
30,00011110,83,01010011,113,01110001
60,00111100,98,01100010,158,10011110
104,01101000,91,01011011,195,11000011
98,01100010,56,00111000,154,10011010
92,01011100,107,01101011,199,11000111
38,00100110,92,01011100,130,10000010
97,01100001,73,01001001,170,10101010
100,01100100,47,00101111,147,10010011
51,00110011,6,00000110,57,00111001
8,00001000,15,00001111,23,00010111
119,01110111,20,00010100,139,10001011
77,01001101,1,00000001,78,01001110
118,01110110,49,00110001,167,10100111
89,01011001,97,01100001,186,10111010
46,00101110,48,00110000,94,01011110
81,01010001,75,01001011,156,10011100
49,00110001,82,01010010,131,10000011
99,01100011,101,01100101,200,11001000
15,00001111,45,00101101,60,00111100
7,00000111,72,01001000,79,01001111
67,01000011,35,00100011,102,01100110
118,01110110,110,01101110,228,11100100
101,01100101,61,00111101,162,10100010
48,00110000,112,01110000,160,10100000
44,00101100,115,01110011,159,10011111
67,01000011,71,01000111,138,10001010
106,01101010,6,00000110,112,01110000
2,00000010,55,00110111,57,00111001
0,00000000,3,00000011,3,00000011
63,00111111,64,01000000,127,01111111
109,01101101,105,01101001,214,11010110
59,00111011,57,00111001,116,01110100
37,00100101,100,01100100,137,10001001
11,00001011,105,01101001,116,01110100
9,00001001,46,00101110,55,00110111
117,01110101,0,00000000,117,01110101
1,00000001,11,00001011,12,00001100
102,01100110,111,01101111,213,11010101
35,00100011,6,00000110,41,00101001
59,00111011,120,01111000,179,10110011
101,01100101,88,01011000,189,10111101
66,01000010,57,00111001,123,01111011
26,00011010,113,01110001,139,10001011
87,01010111,90,01011010,177,10110001
5,00000101,24,00011000,29,00011101
119,01110111,106,01101010,225,11100001
94,01011110,43,00101011,137,10001001
8,00001000,120,01111000,128,10000000
102,01100110,119,01110111,221,11011101
61,00111101,28,00011100,89,01011001
77,01001101,99,01100011,176,10110000
113,01110001,92,01011100,205,11001101
106,01101010,40,00101000,146,10010010
37,00100101,85,01010101,122,01111010
11,00001011,39,00100111,50,00110010
48,00110000,89,01011001,137,10001001
109,01101101,27,00011011,136,10001000
84,01010100,90,01011010,174,10101110
96,01100000,58,00111010,154,10011010
92,01011100,118,01110110,210,11010010
63,00111111,23,00010111,86,01010110
31,00011111,69,01000101,100,01100100
59,00111011,26,00011010,85,01010101
79,01001111,99,01100011,178,10110010
46,00101110,93,01011101,139,10001011
78,01001110,59,00111011,137,10001001
7,00000111,54,00110110,61,00111101
30,00011110,8,00001000,38,00100110
105,01101001,55,00110111,160,10100000
20,00010100,38,00100110,58,00111010
102,01100110,56,00111000,158,10011110
42,00101010,83,01010011,125,01111101
89,01011001,101,01100101,190,10111110
106,01101010,120,01111000,226,11100010
77,01001101,51,00110011,128,10000000
51,00110011,47,00101111,98,01100010
40,00101000,54,00110110,94,01011110
20,00010100,52,00110100,72,01001000
116,01110100,18,00010010,134,10000110
125,01111101,61,00111101,186,10111010
13,00001101,119,01110111,132,10000100
8,00001000,41,00101001,49,00110001
121,01111001,67,01000011,188,10111100
63,00111111,22,00010110,85,01010101
85,01010101,83,01010011,168,10101000
18,00010010,82,01010010,100,01100100
86,01010110,30,00011110,116,01110100
51,00110011,125,01111101,176,10110000
123,01111011,109,01101101,232,11101000
124,01111100,82,01010010,206,11001110
43,00101011,83,01010011,126,01111110
118,01110110,25,00011001,143,10001111
69,01000101,27,00011011,96,01100000
40,00101000,62,00111110,102,01100110
117,01110101,67,01000011,184,10111000
112,01110000,107,01101011,219,11011011
72,01001000,48,00110000,120,01111000
13,00001101,30,00011110,43,00101011
62,00111110,116,01110100,178,10110010
28,00011100,112,01110000,140,10001100
21,00010101,124,01111100,145,10010001
119,01110111,60,00111100,179,10110011
72,01001000,63,00111111,135,10000111
10,00001010,126,01111110,136,10001000
24,00011000,33,00100001,57,00111001
101,01100101,68,01000100,169,10101001
46,00101110,86,01010110,132,10000100
21,00010101,36,00100100,57,00111001
42,00101010,110,01101110,152,10011000
70,01000110,71,01000111,141,10001101
54,00110110,74,01001010,128,10000000
40,00101000,97,01100001,137,10001001
27,00011011,10,00001010,37,00100101
121,01111001,113,01110001,234,11101010
126,01111110,32,00100000,158,10011110
85,01010101,89,01011001,174,10101110
5,00000101,69,01000101,74,01001010
82,01010010,77,01001101,159,10011111
98,01100010,111,01101111,209,11010001
46,00101110,100,01100100,146,10010010
0,00000000,23,00010111,23,00010111
71,01000111,56,00111000,127,01111111
64,01000000,124,01111100,188,10111100
16,00010000,45,00101101,61,00111101
99,01100011,106,01101010,205,11001101
114,01110010,65,01000001,179,10110011
16,00010000,8,00001000,24,00011000
105,01101001,124,01111100,229,11100101
25,00011001,105,01101001,130,10000010
5,00000101,5,00000101,10,00001010
114,01110010,80,01010000,194,11000010
35,00100011,59,00111011,94,01011110
76,01001100,36,00100100,112,01110000
104,01101000,103,01100111,207,11001111
61,00111101,73,01001001,134,10000110
122,01111010,66,01000010,188,10111100
29,00011101,13,00001101,42,00101010
24,00011000,124,01111100,148,10010100
115,01110011,68,01000100,183,10110111
61,00111101,127,01111111,188,10111100
82,01010010,7,00000111,89,01011001
52,00110100,61,00111101,113,01110001
87,01010111,37,00100101,124,01111100
19,00010011,105,01101001,124,01111100
0,00000000,6,00000110,6,00000110
28,00011100,55,00110111,83,01010011
124,01111100,41,00101001,165,10100101
104,01101000,127,01111111,231,11100111
93,01011101,31,00011111,124,01111100
47,00101111,77,01001101,124,01111100
126,01111110,88,01011000,214,11010110
120,01111000,81,01010001,201,11001001
9,00001001,21,00010101,30,00011110
76,01001100,95,01011111,171,10101011
116,01110100,66,01000010,182,10110110
43,00101011,17,00010001,60,00111100
96,01100000,85,01010101,181,10110101
92,01011100,115,01110011,207,11001111
106,01101010,56,00111000,162,10100010
3,00000011,92,01011100,95,01011111
17,00010001,0,00000000,17,00010001
7,00000111,30,00011110,37,00100101
110,01101110,105,01101001,215,11010111
84,01010100,101,01100101,185,10111001
72,01001000,112,01110000,184,10111000
44,00101100,83,01010011,127,01111111
86,01010110,7,00000111,93,01011101
73,01001001,44,00101100,117,01110101
19,00010011,67,01000011,86,01010110
22,00010110,96,01100000,118,01110110
49,00110001,1,00000001,50,00110010
37,00100101,17,00010001,54,00110110
55,00110111,76,01001100,131,10000011
49,00110001,10,00001010,59,00111011
56,00111000,19,00010011,75,01001011
1,00000001,51,00110011,52,00110100
44,00101100,12,00001100,56,00111000
79,01001111,114,01110010,193,11000001
22,00010110,58,00111010,80,01010000
109,01101101,50,00110010,159,10011111
91,01011011,52,00110100,143,10001111
12,00001100,25,00011001,37,00100101
101,01100101,3,00000011,104,01101000
0,00000000,125,01111101,125,01111101
84,01010100,24,00011000,108,01101100
120,01111000,114,01110010,234,11101010
55,00110111,13,00001101,68,01000100
50,00110010,51,00110011,101,01100101
26,00011010,102,01100110,128,10000000
126,01111110,64,01000000,190,10111110
118,01110110,90,01011010,208,11010000
96,01100000,0,00000000,96,01100000
4,00000100,36,00100100,40,00101000
61,00111101,97,01100001,158,10011110
102,01100110,4,00000100,106,01101010
51,00110011,17,00010001,68,01000100
96,01100000,74,01001010,170,10101010
35,00100011,51,00110011,86,01010110
127,01111111,61,00111101,188,10111100
59,00111011,37,00100101,96,01100000
52,00110100,36,00100100,88,01011000
86,01010110,21,00010101,107,01101011
88,01011000,44,00101100,132,10000100
48,00110000,125,01111101,173,10101101
76,01001100,98,01100010,174,10101110
51,00110011,124,01111100,175,10101111
60,00111100,45,00101101,105,01101001
107,01101011,51,00110011,158,10011110
102,01100110,65,01000001,167,10100111
52,00110100,80,01010000,132,10000100
32,00100000,82,01010010,114,01110010
31,00011111,104,01101000,135,10000111
53,00110101,90,01011010,143,10001111
55,00110111,14,00001110,69,01000101
119,01110111,92,01011100,211,11010011
50,00110010,32,00100000,82,01010010
67,01000011,107,01101011,174,10101110
50,00110010,4,00000100,54,00110110
119,01110111,64,01000000,183,10110111
54,00110110,82,01010010,136,10001000
70,01000110,123,01111011,193,11000001
122,01111010,98,01100010,220,11011100
75,01001011,91,01011011,166,10100110
15,00001111,1,00000001,16,00010000
100,01100100,119,01110111,219,11011011
97,01100001,41,00101001,138,10001010
17,00010001,117,01110101,134,10000110
68,01000100,72,01001000,140,10001100
19,00010011,67,01000011,86,01010110
80,01010000,35,00100011,115,01110011
8,00001000,10,00001010,18,00010010
34,00100010,34,00100010,68,01000100
50,00110010,94,01011110,144,10010000
94,01011110,22,00010110,116,01110100
65,01000001,9,00001001,74,01001010
42,00101010,17,00010001,59,00111011
65,01000001,120,01111000,185,10111001
86,01010110,109,01101101,195,11000011
8,00001000,20,00010100,28,00011100
62,00111110,13,00001101,75,01001011
32,00100000,99,01100011,131,10000011
41,00101001,77,01001101,118,01110110
114,01110010,39,00100111,153,10011001
47,00101111,75,01001011,122,01111010
22,00010110,45,00101101,67,01000011
111,01101111,41,00101001,152,10011000
56,00111000,57,00111001,113,01110001
48,00110000,97,01100001,145,10010001
79,01001111,13,00001101,92,01011100
16,00010000,99,01100011,115,01110011
111,01101111,59,00111011,170,10101010
118,01110110,121,01111001,239,11101111
11,00001011,94,01011110,105,01101001
21,00010101,100,01100100,121,01111001
103,01100111,77,01001101,180,10110100
6,00000110,27,00011011,33,00100001
18,00010010,45,00101101,63,00111111
81,01010001,61,00111101,142,10001110
31,00011111,90,01011010,121,01111001
21,00010101,95,01011111,116,01110100
72,01001000,43,00101011,115,01110011
5,00000101,69,01000101,74,01001010
16,00010000,0,00000000,16,00010000
87,01010111,65,01000001,152,10011000
56,00111000,37,00100101,93,01011101
54,00110110,71,01000111,125,01111101
61,00111101,75,01001011,136,10001000
99,01100011,109,01101101,208,11010000
36,00100100,93,01011101,129,10000001
83,01010011,41,00101001,124,01111100
58,00111010,75,01001011,133,10000101
7,00000111,14,00001110,21,00010101
27,00011011,50,00110010,77,01001101
101,01100101,69,01000101,170,10101010
8,00001000,52,00110100,60,00111100
68,01000100,46,00101110,114,01110010
80,01010000,77,01001101,157,10011101
86,01010110,57,00111001,143,10001111
42,00101010,82,01010010,124,01111100
17,00010001,125,01111101,142,10001110
105,01101001,3,00000011,108,01101100
85,01010101,120,01111000,205,11001101
79,01001111,44,00101100,123,01111011
60,00111100,77,01001101,137,10001001
19,00010011,89,01011001,108,01101100
4,00000100,7,00000111,11,00001011
103,01100111,85,01010101,188,10111100
18,00010010,117,01110101,135,10000111
63,00111111,99,01100011,162,10100010
95,01011111,116,01110100,211,11010011
25,00011001,32,00100000,57,00111001
81,01010001,77,01001101,158,10011110
125,01111101,119,01110111,244,11110100
119,01110111,115,01110011,234,11101010
27,00011011,117,01110101,144,10010000
80,01010000,92,01011100,172,10101100
46,00101110,127,01111111,173,10101101
18,00010010,98,01100010,116,01110100
55,00110111,64,01000000,119,01110111
27,00011011,27,00011011,54,00110110
27,00011011,32,00100000,59,00111011
42,00101010,18,00010010,60,00111100
84,01010100,113,01110001,197,11000101
10,00001010,123,01111011,133,10000101
51,00110011,72,01001000,123,01111011
44,00101100,79,01001111,123,01111011
34,00100010,107,01101011,141,10001101
120,01111000,66,01000010,186,10111010
33,00100001,70,01000110,103,01100111
31,00011111,37,00100101,68,01000100
1,00000001,12,00001100,13,00001101
92,01011100,120,01111000,212,11010100
116,01110100,93,01011101,209,11010001
115,01110011,37,00100101,152,10011000
124,01111100,110,01101110,234,11101010
53,00110101,16,00010000,69,01000101
56,00111000,127,01111111,183,10110111
67,01000011,84,01010100,151,10010111
58,00111010,114,01110010,172,10101100
73,01001001,61,00111101,134,10000110
5,00000101,87,01010111,92,01011100
99,01100011,125,01111101,224,11100000
79,01001111,99,01100011,178,10110010
126,01111110,127,01111111,253,11111101
88,01011000,17,00010001,105,01101001
14,00001110,91,01011011,105,01101001
122,01111010,88,01011000,210,11010010
109,01101101,76,01001100,185,10111001
118,01110110,18,00010010,136,10001000
31,00011111,126,01111110,157,10011101
113,01110001,44,00101100,157,10011101
115,01110011,56,00111000,171,10101011
119,01110111,22,00010110,141,10001101
96,01100000,63,00111111,159,10011111
14,00001110,124,01111100,138,10001010
113,01110001,113,01110001,226,11100010
115,01110011,25,00011001,140,10001100
36,00100100,105,01101001,141,10001101
61,00111101,64,01000000,125,01111101
113,01110001,24,00011000,137,10001001
37,00100101,16,00010000,53,00110101
47,00101111,14,00001110,61,00111101
105,01101001,97,01100001,202,11001010
54,00110110,124,01111100,178,10110010
97,01100001,68,01000100,165,10100101
82,01010010,41,00101001,123,01111011
32,00100000,67,01000011,99,01100011
115,01110011,116,01110100,231,11100111
1,00000001,108,01101100,109,01101101
109,01101101,90,01011010,199,11000111
56,00111000,21,00010101,77,01001101
123,01111011,19,00010011,142,10001110
90,01011010,7,00000111,97,01100001
81,01010001,11,00001011,92,01011100
106,01101010,110,01101110,216,11011000
1,00000001,47,00101111,48,00110000
47,00101111,11,00001011,58,00111010
121,01111001,58,00111010,179,10110011
15,00001111,99,01100011,114,01110010
90,01011010,127,01111111,217,11011001
85,01010101,35,00100011,120,01111000
94,01011110,9,00001001,103,01100111
111,01101111,116,01110100,227,11100011
66,01000010,120,01111000,186,10111010
125,01111101,106,01101010,231,11100111
64,01000000,126,01111110,190,10111110
119,01110111,10,00001010,129,10000001
13,00001101,13,00001101,26,00011010
20,00010100,40,00101000,60,00111100
32,00100000,79,01001111,111,01101111
110,01101110,33,00100001,143,10001111
25,00011001,117,01110101,142,10001110
109,01101101,127,01111111,236,11101100
121,01111001,70,01000110,191,10111111
33,00100001,102,01100110,135,10000111
56,00111000,27,00011011,83,01010011
113,01110001,79,01001111,192,11000000
48,00110000,107,01101011,155,10011011
45,00101101,66,01000010,111,01101111
27,00011011,56,00111000,83,01010011
103,01100111,97,01100001,200,11001000
72,01001000,9,00001001,81,01010001
35,00100011,91,01011011,126,01111110
50,00110010,18,00010010,68,01000100
66,01000010,9,00001001,75,01001011
75,01001011,97,01100001,172,10101100
41,00101001,34,00100010,75,01001011
77,01001101,37,00100101,114,01110010
78,01001110,67,01000011,145,10010001
8,00001000,68,01000100,76,01001100
32,00100000,123,01111011,155,10011011
38,00100110,99,01100011,137,10001001
10,00001010,19,00010011,29,00011101
94,01011110,31,00011111,125,01111101
69,01000101,16,00010000,85,01010101
127,01111111,76,01001100,203,11001011
101,01100101,87,01010111,188,10111100
118,01110110,100,01100100,218,11011010
44,00101100,20,00010100,64,01000000
47,00101111,73,01001001,120,01111000
30,00011110,43,00101011,73,01001001
46,00101110,70,01000110,116,01110100
115,01110011,71,01000111,186,10111010
59,00111011,113,01110001,172,10101100
97,01100001,111,01101111,208,11010000
60,00111100,52,00110100,112,01110000
42,00101010,116,01110100,158,10011110
33,00100001,68,01000100,101,01100101
58,00111010,67,01000011,125,01111101
20,00010100,127,01111111,147,10010011
124,01111100,103,01100111,227,11100011
122,01111010,124,01111100,246,11110110
13,00001101,121,01111001,134,10000110
63,00111111,107,01101011,170,10101010
37,00100101,59,00111011,96,01100000
14,00001110,35,00100011,49,00110001
56,00111000,23,00010111,79,01001111
58,00111010,66,01000010,124,01111100
100,01100100,47,00101111,147,10010011
37,00100101,81,01010001,118,01110110
81,01010001,25,00011001,106,01101010
82,01010010,86,01010110,168,10101000
73,01001001,50,00110010,123,01111011
125,01111101,44,00101100,169,10101001
58,00111010,104,01101000,162,10100010
16,00010000,25,00011001,41,00101001
5,00000101,99,01100011,104,01101000
124,01111100,112,01110000,236,11101100
71,01000111,101,01100101,172,10101100
92,01011100,127,01111111,219,11011011
66,01000010,6,00000110,72,01001000
126,01111110,22,00010110,148,10010100
104,01101000,112,01110000,216,11011000
0,00000000,33,00100001,33,00100001
72,01001000,112,01110000,184,10111000
113,01110001,73,01001001,186,10111010
38,00100110,33,00100001,71,01000111
113,01110001,31,00011111,144,10010000
112,01110000,77,01001101,189,10111101
102,01100110,80,01010000,182,10110110
118,01110110,116,01110100,234,11101010
81,01010001,65,01000001,146,10010010
72,01001000,83,01010011,155,10011011
55,00110111,115,01110011,170,10101010
15,00001111,126,01111110,141,10001101
96,01100000,43,00101011,139,10001011
12,00001100,77,01001101,89,01011001
109,01101101,89,01011001,198,11000110
42,00101010,124,01111100,166,10100110
115,01110011,125,01111101,240,11110000
4,00000100,69,01000101,73,01001001
96,01100000,77,01001101,173,10101101
64,01000000,121,01111001,185,10111001
32,00100000,32,00100000,64,01000000
23,00010111,67,01000011,90,01011010
12,00001100,10,00001010,22,00010110
94,01011110,56,00111000,150,10010110
21,00010101,42,00101010,63,00111111
117,01110101,125,01111101,242,11110010
67,01000011,27,00011011,94,01011110
33,00100001,91,01011011,124,01111100
37,00100101,107,01101011,144,10010000
3,00000011,100,01100100,103,01100111
25,00011001,98,01100010,123,01111011
56,00111000,64,01000000,120,01111000
76,01001100,12,00001100,88,01011000
107,01101011,13,00001101,120,01111000
3,00000011,77,01001101,80,01010000
72,01001000,17,00010001,89,01011001
31,00011111,32,00100000,63,00111111
104,01101000,81,01010001,185,10111001
114,01110010,6,00000110,120,01111000
113,01110001,66,01000010,179,10110011
34,00100010,76,01001100,110,01101110
81,01010001,23,00010111,104,01101000
40,00101000,114,01110010,154,10011010
79,01001111,34,00100010,113,01110001
35,00100011,92,01011100,127,01111111
30,00011110,37,00100101,67,01000011
41,00101001,103,01100111,144,10010000
125,01111101,50,00110010,175,10101111
88,01011000,69,01000101,157,10011101
33,00100001,88,01011000,121,01111001
87,01010111,105,01101001,192,11000000
94,01011110,105,01101001,199,11000111
49,00110001,91,01011011,140,10001100
27,00011011,125,01111101,152,10011000
97,01100001,92,01011100,189,10111101
42,00101010,103,01100111,145,10010001
54,00110110,82,01010010,136,10001000
115,01110011,24,00011000,139,10001011
108,01101100,75,01001011,183,10110111
78,01001110,58,00111010,136,10001000
116,01110100,69,01000101,185,10111001
114,01110010,115,01110011,229,11100101
100,01100100,65,01000001,165,10100101
17,00010001,61,00111101,78,01001110
81,01010001,105,01101001,186,10111010
58,00111010,4,00000100,62,00111110
96,01100000,55,00110111,151,10010111
59,00111011,108,01101100,167,10100111
81,01010001,35,00100011,116,01110100
68,01000100,33,00100001,101,01100101
7,00000111,12,00001100,19,00010011
109,01101101,16,00010000,125,01111101
107,01101011,114,01110010,221,11011101
101,01100101,82,01010010,183,10110111
25,00011001,87,01010111,112,01110000
103,01100111,19,00010011,122,01111010
86,01010110,48,00110000,134,10000110
111,01101111,92,01011100,203,11001011
110,01101110,80,01010000,190,10111110
118,01110110,28,00011100,146,10010010
91,01011011,96,01100000,187,10111011
126,01111110,100,01100100,226,11100010
39,00100111,83,01010011,122,01111010
65,01000001,121,01111001,186,10111010
93,01011101,39,00100111,132,10000100
12,00001100,33,00100001,45,00101101
121,01111001,9,00001001,130,10000010
99,01100011,120,01111000,219,11011011
39,00100111,69,01000101,108,01101100
13,00001101,75,01001011,88,01011000
89,01011001,107,01101011,196,11000100
53,00110101,33,00100001,86,01010110
50,00110010,28,00011100,78,01001110
110,01101110,26,00011010,136,10001000
79,01001111,2,00000010,81,01010001
109,01101101,90,01011010,199,11000111
47,00101111,70,01000110,117,01110101
21,00010101,9,00001001,30,00011110
80,01010000,37,00100101,117,01110101
117,01110101,23,00010111,140,10001100
109,01101101,90,01011010,199,11000111
6,00000110,66,01000010,72,01001000
29,00011101,37,00100101,66,01000010
39,00100111,25,00011001,64,01000000
107,01101011,48,00110000,155,10011011
18,00010010,58,00111010,76,01001100
80,01010000,50,00110010,130,10000010
46,00101110,81,01010001,127,01111111
109,01101101,126,01111110,235,11101011
123,01111011,16,00010000,139,10001011
24,00011000,44,00101100,68,01000100
12,00001100,41,00101001,53,00110101
84,01010100,58,00111010,142,10001110
27,00011011,16,00010000,43,00101011
36,00100100,95,01011111,131,10000011
124,01111100,12,00001100,136,10001000
5,00000101,13,00001101,18,00010010
45,00101101,105,01101001,150,10010110
114,01110010,98,01100010,212,11010100
79,01001111,113,01110001,192,11000000
37,00100101,35,00100011,72,01001000
96,01100000,104,01101000,200,11001000
127,01111111,9,00001001,136,10001000
111,01101111,125,01111101,236,11101100
40,00101000,14,00001110,54,00110110
3,00000011,17,00010001,20,00010100
43,00101011,70,01000110,113,01110001
87,01010111,26,00011010,113,01110001
44,00101100,28,00011100,72,01001000
101,01100101,124,01111100,225,11100001
10,00001010,50,00110010,60,00111100
125,01111101,18,00010010,143,10001111
108,01101100,83,01010011,191,10111111
93,01011101,3,00000011,96,01100000
4,00000100,47,00101111,51,00110011
46,00101110,79,01001111,125,01111101
80,01010000,75,01001011,155,10011011
45,00101101,107,01101011,152,10011000
11,00001011,127,01111111,138,10001010
127,01111111,28,00011100,155,10011011
2,00000010,37,00100101,39,00100111
71,01000111,70,01000110,141,10001101
108,01101100,15,00001111,123,01111011
91,01011011,93,01011101,184,10111000
99,01100011,5,00000101,104,01101000
4,00000100,44,00101100,48,00110000
102,01100110,82,01010010,184,10111000
121,01111001,93,01011101,214,11010110
14,00001110,40,00101000,54,00110110
90,01011010,103,01100111,193,11000001
34,00100010,24,00011000,58,00111010
11,00001011,38,00100110,49,00110001
52,00110100,25,00011001,77,01001101
52,00110100,46,00101110,98,01100010
56,00111000,105,01101001,161,10100001
46,00101110,62,00111110,108,01101100
122,01111010,62,00111110,184,10111000
86,01010110,40,00101000,126,01111110
83,01010011,121,01111001,204,11001100
124,01111100,79,01001111,203,11001011
6,00000110,0,00000000,6,00000110
122,01111010,103,01100111,225,11100001
97,01100001,12,00001100,109,01101101
97,01100001,27,00011011,124,01111100
28,00011100,70,01000110,98,01100010
110,01101110,12,00001100,122,01111010
119,01110111,63,00111111,182,10110110
32,00100000,113,01110001,145,10010001
65,01000001,102,01100110,167,10100111
59,00111011,17,00010001,76,01001100
85,01010101,114,01110010,199,11000111
15,00001111,118,01110110,133,10000101
36,00100100,115,01110011,151,10010111
91,01011011,21,00010101,112,01110000
52,00110100,109,01101101,161,10100001
63,00111111,38,00100110,101,01100101
98,01100010,102,01100110,200,11001000
85,01010101,47,00101111,132,10000100
59,00111011,71,01000111,130,10000010
38,00100110,111,01101111,149,10010101
86,01010110,76,01001100,162,10100010
16,00010000,9,00001001,25,00011001
106,01101010,25,00011001,131,10000011
93,01011101,88,01011000,181,10110101
31,00011111,4,00000100,35,00100011
8,00001000,57,00111001,65,01000001
114,01110010,96,01100000,210,11010010
76,01001100,24,00011000,100,01100100
27,00011011,126,01111110,153,10011001
19,00010011,37,00100101,56,00111000
73,01001001,66,01000010,139,10001011
107,01101011,45,00101101,152,10011000
78,01001110,103,01100111,181,10110101
27,00011011,28,00011100,55,00110111
14,00001110,63,00111111,77,01001101
113,01110001,40,00101000,153,10011001
63,00111111,80,01010000,143,10001111
108,01101100,32,00100000,140,10001100
111,01101111,71,01000111,182,10110110
103,01100111,110,01101110,213,11010101
5,00000101,95,01011111,100,01100100
17,00010001,116,01110100,133,10000101
126,01111110,111,01101111,237,11101101
1,00000001,102,01100110,103,01100111
74,01001010,91,01011011,165,10100101
98,01100010,33,00100001,131,10000011
66,01000010,119,01110111,185,10111001
30,00011110,113,01110001,143,10001111
111,01101111,10,00001010,121,01111001
6,00000110,0,00000000,6,00000110
11,00001011,64,01000000,75,01001011
55,00110111,9,00001001,64,01000000
18,00010010,51,00110011,69,01000101
76,01001100,50,00110010,126,01111110
50,00110010,78,01001110,128,10000000
105,01101001,12,00001100,117,01110101
97,01100001,32,00100000,129,10000001
25,00011001,93,01011101,118,01110110
23,00010111,23,00010111,46,00101110
44,00101100,127,01111111,171,10101011
90,01011010,107,01101011,197,11000101
101,01100101,85,01010101,186,10111010
51,00110011,117,01110101,168,10101000
99,01100011,46,00101110,145,10010001
13,00001101,43,00101011,56,00111000
14,00001110,21,00010101,35,00100011
124,01111100,36,00100100,160,10100000
111,01101111,47,00101111,158,10011110
21,00010101,105,01101001,126,01111110
43,00101011,111,01101111,154,10011010
2,00000010,3,00000011,5,00000101
68,01000100,37,00100101,105,01101001
33,00100001,29,00011101,62,00111110
110,01101110,43,00101011,153,10011001
84,01010100,38,00100110,122,01111010
40,00101000,76,01001100,116,01110100
3,00000011,83,01010011,86,01010110
56,00111000,87,01010111,143,10001111
23,00010111,92,01011100,115,01110011
2,00000010,71,01000111,73,01001001
93,01011101,72,01001000,165,10100101
100,01100100,50,00110010,150,10010110
96,01100000,87,01010111,183,10110111
74,01001010,20,00010100,94,01011110
109,01101101,83,01010011,192,11000000
72,01001000,79,01001111,151,10010111
41,00101001,124,01111100,165,10100101
54,00110110,40,00101000,94,01011110
107,01101011,101,01100101,208,11010000
64,01000000,83,01010011,147,10010011
87,01010111,70,01000110,157,10011101
84,01010100,125,01111101,209,11010001
6,00000110,100,01100100,106,01101010
111,01101111,66,01000010,177,10110001
18,00010010,87,01010111,105,01101001
31,00011111,76,01001100,107,01101011
51,00110011,54,00110110,105,01101001
25,00011001,25,00011001,50,00110010
122,01111010,4,00000100,126,01111110
110,01101110,22,00010110,132,10000100
54,00110110,113,01110001,167,10100111
98,01100010,89,01011001,187,10111011
39,00100111,42,00101010,81,01010001
98,01100010,56,00111000,154,10011010
22,00010110,69,01000101,91,01011011
66,01000010,107,01101011,173,10101101
114,01110010,125,01111101,239,11101111
91,01011011,9,00001001,100,01100100
82,01010010,26,00011010,108,01101100
103,01100111,6,00000110,109,01101101
13,00001101,80,01010000,93,01011101
96,01100000,58,00111010,154,10011010
89,01011001,27,00011011,116,01110100
24,00011000,56,00111000,80,01010000
86,01010110,76,01001100,162,10100010
28,00011100,12,00001100,40,00101000
68,01000100,9,00001001,77,01001101
72,01001000,57,00111001,129,10000001
102,01100110,117,01110101,219,11011011
34,00100010,41,00101001,75,01001011
64,01000000,16,00010000,80,01010000
89,01011001,47,00101111,136,10001000
83,01010011,30,00011110,113,01110001
34,00100010,58,00111010,92,01011100
103,01100111,101,01100101,204,11001100
21,00010101,56,00111000,77,01001101
72,01001000,68,01000100,140,10001100
74,01001010,11,00001011,85,01010101
123,01111011,5,00000101,128,10000000
48,00110000,71,01000111,119,01110111
123,01111011,103,01100111,226,11100010
64,01000000,36,00100100,100,01100100
30,00011110,68,01000100,98,01100010
1,00000001,82,01010010,83,01010011
62,00111110,114,01110010,176,10110000
28,00011100,49,00110001,77,01001101
67,01000011,124,01111100,191,10111111
30,00011110,37,00100101,67,01000011
22,00010110,119,01110111,141,10001101
96,01100000,125,01111101,221,11011101
106,01101010,108,01101100,214,11010110
82,01010010,124,01111100,206,11001110
43,00101011,116,01110100,159,10011111
58,00111010,11,00001011,69,01000101
58,00111010,116,01110100,174,10101110
90,01011010,5,00000101,95,01011111
83,01010011,86,01010110,169,10101001
110,01101110,126,01111110,236,11101100
56,00111000,122,01111010,178,10110010
68,01000100,91,01011011,159,10011111
45,00101101,77,01001101,122,01111010
69,01000101,110,01101110,179,10110011
2,00000010,41,00101001,43,00101011
50,00110010,61,00111101,111,01101111
88,01011000,45,00101101,133,10000101
59,00111011,45,00101101,104,01101000
93,01011101,28,00011100,121,01111001
69,01000101,97,01100001,166,10100110
25,00011001,96,01100000,121,01111001
92,01011100,93,01011101,185,10111001
107,01101011,73,01001001,180,10110100
69,01000101,122,01111010,191,10111111
20,00010100,88,01011000,108,01101100
126,01111110,92,01011100,218,11011010
24,00011000,117,01110101,141,10001101
17,00010001,44,00101100,61,00111101
66,01000010,27,00011011,93,01011101
25,00011001,58,00111010,83,01010011
16,00010000,32,00100000,48,00110000
102,01100110,94,01011110,196,11000100
47,00101111,5,00000101,52,00110100
40,00101000,18,00010010,58,00111010
26,00011010,100,01100100,126,01111110
47,00101111,119,01110111,166,10100110
114,01110010,27,00011011,141,10001101
46,00101110,114,01110010,160,10100000
35,00100011,23,00010111,58,00111010
56,00111000,10,00001010,66,01000010
52,00110100,124,01111100,176,10110000
127,01111111,58,00111010,185,10111001
10,00001010,67,01000011,77,01001101
11,00001011,8,00001000,19,00010011
119,01110111,17,00010001,136,10001000
77,01001101,85,01010101,162,10100010
40,00101000,9,00001001,49,00110001
10,00001010,22,00010110,32,00100000
93,01011101,86,01010110,179,10110011
105,01101001,93,01011101,198,11000110
126,01111110,97,01100001,223,11011111
74,01001010,71,01000111,145,10010001
78,01001110,106,01101010,184,10111000
54,00110110,99,01100011,153,10011001
70,01000110,24,00011000,94,01011110
122,01111010,107,01101011,229,11100101
72,01001000,51,00110011,123,01111011
2,00000010,39,00100111,41,00101001
46,00101110,41,00101001,87,01010111
13,00001101,20,00010100,33,00100001
65,01000001,82,01010010,147,10010011
76,01001100,1,00000001,77,01001101
9,00001001,86,01010110,95,01011111
2,00000010,60,00111100,62,00111110
57,00111001,76,01001100,133,10000101
21,00010101,90,01011010,111,01101111
6,00000110,36,00100100,42,00101010
2,00000010,60,00111100,62,00111110
58,00111010,101,01100101,159,10011111
64,01000000,12,00001100,76,01001100
48,00110000,45,00101101,93,01011101
18,00010010,36,00100100,54,00110110
122,01111010,121,01111001,243,11110011
112,01110000,96,01100000,208,11010000
113,01110001,110,01101110,223,11011111
9,00001001,35,00100011,44,00101100
124,01111100,31,00011111,155,10011011
123,01111011,118,01110110,241,11110001
26,00011010,74,01001010,100,01100100
18,00010010,61,00111101,79,01001111
127,01111111,9,00001001,136,10001000
18,00010010,21,00010101,39,00100111
48,00110000,17,00010001,65,01000001
109,01101101,84,01010100,193,11000001
114,01110010,77,01001101,191,10111111
27,00011011,115,01110011,142,10001110
55,00110111,103,01100111,158,10011110
118,01110110,105,01101001,223,11011111
95,01011111,87,01010111,182,10110110
85,01010101,78,01001110,163,10100011
98,01100010,20,00010100,118,01110110
30,00011110,84,01010100,114,01110010
70,01000110,61,00111101,131,10000011
99,01100011,46,00101110,145,10010001
53,00110101,5,00000101,58,00111010
22,00010110,45,00101101,67,01000011
52,00110100,126,01111110,178,10110010
84,01010100,40,00101000,124,01111100
62,00111110,114,01110010,176,10110000
47,00101111,51,00110011,98,01100010
19,00010011,45,00101101,64,01000000
21,00010101,37,00100101,58,00111010
84,01010100,115,01110011,199,11000111
55,00110111,23,00010111,78,01001110
89,01011001,25,00011001,114,01110010
78,01001110,120,01111000,198,11000110
79,01001111,55,00110111,134,10000110
45,00101101,16,00010000,61,00111101
125,01111101,126,01111110,251,11111011
8,00001000,74,01001010,82,01010010
106,01101010,21,00010101,127,01111111
16,00010000,94,01011110,110,01101110
60,00111100,22,00010110,82,01010010
108,01101100,89,01011001,197,11000101
27,00011011,41,00101001,68,01000100
83,01010011,30,00011110,113,01110001
123,01111011,42,00101010,165,10100101
58,00111010,103,01100111,161,10100001
33,00100001,21,00010101,54,00110110
74,01001010,4,00000100,78,01001110
104,01101000,34,00100010,138,10001010
116,01110100,23,00010111,139,10001011
64,01000000,80,01010000,144,10010000
106,01101010,78,01001110,184,10111000
65,01000001,73,01001001,138,10001010
101,01100101,19,00010011,120,01111000
64,01000000,3,00000011,67,01000011
45,00101101,41,00101001,86,01010110
43,00101011,119,01110111,162,10100010
25,00011001,65,01000001,90,01011010
48,00110000,24,00011000,72,01001000
1,00000001,11,00001011,12,00001100
47,00101111,79,01001111,126,01111110
23,00010111,94,01011110,117,01110101
54,00110110,20,00010100,74,01001010
100,01100100,2,00000010,102,01100110
107,01101011,56,00111000,163,10100011
87,01010111,105,01101001,192,11000000
93,01011101,49,00110001,142,10001110
59,00111011,34,00100010,93,01011101
36,00100100,93,01011101,129,10000001
3,00000011,59,00111011,62,00111110
27,00011011,83,01010011,110,01101110
35,00100011,4,00000100,39,00100111
92,01011100,51,00110011,143,10001111
11,00001011,110,01101110,121,01111001
9,00001001,76,01001100,85,01010101
21,00010101,29,00011101,50,00110010
49,00110001,113,01110001,162,10100010
67,01000011,70,01000110,137,10001001
83,01010011,24,00011000,107,01101011
29,00011101,26,00011010,55,00110111
78,01001110,57,00111001,135,10000111
99,01100011,101,01100101,200,11001000
49,00110001,109,01101101,158,10011110
75,01001011,1,00000001,76,01001100
1,00000001,34,00100010,35,00100011
110,01101110,107,01101011,217,11011001
82,01010010,118,01110110,200,11001000
84,01010100,41,00101001,125,01111101
6,00000110,40,00101000,46,00101110
87,01010111,100,01100100,187,10111011
88,01011000,24,00011000,112,01110000
114,01110010,110,01101110,224,11100000
96,01100000,86,01010110,182,10110110
18,00010010,15,00001111,33,00100001
39,00100111,90,01011010,129,10000001
51,00110011,103,01100111,154,10011010
73,01001001,4,00000100,77,01001101
65,01000001,26,00011010,91,01011011
93,01011101,31,00011111,124,01111100
93,01011101,37,00100101,130,10000010
18,00010010,91,01011011,109,01101101
47,00101111,32,00100000,79,01001111
113,01110001,55,00110111,168,10101000
11,00001011,59,00111011,70,01000110
26,00011010,60,00111100,86,01010110
65,01000001,101,01100101,166,10100110
65,01000001,39,00100111,104,01101000
119,01110111,12,00001100,131,10000011
92,01011100,21,00010101,113,01110001
91,01011011,6,00000110,97,01100001
112,01110000,85,01010101,197,11000101
22,00010110,87,01010111,109,01101101
32,00100000,88,01011000,120,01111000
98,01100010,31,00011111,129,10000001
32,00100000,108,01101100,140,10001100
29,00011101,38,00100110,67,01000011
126,01111110,56,00111000,182,10110110
80,01010000,68,01000100,148,10010100
66,01000010,46,00101110,112,01110000
30,00011110,93,01011101,123,01111011
39,00100111,106,01101010,145,10010001
9,00001001,55,00110111,64,01000000
90,01011010,70,01000110,160,10100000
37,00100101,89,01011001,126,01111110
42,00101010,52,00110100,94,01011110
86,01010110,122,01111010,208,11010000
126,01111110,66,01000010,192,11000000
33,00100001,51,00110011,84,01010100
56,00111000,10,00001010,66,01000010
50,00110010,99,01100011,149,10010101
35,00100011,1,00000001,36,00100100
86,01010110,78,01001110,164,10100100
57,00111001,33,00100001,90,01011010
72,01001000,22,00010110,94,01011110
107,01101011,63,00111111,170,10101010
65,01000001,51,00110011,116,01110100
32,00100000,106,01101010,138,10001010
35,00100011,64,01000000,99,01100011
84,01010100,61,00111101,145,10010001
25,00011001,83,01010011,108,01101100
1,00000001,54,00110110,55,00110111
91,01011011,100,01100100,191,10111111
64,01000000,74,01001010,138,10001010
48,00110000,66,01000010,114,01110010
12,00001100,62,00111110,74,01001010
53,00110101,76,01001100,129,10000001
80,01010000,119,01110111,199,11000111
67,01000011,122,01111010,189,10111101
41,00101001,78,01001110,119,01110111
113,01110001,119,01110111,232,11101000
116,01110100,127,01111111,243,11110011
105,01101001,85,01010101,190,10111110
76,01001100,113,01110001,189,10111101
93,01011101,120,01111000,213,11010101
12,00001100,58,00111010,70,01000110
73,01001001,91,01011011,164,10100100
97,01100001,37,00100101,134,10000110
46,00101110,59,00111011,105,01101001
79,01001111,82,01010010,161,10100001
123,01111011,101,01100101,224,11100000
105,01101001,114,01110010,219,11011011
111,01101111,39,00100111,150,10010110
12,00001100,25,00011001,37,00100101
38,00100110,3,00000011,41,00101001
4,00000100,31,00011111,35,00100011
103,01100111,85,01010101,188,10111100
65,01000001,55,00110111,120,01111000
122,01111010,71,01000111,193,11000001
110,01101110,127,01111111,237,11101101
16,00010000,71,01000111,87,01010111
77,01001101,122,01111010,199,11000111
105,01101001,89,01011001,194,11000010
75,01001011,125,01111101,200,11001000
99,01100011,57,00111001,156,10011100
126,01111110,125,01111101,251,11111011
66,01000010,77,01001101,143,10001111
3,00000011,75,01001011,78,01001110
1,00000001,96,01100000,97,01100001
67,01000011,8,00001000,75,01001011
49,00110001,8,00001000,57,00111001
37,00100101,106,01101010,143,10001111
49,00110001,1,00000001,50,00110010
86,01010110,69,01000101,155,10011011
43,00101011,105,01101001,148,10010100
43,00101011,36,00100100,79,01001111
105,01101001,40,00101000,145,10010001
36,00100100,52,00110100,88,01011000
114,01110010,77,01001101,191,10111111
37,00100101,45,00101101,82,01010010
41,00101001,57,00111001,98,01100010
72,01001000,89,01011001,161,10100001
24,00011000,5,00000101,29,00011101
5,00000101,36,00100100,41,00101001
101,01100101,4,00000100,105,01101001
79,01001111,58,00111010,137,10001001
71,01000111,23,00010111,94,01011110
34,00100010,73,01001001,107,01101011
9,00001001,56,00111000,65,01000001
46,00101110,35,00100011,81,01010001
95,01011111,63,00111111,158,10011110
72,01001000,50,00110010,122,01111010
71,01000111,56,00111000,127,01111111
69,01000101,95,01011111,164,10100100
15,00001111,88,01011000,103,01100111
86,01010110,127,01111111,213,11010101
6,00000110,38,00100110,44,00101100
112,01110000,104,01101000,216,11011000
77,01001101,121,01111001,198,11000110
18,00010010,68,01000100,86,01010110
4,00000100,126,01111110,130,10000010
116,01110100,118,01110110,234,11101010
70,01000110,105,01101001,175,10101111
126,01111110,76,01001100,202,11001010
68,01000100,43,00101011,111,01101111
25,00011001,64,01000000,89,01011001
85,01010101,123,01111011,208,11010000
4,00000100,62,00111110,66,01000010
124,01111100,36,00100100,160,10100000
36,00100100,114,01110010,150,10010110
60,00111100,26,00011010,86,01010110
62,00111110,62,00111110,124,01111100
29,00011101,104,01101000,133,10000101
30,00011110,79,01001111,109,01101101
67,01000011,84,01010100,151,10010111
119,01110111,118,01110110,237,11101101
82,01010010,103,01100111,185,10111001
62,00111110,56,00111000,118,01110110
13,00001101,23,00010111,36,00100100
28,00011100,124,01111100,152,10011000
91,01011011,105,01101001,196,11000100
80,01010000,114,01110010,194,11000010
127,01111111,5,00000101,132,10000100
66,01000010,57,00111001,123,01111011
12,00001100,4,00000100,16,00010000
21,00010101,65,01000001,86,01010110
123,01111011,117,01110101,240,11110000
27,00011011,30,00011110,57,00111001
101,01100101,112,01110000,213,11010101
67,01000011,0,00000000,67,01000011
39,00100111,72,01001000,111,01101111
94,01011110,113,01110001,207,11001111
44,00101100,35,00100011,79,01001111
12,00001100,68,01000100,80,01010000
88,01011000,61,00111101,149,10010101
89,01011001,36,00100100,125,01111101
67,01000011,55,00110111,122,01111010
4,00000100,109,01101101,113,01110001
99,01100011,124,01111100,223,11011111
2,00000010,84,01010100,86,01010110
36,00100100,84,01010100,120,01111000
13,00001101,32,00100000,45,00101101
28,00011100,40,00101000,68,01000100
39,00100111,1,00000001,40,00101000
97,01100001,67,01000011,164,10100100
37,00100101,65,01000001,102,01100110
95,01011111,67,01000011,162,10100010
104,01101000,3,00000011,107,01101011
35,00100011,98,01100010,133,10000101
90,01011010,38,00100110,128,10000000
47,00101111,120,01111000,167,10100111
90,01011010,120,01111000,210,11010010
38,00100110,65,01000001,103,01100111
97,01100001,51,00110011,148,10010100
94,01011110,118,01110110,212,11010100
15,00001111,108,01101100,123,01111011
118,01110110,101,01100101,219,11011011
62,00111110,43,00101011,105,01101001
101,01100101,102,01100110,203,11001011
122,01111010,26,00011010,148,10010100
52,00110100,47,00101111,99,01100011
64,01000000,126,01111110,190,10111110
48,00110000,2,00000010,50,00110010
100,01100100,55,00110111,155,10011011
42,00101010,78,01001110,120,01111000
88,01011000,127,01111111,215,11010111
82,01010010,104,01101000,186,10111010
6,00000110,3,00000011,9,00001001
94,01011110,110,01101110,204,11001100
54,00110110,78,01001110,132,10000100
95,01011111,22,00010110,117,01110101
16,00010000,17,00010001,33,00100001
10,00001010,17,00010001,27,00011011
61,00111101,69,01000101,130,10000010
56,00111000,23,00010111,79,01001111
123,01111011,99,01100011,222,11011110
57,00111001,50,00110010,107,01101011
3,00000011,45,00101101,48,00110000
126,01111110,27,00011011,153,10011001
62,00111110,4,00000100,66,01000010
5,00000101,116,01110100,121,01111001
114,01110010,41,00101001,155,10011011
118,01110110,106,01101010,224,11100000
10,00001010,63,00111111,73,01001001
92,01011100,55,00110111,147,10010011
12,00001100,49,00110001,61,00111101
49,00110001,99,01100011,148,10010100
35,00100011,96,01100000,131,10000011
76,01001100,103,01100111,179,10110011
48,00110000,86,01010110,134,10000110
83,01010011,118,01110110,201,11001001
19,00010011,65,01000001,84,01010100
3,00000011,65,01000001,68,01000100
93,01011101,98,01100010,191,10111111
41,00101001,2,00000010,43,00101011
42,00101010,72,01001000,114,01110010
105,01101001,4,00000100,109,01101101
42,00101010,62,00111110,104,01101000
81,01010001,58,00111010,139,10001011
19,00010011,53,00110101,72,01001000
76,01001100,10,00001010,86,01010110
121,01111001,125,01111101,246,11110110
120,01111000,68,01000100,188,10111100
123,01111011,6,00000110,129,10000001
5,00000101,28,00011100,33,00100001
73,01001001,96,01100000,169,10101001
108,01101100,49,00110001,157,10011101
58,00111010,69,01000101,127,01111111
112,01110000,42,00101010,154,10011010
61,00111101,83,01010011,144,10010000
112,01110000,32,00100000,144,10010000
65,01000001,48,00110000,113,01110001
19,00010011,33,00100001,52,00110100
13,00001101,4,00000100,17,00010001
86,01010110,52,00110100,138,10001010
98,01100010,39,00100111,137,10001001
1,00000001,14,00001110,15,00001111
27,00011011,63,00111111,90,01011010
72,01001000,80,01010000,152,10011000
77,01001101,47,00101111,124,01111100
18,00010010,47,00101111,65,01000001
108,01101100,45,00101101,153,10011001
26,00011010,7,00000111,33,00100001
26,00011010,101,01100101,127,01111111
57,00111001,42,00101010,99,01100011
37,00100101,48,00110000,85,01010101
62,00111110,6,00000110,68,01000100
98,01100010,34,00100010,132,10000100
96,01100000,39,00100111,135,10000111
55,00110111,106,01101010,161,10100001
78,01001110,38,00100110,116,01110100
58,00111010,48,00110000,106,01101010
107,01101011,49,00110001,156,10011100
19,00010011,39,00100111,58,00111010
100,01100100,67,01000011,167,10100111
65,01000001,49,00110001,114,01110010
34,00100010,6,00000110,40,00101000
102,01100110,87,01010111,189,10111101
93,01011101,44,00101100,137,10001001
73,01001001,26,00011010,99,01100011
24,00011000,53,00110101,77,01001101
77,01001101,93,01011101,170,10101010
12,00001100,66,01000010,78,01001110
39,00100111,15,00001111,54,00110110
68,01000100,101,01100101,169,10101001
41,00101001,124,01111100,165,10100101
115,01110011,115,01110011,230,11100110
64,01000000,88,01011000,152,10011000
90,01011010,20,00010100,110,01101110
112,01110000,108,01101100,220,11011100
93,01011101,52,00110100,145,10010001
10,00001010,90,01011010,100,01100100
84,01010100,32,00100000,116,01110100
103,01100111,38,00100110,141,10001101
28,00011100,87,01010111,115,01110011
30,00011110,44,00101100,74,01001010
62,00111110,109,01101101,171,10101011
87,01010111,10,00001010,97,01100001
100,01100100,87,01010111,187,10111011
115,01110011,93,01011101,208,11010000
3,00000011,12,00001100,15,00001111
112,01110000,81,01010001,193,11000001
118,01110110,97,01100001,215,11010111
36,00100100,68,01000100,104,01101000
65,01000001,61,00111101,126,01111110
9,00001001,71,01000111,80,01010000
29,00011101,56,00111000,85,01010101
85,01010101,37,00100101,122,01111010
43,00101011,102,01100110,145,10010001
29,00011101,124,01111100,153,10011001
118,01110110,79,01001111,197,11000101
102,01100110,43,00101011,145,10010001
51,00110011,17,00010001,68,01000100
87,01010111,82,01010010,169,10101001
0,00000000,97,01100001,97,01100001
99,01100011,30,00011110,129,10000001
122,01111010,34,00100010,156,10011100
42,00101010,53,00110101,95,01011111
59,00111011,70,01000110,129,10000001
25,00011001,37,00100101,62,00111110
53,00110101,36,00100100,89,01011001
83,01010011,66,01000010,149,10010101
71,01000111,10,00001010,81,01010001
18,00010010,124,01111100,142,10001110
23,00010111,55,00110111,78,01001110
44,00101100,21,00010101,65,01000001
123,01111011,76,01001100,199,11000111
27,00011011,38,00100110,65,01000001
19,00010011,101,01100101,120,01111000
61,00111101,111,01101111,172,10101100
17,00010001,32,00100000,49,00110001
123,01111011,37,00100101,160,10100000
69,01000101,44,00101100,113,01110001
84,01010100,72,01001000,156,10011100
115,01110011,1,00000001,116,01110100
32,00100000,30,00011110,62,00111110
65,01000001,35,00100011,100,01100100
121,01111001,76,01001100,197,11000101
33,00100001,37,00100101,70,01000110
11,00001011,93,01011101,104,01101000
92,01011100,35,00100011,127,01111111
78,01001110,95,01011111,173,10101101
113,01110001,48,00110000,161,10100001
108,01101100,98,01100010,206,11001110
127,01111111,11,00001011,138,10001010
6,00000110,66,01000010,72,01001000
86,01010110,30,00011110,116,01110100
88,01011000,110,01101110,198,11000110
16,00010000,82,01010010,98,01100010
14,00001110,35,00100011,49,00110001
98,01100010,2,00000010,100,01100100
3,00000011,46,00101110,49,00110001
71,01000111,1,00000001,72,01001000
83,01010011,67,01000011,150,10010110
87,01010111,3,00000011,90,01011010
90,01011010,99,01100011,189,10111101
74,01001010,67,01000011,141,10001101
22,00010110,22,00010110,44,00101100
65,01000001,13,00001101,78,01001110
62,00111110,80,01010000,142,10001110
13,00001101,16,00010000,29,00011101
34,00100010,28,00011100,62,00111110
89,01011001,17,00010001,106,01101010
83,01010011,46,00101110,129,10000001
60,00111100,13,00001101,73,01001001
77,01001101,32,00100000,109,01101101
114,01110010,6,00000110,120,01111000
59,00111011,19,00010011,78,01001110
22,00010110,52,00110100,74,01001010
3,00000011,40,00101000,43,00101011
23,00010111,124,01111100,147,10010011
96,01100000,78,01001110,174,10101110
3,00000011,42,00101010,45,00101101
18,00010010,99,01100011,117,01110101
12,00001100,81,01010001,93,01011101
107,01101011,70,01000110,177,10110001
110,01101110,78,01001110,188,10111100
1,00000001,30,00011110,31,00011111
71,01000111,120,01111000,191,10111111
89,01011001,61,00111101,150,10010110
98,01100010,96,01100000,194,11000010
16,00010000,121,01111001,137,10001001
3,00000011,50,00110010,53,00110101
5,00000101,52,00110100,57,00111001
38,00100110,53,00110101,91,01011011
111,01101111,43,00101011,154,10011010
88,01011000,102,01100110,190,10111110
111,01101111,85,01010101,196,11000100
100,01100100,105,01101001,205,11001101
87,01010111,50,00110010,137,10001001
126,01111110,80,01010000,206,11001110
64,01000000,8,00001000,72,01001000
18,00010010,100,01100100,118,01110110
52,00110100,36,00100100,88,01011000
38,00100110,85,01010101,123,01111011
28,00011100,16,00010000,44,00101100
28,00011100,7,00000111,35,00100011
127,01111111,95,01011111,222,11011110
62,00111110,89,01011001,151,10010111
5,00000101,46,00101110,51,00110011
54,00110110,14,00001110,68,01000100
90,01011010,46,00101110,136,10001000
7,00000111,84,01010100,91,01011011
81,01010001,12,00001100,93,01011101
124,01111100,14,00001110,138,10001010
37,00100101,45,00101101,82,01010010
10,00001010,101,01100101,111,01101111
122,01111010,48,00110000,170,10101010
22,00010110,45,00101101,67,01000011
105,01101001,105,01101001,210,11010010
34,00100010,36,00100100,70,01000110
107,01101011,119,01110111,226,11100010
127,01111111,86,01010110,213,11010101
85,01010101,113,01110001,198,11000110
106,01101010,76,01001100,182,10110110
68,01000100,44,00101100,112,01110000
117,01110101,6,00000110,123,01111011
31,00011111,120,01111000,151,10010111
34,00100010,35,00100011,69,01000101
125,01111101,0,00000000,125,01111101
2,00000010,102,01100110,104,01101000
106,01101010,79,01001111,185,10111001
26,00011010,9,00001001,35,00100011
67,01000011,115,01110011,182,10110110
5,00000101,99,01100011,104,01101000
42,00101010,118,01110110,160,10100000
52,00110100,23,00010111,75,01001011
51,00110011,24,00011000,75,01001011
126,01111110,38,00100110,164,10100100
77,01001101,107,01101011,184,10111000
32,00100000,23,00010111,55,00110111
36,00100100,108,01101100,144,10010000
80,01010000,99,01100011,179,10110011
117,01110101,105,01101001,222,11011110
9,00001001,118,01110110,127,01111111
122,01111010,39,00100111,161,10100001
120,01111000,61,00111101,181,10110101
105,01101001,62,00111110,167,10100111
29,00011101,57,00111001,86,01010110
23,00010111,21,00010101,44,00101100
127,01111111,126,01111110,253,11111101
26,00011010,108,01101100,134,10000110
32,00100000,97,01100001,129,10000001
114,01110010,31,00011111,145,10010001
102,01100110,27,00011011,129,10000001
1,00000001,95,01011111,96,01100000
90,01011010,63,00111111,153,10011001
50,00110010,119,01110111,169,10101001
37,00100101,55,00110111,92,01011100
39,00100111,5,00000101,44,00101100
92,01011100,7,00000111,99,01100011
101,01100101,87,01010111,188,10111100
0,00000000,40,00101000,40,00101000
4,00000100,40,00101000,44,00101100
57,00111001,35,00100011,92,01011100
61,00111101,45,00101101,106,01101010
60,00111100,47,00101111,107,01101011
77,01001101,59,00111011,136,10001000
5,00000101,50,00110010,55,00110111
72,01001000,117,01110101,189,10111101
108,01101100,30,00011110,138,10001010
44,00101100,44,00101100,88,01011000
109,01101101,48,00110000,157,10011101
86,01010110,116,01110100,202,11001010
80,01010000,121,01111001,201,11001001
78,01001110,5,00000101,83,01010011
10,00001010,99,01100011,109,01101101
84,01010100,28,00011100,112,01110000
6,00000110,52,00110100,58,00111010
60,00111100,116,01110100,176,10110000
35,00100011,84,01010100,119,01110111
93,01011101,84,01010100,177,10110001
103,01100111,27,00011011,130,10000010
87,01010111,110,01101110,197,11000101
80,01010000,30,00011110,110,01101110
98,01100010,88,01011000,186,10111010
44,00101100,62,00111110,106,01101010
100,01100100,46,00101110,146,10010010
69,01000101,11,00001011,80,01010000
65,01000001,123,01111011,188,10111100
26,00011010,126,01111110,152,10011000
51,00110011,116,01110100,167,10100111
108,01101100,19,00010011,127,01111111
88,01011000,35,00100011,123,01111011
52,00110100,76,01001100,128,10000000
95,01011111,49,00110001,144,10010000
66,01000010,28,00011100,94,01011110
116,01110100,24,00011000,140,10001100
41,00101001,40,00101000,81,01010001
17,00010001,22,00010110,39,00100111
108,01101100,70,01000110,178,10110010
117,01110101,122,01111010,239,11101111
83,01010011,77,01001101,160,10100000
1,00000001,35,00100011,36,00100100
91,01011011,67,01000011,158,10011110
112,01110000,59,00111011,171,10101011
10,00001010,20,00010100,30,00011110
103,01100111,0,00000000,103,01100111
17,00010001,63,00111111,80,01010000
9,00001001,91,01011011,100,01100100
44,00101100,96,01100000,140,10001100
112,01110000,13,00001101,125,01111101
66,01000010,111,01101111,177,10110001
109,01101101,44,00101100,153,10011001
6,00000110,25,00011001,31,00011111
35,00100011,119,01110111,154,10011010
9,00001001,32,00100000,41,00101001
79,01001111,121,01111001,200,11001000
106,01101010,54,00110110,160,10100000
25,00011001,75,01001011,100,01100100
36,00100100,64,01000000,100,01100100
95,01011111,121,01111001,216,11011000
109,01101101,109,01101101,218,11011010
119,01110111,99,01100011,218,11011010
62,00111110,17,00010001,79,01001111
74,01001010,38,00100110,112,01110000
74,01001010,118,01110110,192,11000000
7,00000111,61,00111101,68,01000100
106,01101010,42,00101010,148,10010100
127,01111111,102,01100110,229,11100101
26,00011010,1,00000001,27,00011011
17,00010001,113,01110001,130,10000010
76,01001100,90,01011010,166,10100110
126,01111110,95,01011111,221,11011101
124,01111100,43,00101011,167,10100111
94,01011110,30,00011110,124,01111100
118,01110110,121,01111001,239,11101111
77,01001101,24,00011000,101,01100101
92,01011100,70,01000110,162,10100010
63,00111111,84,01010100,147,10010011
105,01101001,100,01100100,205,11001101
10,00001010,103,01100111,113,01110001
3,00000011,68,01000100,71,01000111
86,01010110,27,00011011,113,01110001
80,01010000,28,00011100,108,01101100
103,01100111,102,01100110,205,11001101
82,01010010,51,00110011,133,10000101
12,00001100,88,01011000,100,01100100
126,01111110,37,00100101,163,10100011
7,00000111,51,00110011,58,00111010
76,01001100,65,01000001,141,10001101
73,01001001,49,00110001,122,01111010
27,00011011,108,01101100,135,10000111
99,01100011,104,01101000,203,11001011
72,01001000,50,00110010,122,01111010
49,00110001,71,01000111,120,01111000
67,01000011,122,01111010,189,10111101
74,01001010,86,01010110,160,10100000
101,01100101,111,01101111,212,11010100
14,00001110,99,01100011,113,01110001
82,01010010,51,00110011,133,10000101
117,01110101,77,01001101,194,11000010
2,00000010,82,01010010,84,01010100
70,01000110,104,01101000,174,10101110
7,00000111,86,01010110,93,01011101
40,00101000,15,00001111,55,00110111
107,01101011,27,00011011,134,10000110
117,01110101,105,01101001,222,11011110
6,00000110,120,01111000,126,01111110
104,01101000,67,01000011,171,10101011
124,01111100,101,01100101,225,11100001
78,01001110,93,01011101,171,10101011
32,00100000,23,00010111,55,00110111
16,00010000,48,00110000,64,01000000
89,01011001,69,01000101,158,10011110
40,00101000,39,00100111,79,01001111
126,01111110,34,00100010,160,10100000
77,01001101,39,00100111,116,01110100
83,01010011,87,01010111,170,10101010
45,00101101,122,01111010,167,10100111
52,00110100,15,00001111,67,01000011
68,01000100,31,00011111,99,01100011
123,01111011,66,01000010,189,10111101
34,00100010,8,00001000,42,00101010
86,01010110,46,00101110,132,10000100
97,01100001,111,01101111,208,11010000
115,01110011,72,01001000,187,10111011
113,01110001,53,00110101,166,10100110
83,01010011,121,01111001,204,11001100
29,00011101,127,01111111,156,10011100
8,00001000,14,00001110,22,00010110
101,01100101,85,01010101,186,10111010
22,00010110,99,01100011,121,01111001
100,01100100,86,01010110,186,10111010
69,01000101,45,00101101,114,01110010
26,00011010,35,00100011,61,00111101
107,01101011,32,00100000,139,10001011
84,01010100,71,01000111,155,10011011
89,01011001,69,01000101,158,10011110
47,00101111,118,01110110,165,10100101
89,01011001,116,01110100,205,11001101
12,00001100,41,00101001,53,00110101
8,00001000,112,01110000,120,01111000
72,01001000,90,01011010,162,10100010
46,00101110,94,01011110,140,10001100
22,00010110,86,01010110,108,01101100
1,00000001,116,01110100,117,01110101
116,01110100,74,01001010,190,10111110
50,00110010,72,01001000,122,01111010
113,01110001,75,01001011,188,10111100
85,01010101,3,00000011,88,01011000
104,01101000,61,00111101,165,10100101
43,00101011,35,00100011,78,01001110
96,01100000,103,01100111,199,11000111
3,00000011,107,01101011,110,01101110
15,00001111,105,01101001,120,01111000
4,00000100,5,00000101,9,00001001
46,00101110,13,00001101,59,00111011
89,01011001,122,01111010,211,11010011
82,01010010,39,00100111,121,01111001
69,01000101,14,00001110,83,01010011
75,01001011,58,00111010,133,10000101
44,00101100,74,01001010,118,01110110
43,00101011,79,01001111,122,01111010
15,00001111,23,00010111,38,00100110
100,01100100,63,00111111,163,10100011
16,00010000,62,00111110,78,01001110
81,01010001,40,00101000,121,01111001
97,01100001,53,00110101,150,10010110
121,01111001,48,00110000,169,10101001
122,01111010,109,01101101,231,11100111
111,01101111,52,00110100,163,10100011
15,00001111,126,01111110,141,10001101
23,00010111,78,01001110,101,01100101
49,00110001,8,00001000,57,00111001
32,00100000,33,00100001,65,01000001
123,01111011,17,00010001,140,10001100
3,00000011,21,00010101,24,00011000
56,00111000,75,01001011,131,10000011
92,01011100,118,01110110,210,11010010
104,01101000,32,00100000,136,10001000
25,00011001,90,01011010,115,01110011
93,01011101,52,00110100,145,10010001
6,00000110,95,01011111,101,01100101
79,01001111,9,00001001,88,01011000
89,01011001,97,01100001,186,10111010
79,01001111,91,01011011,170,10101010
107,01101011,118,01110110,225,11100001
30,00011110,120,01111000,150,10010110
126,01111110,98,01100010,224,11100000
104,01101000,115,01110011,219,11011011
66,01000010,14,00001110,80,01010000
96,01100000,107,01101011,203,11001011
16,00010000,15,00001111,31,00011111
79,01001111,46,00101110,125,01111101
14,00001110,126,01111110,140,10001100
103,01100111,93,01011101,196,11000100
52,00110100,21,00010101,73,01001001
103,01100111,25,00011001,128,10000000
76,01001100,75,01001011,151,10010111
33,00100001,64,01000000,97,01100001
103,01100111,46,00101110,149,10010101
43,00101011,99,01100011,142,10001110
20,00010100,40,00101000,60,00111100
28,00011100,21,00010101,49,00110001
14,00001110,82,01010010,96,01100000
27,00011011,10,00001010,37,00100101
16,00010000,107,01101011,123,01111011
12,00001100,47,00101111,59,00111011
52,00110100,44,00101100,96,01100000
49,00110001,22,00010110,71,01000111
115,01110011,64,01000000,179,10110011
10,00001010,25,00011001,35,00100011
11,00001011,127,01111111,138,10001010
79,01001111,31,00011111,110,01101110
67,01000011,98,01100010,165,10100101
102,01100110,78,01001110,180,10110100
113,01110001,94,01011110,207,11001111
68,01000100,40,00101000,108,01101100
25,00011001,31,00011111,56,00111000
38,00100110,6,00000110,44,00101100
25,00011001,43,00101011,68,01000100
19,00010011,34,00100010,53,00110101
55,00110111,21,00010101,76,01001100
103,01100111,78,01001110,181,10110101
111,01101111,54,00110110,165,10100101
17,00010001,116,01110100,133,10000101
25,00011001,30,00011110,55,00110111
25,00011001,111,01101111,136,10001000
53,00110101,117,01110101,170,10101010
63,00111111,90,01011010,153,10011001
120,01111000,6,00000110,126,01111110
1,00000001,106,01101010,107,01101011
100,01100100,69,01000101,169,10101001
119,01110111,45,00101101,164,10100100
51,00110011,86,01010110,137,10001001
66,01000010,17,00010001,83,01010011
54,00110110,25,00011001,79,01001111
78,01001110,46,00101110,124,01111100
123,01111011,51,00110011,174,10101110
95,01011111,99,01100011,194,11000010
112,01110000,116,01110100,228,11100100
46,00101110,32,00100000,78,01001110
99,01100011,68,01000100,167,10100111
73,01001001,79,01001111,152,10011000
94,01011110,94,01011110,188,10111100
115,01110011,31,00011111,146,10010010
46,00101110,69,01000101,115,01110011
109,01101101,40,00101000,149,10010101
71,01000111,94,01011110,165,10100101
67,01000011,80,01010000,147,10010011
27,00011011,40,00101000,67,01000011
97,01100001,125,01111101,222,11011110
113,01110001,115,01110011,228,11100100
38,00100110,15,00001111,53,00110101
33,00100001,77,01001101,110,01101110
37,00100101,51,00110011,88,01011000
71,01000111,49,00110001,120,01111000
88,01011000,4,00000100,92,01011100
64,01000000,76,01001100,140,10001100
119,01110111,11,00001011,130,10000010
111,01101111,8,00001000,119,01110111
95,01011111,107,01101011,202,11001010
111,01101111,103,01100111,214,11010110
96,01100000,40,00101000,136,10001000
37,00100101,107,01101011,144,10010000
124,01111100,101,01100101,225,11100001
13,00001101,15,00001111,28,00011100
121,01111001,110,01101110,231,11100111
115,01110011,58,00111010,173,10101101
91,01011011,118,01110110,209,11010001
39,00100111,17,00010001,56,00111000
86,01010110,114,01110010,200,11001000
11,00001011,111,01101111,122,01111010
90,01011010,59,00111011,149,10010101
19,00010011,44,00101100,63,00111111
19,00010011,53,00110101,72,01001000
76,01001100,118,01110110,194,11000010
83,01010011,103,01100111,186,10111010
118,01110110,41,00101001,159,10011111
50,00110010,108,01101100,158,10011110
50,00110010,36,00100100,86,01010110
43,00101011,98,01100010,141,10001101
42,00101010,105,01101001,147,10010011
52,00110100,2,00000010,54,00110110
125,01111101,4,00000100,129,10000001
23,00010111,37,00100101,60,00111100
110,01101110,119,01110111,229,11100101
77,01001101,118,01110110,195,11000011
29,00011101,19,00010011,48,00110000
37,00100101,94,01011110,131,10000011
46,00101110,39,00100111,85,01010101
112,01110000,22,00010110,134,10000110
58,00111010,96,01100000,154,10011010
16,00010000,86,01010110,102,01100110
86,01010110,105,01101001,191,10111111
11,00001011,51,00110011,62,00111110
48,00110000,115,01110011,163,10100011
38,00100110,24,00011000,62,00111110
106,01101010,108,01101100,214,11010110
11,00001011,120,01111000,131,10000011
48,00110000,127,01111111,175,10101111
52,00110100,126,01111110,178,10110010
115,01110011,44,00101100,159,10011111
37,00100101,80,01010000,117,01110101
24,00011000,114,01110010,138,10001010
64,01000000,6,00000110,70,01000110
78,01001110,102,01100110,180,10110100
105,01101001,44,00101100,149,10010101
92,01011100,41,00101001,133,10000101
88,01011000,57,00111001,145,10010001
98,01100010,52,00110100,150,10010110
79,01001111,28,00011100,107,01101011
6,00000110,24,00011000,30,00011110
22,00010110,2,00000010,24,00011000
8,00001000,43,00101011,51,00110011
36,00100100,108,01101100,144,10010000
52,00110100,7,00000111,59,00111011
100,01100100,47,00101111,147,10010011
67,01000011,34,00100010,101,01100101
72,01001000,68,01000100,140,10001100
116,01110100,24,00011000,140,10001100
69,01000101,77,01001101,146,10010010
37,00100101,36,00100100,73,01001001
118,01110110,122,01111010,240,11110000
73,01001001,70,01000110,143,10001111
117,01110101,83,01010011,200,11001000
54,00110110,36,00100100,90,01011010
96,01100000,58,00111010,154,10011010
30,00011110,110,01101110,140,10001100
7,00000111,71,01000111,78,01001110
109,01101101,114,01110010,223,11011111
16,00010000,8,00001000,24,00011000
111,01101111,69,01000101,180,10110100
59,00111011,117,01110101,176,10110000
127,01111111,55,00110111,182,10110110
118,01110110,84,01010100,202,11001010
100,01100100,14,00001110,114,01110010
114,01110010,3,00000011,117,01110101
21,00010101,7,00000111,28,00011100
111,01101111,48,00110000,159,10011111
2,00000010,105,01101001,107,01101011
37,00100101,116,01110100,153,10011001
94,01011110,21,00010101,115,01110011
116,01110100,67,01000011,183,10110111
100,01100100,79,01001111,179,10110011
61,00111101,27,00011011,88,01011000
110,01101110,56,00111000,166,10100110
7,00000111,101,01100101,108,01101100
55,00110111,76,01001100,131,10000011
38,00100110,81,01010001,119,01110111
4,00000100,78,01001110,82,01010010
46,00101110,7,00000111,53,00110101
73,01001001,1,00000001,74,01001010
20,00010100,118,01110110,138,10001010
4,00000100,101,01100101,105,01101001
64,01000000,92,01011100,156,10011100
94,01011110,39,00100111,133,10000101
30,00011110,55,00110111,85,01010101
44,00101100,105,01101001,149,10010101
50,00110010,106,01101010,156,10011100
100,01100100,24,00011000,124,01111100
85,01010101,17,00010001,102,01100110
71,01000111,26,00011010,97,01100001
34,00100010,123,01111011,157,10011101
101,01100101,104,01101000,205,11001101
59,00111011,103,01100111,162,10100010
52,00110100,67,01000011,119,01110111
112,01110000,23,00010111,135,10000111
121,01111001,73,01001001,194,11000010
100,01100100,110,01101110,210,11010010
109,01101101,101,01100101,210,11010010
94,01011110,21,00010101,115,01110011
35,00100011,4,00000100,39,00100111
83,01010011,70,01000110,153,10011001
54,00110110,122,01111010,176,10110000
24,00011000,100,01100100,124,01111100
73,01001001,103,01100111,176,10110000
101,01100101,63,00111111,164,10100100
8,00001000,96,01100000,104,01101000
115,01110011,82,01010010,197,11000101
87,01010111,14,00001110,101,01100101
9,00001001,63,00111111,72,01001000
40,00101000,121,01111001,161,10100001
109,01101101,98,01100010,207,11001111
3,00000011,104,01101000,107,01101011
4,00000100,120,01111000,124,01111100
80,01010000,76,01001100,156,10011100
4,00000100,121,01111001,125,01111101
95,01011111,32,00100000,127,01111111
79,01001111,28,00011100,107,01101011
85,01010101,53,00110101,138,10001010
116,01110100,77,01001101,193,11000001
40,00101000,51,00110011,91,01011011
115,01110011,92,01011100,207,11001111
64,01000000,73,01001001,137,10001001
13,00001101,90,01011010,103,01100111
75,01001011,44,00101100,119,01110111
9,00001001,122,01111010,131,10000011
22,00010110,25,00011001,47,00101111
64,01000000,54,00110110,118,01110110
24,00011000,68,01000100,92,01011100
47,00101111,113,01110001,160,10100000
105,01101001,20,00010100,125,01111101
12,00001100,116,01110100,128,10000000
20,00010100,93,01011101,113,01110001
74,01001010,75,01001011,149,10010101
85,01010101,25,00011001,110,01101110
94,01011110,39,00100111,133,10000101
24,00011000,85,01010101,109,01101101
73,01001001,38,00100110,111,01101111
36,00100100,93,01011101,129,10000001
120,01111000,17,00010001,137,10001001
113,01110001,63,00111111,176,10110000
41,00101001,102,01100110,143,10001111
98,01100010,70,01000110,168,10101000
60,00111100,76,01001100,136,10001000
89,01011001,78,01001110,167,10100111
12,00001100,19,00010011,31,00011111
70,01000110,53,00110101,123,01111011
9,00001001,117,01110101,126,01111110
41,00101001,95,01011111,136,10001000
52,00110100,83,01010011,135,10000111
61,00111101,115,01110011,176,10110000
107,01101011,13,00001101,120,01111000
36,00100100,62,00111110,98,01100010
22,00010110,12,00001100,34,00100010
67,01000011,79,01001111,146,10010010
107,01101011,3,00000011,110,01101110
59,00111011,34,00100010,93,01011101
102,01100110,35,00100011,137,10001001
6,00000110,11,00001011,17,00010001
61,00111101,66,01000010,127,01111111
91,01011011,75,01001011,166,10100110
58,00111010,70,01000110,128,10000000
56,00111000,95,01011111,151,10010111
78,01001110,24,00011000,102,01100110
28,00011100,106,01101010,134,10000110
41,00101001,14,00001110,55,00110111
36,00100100,83,01010011,119,01110111
49,00110001,41,00101001,90,01011010
18,00010010,56,00111000,74,01001010
55,00110111,114,01110010,169,10101001
110,01101110,52,00110100,162,10100010
107,01101011,49,00110001,156,10011100
26,00011010,35,00100011,61,00111101
113,01110001,115,01110011,228,11100100
117,01110101,81,01010001,198,11000110
120,01111000,6,00000110,126,01111110
68,01000100,116,01110100,184,10111000
122,01111010,58,00111010,180,10110100
101,01100101,81,01010001,182,10110110
38,00100110,30,00011110,68,01000100
55,00110111,35,00100011,90,01011010
80,01010000,88,01011000,168,10101000
45,00101101,5,00000101,50,00110010
82,01010010,98,01100010,180,10110100
47,00101111,110,01101110,157,10011101
109,01101101,60,00111100,169,10101001
87,01010111,91,01011011,178,10110010
64,01000000,116,01110100,180,10110100
72,01001000,37,00100101,109,01101101
78,01001110,28,00011100,106,01101010
18,00010010,70,01000110,88,01011000
8,00001000,100,01100100,108,01101100
102,01100110,66,01000010,168,10101000
99,01100011,78,01001110,177,10110001
55,00110111,1,00000001,56,00111000
61,00111101,19,00010011,80,01010000
55,00110111,114,01110010,169,10101001
113,01110001,58,00111010,171,10101011
103,01100111,96,01100000,199,11000111
74,01001010,15,00001111,89,01011001
16,00010000,29,00011101,45,00101101
29,00011101,43,00101011,72,01001000
20,00010100,57,00111001,77,01001101
93,01011101,87,01010111,180,10110100
54,00110110,45,00101101,99,01100011
38,00100110,115,01110011,153,10011001
38,00100110,94,01011110,132,10000100
44,00101100,22,00010110,66,01000010
70,01000110,115,01110011,185,10111001
14,00001110,85,01010101,99,01100011
69,01000101,94,01011110,163,10100011
88,01011000,114,01110010,202,11001010
71,01000111,64,01000000,135,10000111
124,01111100,121,01111001,245,11110101
48,00110000,59,00111011,107,01101011
63,00111111,108,01101100,171,10101011
21,00010101,46,00101110,67,01000011
122,01111010,81,01010001,203,11001011
83,01010011,15,00001111,98,01100010
5,00000101,40,00101000,45,00101101
30,00011110,49,00110001,79,01001111
102,01100110,45,00101101,147,10010011
34,00100010,69,01000101,103,01100111
88,01011000,85,01010101,173,10101101
66,01000010,40,00101000,106,01101010
76,01001100,101,01100101,177,10110001
115,01110011,32,00100000,147,10010011
10,00001010,79,01001111,89,01011001
88,01011000,123,01111011,211,11010011
40,00101000,107,01101011,147,10010011
23,00010111,123,01111011,146,10010010
25,00011001,62,00111110,87,01010111
6,00000110,31,00011111,37,00100101
107,01101011,120,01111000,227,11100011
95,01011111,72,01001000,167,10100111
7,00000111,40,00101000,47,00101111
36,00100100,51,00110011,87,01010111
17,00010001,73,01001001,90,01011010
62,00111110,87,01010111,149,10010101
110,01101110,56,00111000,166,10100110
109,01101101,25,00011001,134,10000110
48,00110000,27,00011011,75,01001011
27,00011011,13,00001101,40,00101000
41,00101001,105,01101001,146,10010010
72,01001000,29,00011101,101,01100101
55,00110111,41,00101001,96,01100000
46,00101110,59,00111011,105,01101001
34,00100010,30,00011110,64,01000000
30,00011110,20,00010100,50,00110010
26,00011010,107,01101011,133,10000101
41,00101001,12,00001100,53,00110101
15,00001111,119,01110111,134,10000110
32,00100000,88,01011000,120,01111000
99,01100011,67,01000011,166,10100110
42,00101010,4,00000100,46,00101110
47,00101111,103,01100111,150,10010110
61,00111101,21,00010101,82,01010010
49,00110001,43,00101011,92,01011100
100,01100100,95,01011111,195,11000011
68,01000100,82,01010010,150,10010110
30,00011110,24,00011000,54,00110110
13,00001101,29,00011101,42,00101010
122,01111010,30,00011110,152,10011000
100,01100100,25,00011001,125,01111101
62,00111110,50,00110010,112,01110000
95,01011111,65,01000001,160,10100000
85,01010101,6,00000110,91,01011011
97,01100001,37,00100101,134,10000110
18,00010010,25,00011001,43,00101011
10,00001010,71,01000111,81,01010001
77,01001101,101,01100101,178,10110010
126,01111110,81,01010001,207,11001111
0,00000000,17,00010001,17,00010001
95,01011111,47,00101111,142,10001110
89,01011001,71,01000111,160,10100000
45,00101101,51,00110011,96,01100000
43,00101011,16,00010000,59,00111011
87,01010111,103,01100111,190,10111110
100,01100100,6,00000110,106,01101010
125,01111101,22,00010110,147,10010011
75,01001011,119,01110111,194,11000010
82,01010010,53,00110101,135,10000111
106,01101010,117,01110101,223,11011111
63,00111111,98,01100010,161,10100001
54,00110110,28,00011100,82,01010010
29,00011101,123,01111011,152,10011000
93,01011101,75,01001011,168,10101000
44,00101100,81,01010001,125,01111101
53,00110101,22,00010110,75,01001011
34,00100010,9,00001001,43,00101011
1,00000001,43,00101011,44,00101100
92,01011100,5,00000101,97,01100001
8,00001000,26,00011010,34,00100010
6,00000110,52,00110100,58,00111010
73,01001001,63,00111111,136,10001000
93,01011101,99,01100011,192,11000000
108,01101100,126,01111110,234,11101010
29,00011101,26,00011010,55,00110111
65,01000001,119,01110111,184,10111000
101,01100101,18,00010010,119,01110111
26,00011010,99,01100011,125,01111101
99,01100011,87,01010111,186,10111010
44,00101100,27,00011011,71,01000111
63,00111111,43,00101011,106,01101010
68,01000100,66,01000010,134,10000110
31,00011111,57,00111001,88,01011000
72,01001000,9,00001001,81,01010001
42,00101010,20,00010100,62,00111110
55,00110111,32,00100000,87,01010111
72,01001000,124,01111100,196,11000100
38,00100110,120,01111000,158,10011110
108,01101100,89,01011001,197,11000101
20,00010100,18,00010010,38,00100110
84,01010100,46,00101110,130,10000010
51,00110011,27,00011011,78,01001110
114,01110010,49,00110001,163,10100011
81,01010001,25,00011001,106,01101010
49,00110001,6,00000110,55,00110111
89,01011001,37,00100101,126,01111110
41,00101001,70,01000110,111,01101111
107,01101011,25,00011001,132,10000100
124,01111100,80,01010000,204,11001100
18,00010010,58,00111010,76,01001100
111,01101111,106,01101010,217,11011001
63,00111111,78,01001110,141,10001101
16,00010000,19,00010011,35,00100011
36,00100100,69,01000101,105,01101001
19,00010011,42,00101010,61,00111101
84,01010100,77,01001101,161,10100001
31,00011111,13,00001101,44,00101100
14,00001110,12,00001100,26,00011010
53,00110101,54,00110110,107,01101011
46,00101110,79,01001111,125,01111101
71,01000111,23,00010111,94,01011110
111,01101111,114,01110010,225,11100001
102,01100110,73,01001001,175,10101111
4,00000100,102,01100110,106,01101010
19,00010011,103,01100111,122,01111010
25,00011001,16,00010000,41,00101001
40,00101000,44,00101100,84,01010100
121,01111001,102,01100110,223,11011111
72,01001000,21,00010101,93,01011101
111,01101111,69,01000101,180,10110100
43,00101011,29,00011101,72,01001000
107,01101011,16,00010000,123,01111011
28,00011100,49,00110001,77,01001101
28,00011100,101,01100101,129,10000001
7,00000111,68,01000100,75,01001011
43,00101011,77,01001101,120,01111000
123,01111011,121,01111001,244,11110100
42,00101010,126,01111110,168,10101000
24,00011000,125,01111101,149,10010101
61,00111101,59,00111011,120,01111000
1,00000001,120,01111000,121,01111001
96,01100000,102,01100110,198,11000110
123,01111011,61,00111101,184,10111000
48,00110000,107,01101011,155,10011011
14,00001110,98,01100010,112,01110000
95,01011111,4,00000100,99,01100011
89,01011001,25,00011001,114,01110010
39,00100111,124,01111100,163,10100011
6,00000110,123,01111011,129,10000001
57,00111001,118,01110110,175,10101111
106,01101010,50,00110010,156,10011100
95,01011111,65,01000001,160,10100000
2,00000010,88,01011000,90,01011010
55,00110111,41,00101001,96,01100000
111,01101111,6,00000110,117,01110101
109,01101101,50,00110010,159,10011111
59,00111011,38,00100110,97,01100001
72,01001000,76,01001100,148,10010100
67,01000011,66,01000010,133,10000101
28,00011100,112,01110000,140,10001100
75,01001011,6,00000110,81,01010001
42,00101010,24,00011000,66,01000010
52,00110100,16,00010000,68,01000100
89,01011001,69,01000101,158,10011110
52,00110100,14,00001110,66,01000010
123,01111011,93,01011101,216,11011000
35,00100011,43,00101011,78,01001110
27,00011011,125,01111101,152,10011000
108,01101100,55,00110111,163,10100011
125,01111101,112,01110000,237,11101101
70,01000110,57,00111001,127,01111111
40,00101000,61,00111101,101,01100101
39,00100111,48,00110000,87,01010111
3,00000011,54,00110110,57,00111001
11,00001011,34,00100010,45,00101101
70,01000110,102,01100110,172,10101100
64,01000000,98,01100010,162,10100010
101,01100101,30,00011110,131,10000011
17,00010001,75,01001011,92,01011100
74,01001010,108,01101100,182,10110110
84,01010100,62,00111110,146,10010010
36,00100100,70,01000110,106,01101010
125,01111101,60,00111100,185,10111001
7,00000111,0,00000000,7,00000111
65,01000001,17,00010001,82,01010010
44,00101100,15,00001111,59,00111011
59,00111011,46,00101110,105,01101001
126,01111110,108,01101100,234,11101010
111,01101111,104,01101000,215,11010111
118,01110110,85,01010101,203,11001011
56,00111000,18,00010010,74,01001010
118,01110110,38,00100110,156,10011100
70,01000110,22,00010110,92,01011100
22,00010110,50,00110010,72,01001000
68,01000100,87,01010111,155,10011011
80,01010000,84,01010100,164,10100100
63,00111111,2,00000010,65,01000001
70,01000110,54,00110110,124,01111100
33,00100001,2,00000010,35,00100011
85,01010101,127,01111111,212,11010100
74,01001010,107,01101011,181,10110101
61,00111101,41,00101001,102,01100110
38,00100110,116,01110100,154,10011010
95,01011111,101,01100101,196,11000100
114,01110010,66,01000010,180,10110100
107,01101011,42,00101010,149,10010101
57,00111001,36,00100100,93,01011101
69,01000101,68,01000100,137,10001001
61,00111101,109,01101101,170,10101010
57,00111001,126,01111110,183,10110111
1,00000001,14,00001110,15,00001111
31,00011111,125,01111101,156,10011100
57,00111001,66,01000010,123,01111011
49,00110001,56,00111000,105,01101001
123,01111011,53,00110101,176,10110000
13,00001101,25,00011001,38,00100110
4,00000100,55,00110111,59,00111011
26,00011010,40,00101000,66,01000010
14,00001110,6,00000110,20,00010100
46,00101110,101,01100101,147,10010011
99,01100011,91,01011011,190,10111110
124,01111100,59,00111011,183,10110111
119,01110111,118,01110110,237,11101101
102,01100110,1,00000001,103,01100111
91,01011011,41,00101001,132,10000100
123,01111011,87,01010111,210,11010010
57,00111001,99,01100011,156,10011100
125,01111101,30,00011110,155,10011011
52,00110100,96,01100000,148,10010100
117,01110101,33,00100001,150,10010110
32,00100000,78,01001110,110,01101110
68,01000100,30,00011110,98,01100010
53,00110101,28,00011100,81,01010001
50,00110010,117,01110101,167,10100111
28,00011100,14,00001110,42,00101010
5,00000101,33,00100001,38,00100110
76,01001100,46,00101110,122,01111010
94,01011110,117,01110101,211,11010011
63,00111111,17,00010001,80,01010000
38,00100110,77,01001101,115,01110011
99,01100011,27,00011011,126,01111110
35,00100011,14,00001110,49,00110001
98,01100010,29,00011101,127,01111111
2,00000010,22,00010110,24,00011000
5,00000101,81,01010001,86,01010110
44,00101100,79,01001111,123,01111011
57,00111001,85,01010101,142,10001110
16,00010000,79,01001111,95,01011111
91,01011011,77,01001101,168,10101000
70,01000110,67,01000011,137,10001001
9,00001001,51,00110011,60,00111100
59,00111011,92,01011100,151,10010111
77,01001101,100,01100100,177,10110001
10,00001010,95,01011111,105,01101001
61,00111101,116,01110100,177,10110001
12,00001100,39,00100111,51,00110011
116,01110100,62,00111110,178,10110010
2,00000010,28,00011100,30,00011110
89,01011001,20,00010100,109,01101101
48,00110000,48,00110000,96,01100000
47,00101111,74,01001010,121,01111001
12,00001100,95,01011111,107,01101011
71,01000111,74,01001010,145,10010001
65,01000001,85,01010101,150,10010110
92,01011100,126,01111110,218,11011010
64,01000000,75,01001011,139,10001011
99,01100011,54,00110110,153,10011001
5,00000101,102,01100110,107,01101011
2,00000010,106,01101010,108,01101100
64,01000000,58,00111010,122,01111010
11,00001011,62,00111110,73,01001001
15,00001111,33,00100001,48,00110000
21,00010101,99,01100011,120,01111000
90,01011010,107,01101011,197,11000101
83,01010011,127,01111111,210,11010010
62,00111110,69,01000101,131,10000011
114,01110010,5,00000101,119,01110111
21,00010101,99,01100011,120,01111000
88,01011000,83,01010011,171,10101011
45,00101101,28,00011100,73,01001001
51,00110011,63,00111111,114,01110010
96,01100000,88,01011000,184,10111000
0,00000000,90,01011010,90,01011010
125,01111101,108,01101100,233,11101001
58,00111010,29,00011101,87,01010111
10,00001010,59,00111011,69,01000101
14,00001110,31,00011111,45,00101101
126,01111110,23,00010111,149,10010101
71,01000111,28,00011100,99,01100011
126,01111110,52,00110100,178,10110010
108,01101100,69,01000101,177,10110001
84,01010100,87,01010111,171,10101011
118,01110110,90,01011010,208,11010000
24,00011000,32,00100000,56,00111000
10,00001010,1,00000001,11,00001011
69,01000101,50,00110010,119,01110111
125,01111101,87,01010111,212,11010100
83,01010011,81,01010001,164,10100100
108,01101100,37,00100101,145,10010001
63,00111111,20,00010100,83,01010011
32,00100000,101,01100101,133,10000101
110,01101110,35,00100011,145,10010001
65,01000001,1,00000001,66,01000010
124,01111100,86,01010110,210,11010010
17,00010001,7,00000111,24,00011000
10,00001010,124,01111100,134,10000110
3,00000011,61,00111101,64,01000000
103,01100111,32,00100000,135,10000111
65,01000001,11,00001011,76,01001100
23,00010111,120,01111000,143,10001111
43,00101011,45,00101101,88,01011000
47,00101111,48,00110000,95,01011111
71,01000111,67,01000011,138,10001010
76,01001100,82,01010010,158,10011110
57,00111001,18,00010010,75,01001011
96,01100000,0,00000000,96,01100000
68,01000100,84,01010100,152,10011000
108,01101100,56,00111000,164,10100100
118,01110110,73,01001001,191,10111111
100,01100100,23,00010111,123,01111011
29,00011101,45,00101101,74,01001010
92,01011100,104,01101000,196,11000100
58,00111010,44,00101100,102,01100110
28,00011100,1,00000001,29,00011101
77,01001101,101,01100101,178,10110010
84,01010100,6,00000110,90,01011010
43,00101011,43,00101011,86,01010110
47,00101111,36,00100100,83,01010011
107,01101011,79,01001111,186,10111010
24,00011000,92,01011100,116,01110100
59,00111011,92,01011100,151,10010111
55,00110111,39,00100111,94,01011110
70,01000110,80,01010000,150,10010110
57,00111001,87,01010111,144,10010000
57,00111001,94,01011110,151,10010111
0,00000000,106,01101010,106,01101010
48,00110000,74,01001010,122,01111010
33,00100001,85,01010101,118,01110110
14,00001110,55,00110111,69,01000101
40,00101000,53,00110101,93,01011101
81,01010001,108,01101100,189,10111101
54,00110110,114,01110010,168,10101000
43,00101011,115,01110011,158,10011110
20,00010100,20,00010100,40,00101000
89,01011001,23,00010111,112,01110000
19,00010011,113,01110001,132,10000100
72,01001000,73,01001001,145,10010001
90,01011010,89,01011001,179,10110011
8,00001000,3,00000011,11,00001011
93,01011101,82,01010010,175,10101111
98,01100010,32,00100000,130,10000010
18,00010010,21,00010101,39,00100111
17,00010001,109,01101101,126,01111110
85,01010101,75,01001011,160,10100000
39,00100111,106,01101010,145,10010001
21,00010101,70,01000110,91,01011011
124,01111100,31,00011111,155,10011011
115,01110011,63,00111111,178,10110010
36,00100100,102,01100110,138,10001010
119,01110111,60,00111100,179,10110011
106,01101010,44,00101100,150,10010110
3,00000011,33,00100001,36,00100100
9,00001001,35,00100011,44,00101100
21,00010101,82,01010010,103,01100111
121,01111001,39,00100111,160,10100000
33,00100001,11,00001011,44,00101100
20,00010100,13,00001101,33,00100001
21,00010101,59,00111011,80,01010000
10,00001010,51,00110011,61,00111101
119,01110111,65,01000001,184,10111000
78,01001110,23,00010111,101,01100101
115,01110011,93,01011101,208,11010000
63,00111111,60,00111100,123,01111011
80,01010000,3,00000011,83,01010011
48,00110000,108,01101100,156,10011100
28,00011100,57,00111001,85,01010101
9,00001001,16,00010000,25,00011001
121,01111001,97,01100001,218,11011010
18,00010010,30,00011110,48,00110000
123,01111011,26,00011010,149,10010101
31,00011111,57,00111001,88,01011000
14,00001110,59,00111011,73,01001001
66,01000010,91,01011011,157,10011101
58,00111010,36,00100100,94,01011110
126,01111110,62,00111110,188,10111100
38,00100110,70,01000110,108,01101100
79,01001111,67,01000011,146,10010010
116,01110100,97,01100001,213,11010101
33,00100001,115,01110011,148,10010100
99,01100011,91,01011011,190,10111110
33,00100001,47,00101111,80,01010000
63,00111111,99,01100011,162,10100010
18,00010010,17,00010001,35,00100011
97,01100001,113,01110001,210,11010010
40,00101000,17,00010001,57,00111001
68,01000100,105,01101001,173,10101101
27,00011011,84,01010100,111,01101111
77,01001101,14,00001110,91,01011011
31,00011111,58,00111010,89,01011001
75,01001011,124,01111100,199,11000111
112,01110000,82,01010010,194,11000010
21,00010101,87,01010111,108,01101100
20,00010100,80,01010000,100,01100100
107,01101011,51,00110011,158,10011110
68,01000100,69,01000101,137,10001001
3,00000011,57,00111001,60,00111100
124,01111100,72,01001000,196,11000100
29,00011101,113,01110001,142,10001110
97,01100001,53,00110101,150,10010110
62,00111110,28,00011100,90,01011010
19,00010011,64,01000000,83,01010011
44,00101100,82,01010010,126,01111110
117,01110101,28,00011100,145,10010001
98,01100010,39,00100111,137,10001001
106,01101010,89,01011001,195,11000011
6,00000110,125,01111101,131,10000011
75,01001011,4,00000100,79,01001111
116,01110100,71,01000111,187,10111011
58,00111010,96,01100000,154,10011010
68,01000100,109,01101101,177,10110001
74,01001010,76,01001100,150,10010110
118,01110110,28,00011100,146,10010010
17,00010001,52,00110100,69,01000101
109,01101101,10,00001010,119,01110111
45,00101101,109,01101101,154,10011010
85,01010101,66,01000010,151,10010111
127,01111111,99,01100011,226,11100010
32,00100000,111,01101111,143,10001111
51,00110011,65,01000001,116,01110100
117,01110101,107,01101011,224,11100000
107,01101011,6,00000110,113,01110001
91,01011011,87,01010111,178,10110010
55,00110111,91,01011011,146,10010010
120,01111000,16,00010000,136,10001000
56,00111000,125,01111101,181,10110101
22,00010110,26,00011010,48,00110000
44,00101100,119,01110111,163,10100011
52,00110100,78,01001110,130,10000010
82,01010010,16,00010000,98,01100010
72,01001000,17,00010001,89,01011001
28,00011100,35,00100011,63,00111111
26,00011010,44,00101100,70,01000110
72,01001000,98,01100010,170,10101010
125,01111101,46,00101110,171,10101011
98,01100010,98,01100010,196,11000100
32,00100000,83,01010011,115,01110011
63,00111111,105,01101001,168,10101000
108,01101100,49,00110001,157,10011101
44,00101100,24,00011000,68,01000100
65,01000001,116,01110100,181,10110101
98,01100010,31,00011111,129,10000001
35,00100011,81,01010001,116,01110100
70,01000110,62,00111110,132,10000100
39,00100111,1,00000001,40,00101000
73,01001001,15,00001111,88,01011000
98,01100010,47,00101111,145,10010001
82,01010010,32,00100000,114,01110010
118,01110110,98,01100010,216,11011000
119,01110111,121,01111001,240,11110000
29,00011101,96,01100000,125,01111101
28,00011100,10,00001010,38,00100110
87,01010111,57,00111001,144,10010000
127,01111111,31,00011111,158,10011110
71,01000111,47,00101111,118,01110110
87,01010111,32,00100000,119,01110111
24,00011000,121,01111001,145,10010001
36,00100100,41,00101001,77,01001101
109,01101101,55,00110111,164,10100100
55,00110111,69,01000101,124,01111100
93,01011101,115,01110011,208,11010000
106,01101010,124,01111100,230,11100110
83,01010011,22,00010110,105,01101001
25,00011001,126,01111110,151,10010111
11,00001011,58,00111010,69,01000101
66,01000010,79,01001111,145,10010001
32,00100000,15,00001111,47,00101111
52,00110100,110,01101110,162,10100010
127,01111111,115,01110011,242,11110010
96,01100000,66,01000010,162,10100010
15,00001111,86,01010110,101,01100101
15,00001111,108,01101100,123,01111011
102,01100110,126,01111110,228,11100100
102,01100110,84,01010100,186,10111010
28,00011100,108,01101100,136,10001000
7,00000111,66,01000010,73,01001001
15,00001111,38,00100110,53,00110101
69,01000101,38,00100110,107,01101011
114,01110010,87,01010111,201,11001001
41,00101001,21,00010101,62,00111110
10,00001010,114,01110010,124,01111100
22,00010110,71,01000111,93,01011101
25,00011001,122,01111010,147,10010011
103,01100111,62,00111110,165,10100101
120,01111000,9,00001001,129,10000001
100,01100100,49,00110001,149,10010101
104,01101000,40,00101000,144,10010000
41,00101001,21,00010101,62,00111110
56,00111000,57,00111001,113,01110001
53,00110101,17,00010001,70,01000110
121,01111001,11,00001011,132,10000100
119,01110111,93,01011101,212,11010100
122,01111010,105,01101001,227,11100011
122,01111010,33,00100001,155,10011011
21,00010101,31,00011111,52,00110100
13,00001101,115,01110011,128,10000000
61,00111101,67,01000011,128,10000000
121,01111001,110,01101110,231,11100111
82,01010010,61,00111101,143,10001111
34,00100010,61,00111101,95,01011111
81,01010001,95,01011111,176,10110000
35,00100011,14,00001110,49,00110001
24,00011000,98,01100010,122,01111010
122,01111010,44,00101100,166,10100110
74,01001010,86,01010110,160,10100000
81,01010001,58,00111010,139,10001011
57,00111001,119,01110111,176,10110000
51,00110011,118,01110110,169,10101001
42,00101010,109,01101101,151,10010111
25,00011001,12,00001100,37,00100101
89,01011001,25,00011001,114,01110010
61,00111101,96,01100000,157,10011101
116,01110100,118,01110110,234,11101010
7,00000111,28,00011100,35,00100011
76,01001100,64,01000000,140,10001100
43,00101011,90,01011010,133,10000101
115,01110011,91,01011011,206,11001110
118,01110110,21,00010101,139,10001011
51,00110011,111,01101111,162,10100010
104,01101000,77,01001101,181,10110101
73,01001001,77,01001101,150,10010110
127,01111111,59,00111011,186,10111010
51,00110011,80,01010000,131,10000011
107,01101011,121,01111001,228,11100100
40,00101000,39,00100111,79,01001111
116,01110100,125,01111101,241,11110001
127,01111111,21,00010101,148,10010100
1,00000001,82,01010010,83,01010011
41,00101001,121,01111001,162,10100010
68,01000100,47,00101111,115,01110011
6,00000110,49,00110001,55,00110111
102,01100110,98,01100010,200,11001000
101,01100101,101,01100101,202,11001010
51,00110011,65,01000001,116,01110100
127,01111111,60,00111100,187,10111011
100,01100100,61,00111101,161,10100001
57,00111001,92,01011100,149,10010101
119,01110111,66,01000010,185,10111001
99,01100011,74,01001010,173,10101101
61,00111101,29,00011101,90,01011010
47,00101111,8,00001000,55,00110111
125,01111101,54,00110110,179,10110011
99,01100011,62,00111110,161,10100001
107,01101011,63,00111111,170,10101010
56,00111000,94,01011110,150,10010110
120,01111000,8,00001000,128,10000000
71,01000111,68,01000100,139,10001011
52,00110100,15,00001111,67,01000011
87,01010111,6,00000110,93,01011101
10,00001010,98,01100010,108,01101100
13,00001101,106,01101010,119,01110111
50,00110010,78,01001110,128,10000000
9,00001001,95,01011111,104,01101000
72,01001000,62,00111110,134,10000110
101,01100101,15,00001111,116,01110100
123,01111011,119,01110111,242,11110010
56,00111000,117,01110101,173,10101101
98,01100010,124,01111100,222,11011110
124,01111100,24,00011000,148,10010100
50,00110010,45,00101101,95,01011111
10,00001010,18,00010010,28,00011100
93,01011101,127,01111111,220,11011100
48,00110000,107,01101011,155,10011011
107,01101011,8,00001000,115,01110011
118,01110110,88,01011000,206,11001110
108,01101100,110,01101110,218,11011010
90,01011010,4,00000100,94,01011110
2,00000010,95,01011111,97,01100001
123,01111011,117,01110101,240,11110000
96,01100000,45,00101101,141,10001101
110,01101110,6,00000110,116,01110100
6,00000110,15,00001111,21,00010101
5,00000101,71,01000111,76,01001100
62,00111110,116,01110100,178,10110010
83,01010011,83,01010011,166,10100110
12,00001100,49,00110001,61,00111101
110,01101110,94,01011110,204,11001100
2,00000010,116,01110100,118,01110110
68,01000100,8,00001000,76,01001100
83,01010011,16,00010000,99,01100011
98,01100010,57,00111001,155,10011011
89,01011001,108,01101100,197,11000101
22,00010110,79,01001111,101,01100101
28,00011100,44,00101100,72,01001000
49,00110001,91,01011011,140,10001100
8,00001000,33,00100001,41,00101001
1,00000001,62,00111110,63,00111111
126,01111110,28,00011100,154,10011010
22,00010110,91,01011011,113,01110001
63,00111111,90,01011010,153,10011001
63,00111111,37,00100101,100,01100100
85,01010101,121,01111001,206,11001110
59,00111011,18,00010010,77,01001101
68,01000100,70,01000110,138,10001010
16,00010000,49,00110001,65,01000001
67,01000011,10,00001010,77,01001101
79,01001111,121,01111001,200,11001000
39,00100111,54,00110110,93,01011101
30,00011110,120,01111000,150,10010110
76,01001100,41,00101001,117,01110101
61,00111101,98,01100010,159,10011111
36,00100100,78,01001110,114,01110010
101,01100101,117,01110101,218,11011010
31,00011111,72,01001000,103,01100111
112,01110000,75,01001011,187,10111011
35,00100011,79,01001111,114,01110010
16,00010000,8,00001000,24,00011000
15,00001111,87,01010111,102,01100110
55,00110111,52,00110100,107,01101011
59,00111011,112,01110000,171,10101011
25,00011001,44,00101100,69,01000101
83,01010011,82,01010010,165,10100101
23,00010111,29,00011101,52,00110100
59,00111011,120,01111000,179,10110011
71,01000111,19,00010011,90,01011010
69,01000101,5,00000101,74,01001010
42,00101010,44,00101100,86,01010110
2,00000010,43,00101011,45,00101101
111,01101111,15,00001111,126,01111110
101,01100101,53,00110101,154,10011010
125,01111101,8,00001000,133,10000101
56,00111000,84,01010100,140,10001100
76,01001100,64,01000000,140,10001100
85,01010101,115,01110011,200,11001000
96,01100000,118,01110110,214,11010110
2,00000010,5,00000101,7,00000111
117,01110101,31,00011111,148,10010100
114,01110010,76,01001100,190,10111110
87,01010111,13,00001101,100,01100100
88,01011000,73,01001001,161,10100001
53,00110101,47,00101111,100,01100100
11,00001011,56,00111000,67,01000011
121,01111001,86,01010110,207,11001111
30,00011110,74,01001010,104,01101000
35,00100011,86,01010110,121,01111001
108,01101100,106,01101010,214,11010110
20,00010100,51,00110011,71,01000111
63,00111111,126,01111110,189,10111101
32,00100000,60,00111100,92,01011100
90,01011010,26,00011010,116,01110100
45,00101101,72,01001000,117,01110101
124,01111100,80,01010000,204,11001100
14,00001110,69,01000101,83,01010011
45,00101101,73,01001001,118,01110110
14,00001110,91,01011011,105,01101001
83,01010011,46,00101110,129,10000001
50,00110010,94,01011110,144,10010000
73,01001001,35,00100011,108,01101100
9,00001001,75,01001011,84,01010100
102,01100110,113,01110001,215,11010111
79,01001111,57,00111001,136,10001000
44,00101100,42,00101010,86,01010110
78,01001110,13,00001101,91,01011011
123,01111011,63,00111111,186,10111010
89,01011001,86,01010110,175,10101111
84,01010100,90,01011010,174,10101110
94,01011110,31,00011111,125,01111101
53,00110101,47,00101111,100,01100100
96,01100000,114,01110010,210,11010010
7,00000111,43,00101011,50,00110010
91,01011011,34,00100010,125,01111101
73,01001001,93,01011101,166,10100110
19,00010011,62,00111110,81,01010001
25,00011001,29,00011101,54,00110110
52,00110100,44,00101100,96,01100000
53,00110101,43,00101011,96,01100000
18,00010010,25,00011001,43,00101011
125,01111101,95,01011111,220,11011100
103,01100111,21,00010101,124,01111100
66,01000010,25,00011001,91,01011011
65,01000001,98,01100010,163,10100011
84,01010100,107,01101011,191,10111111
109,01101101,70,01000110,179,10110011
82,01010010,126,01111110,208,11010000
15,00001111,88,01011000,103,01100111
121,01111001,58,00111010,179,10110011
58,00111010,52,00110100,110,01101110
123,01111011,94,01011110,217,11011001
1,00000001,74,01001010,75,01001011
103,01100111,127,01111111,230,11100110
13,00001101,29,00011101,42,00101010
44,00101100,23,00010111,67,01000011
116,01110100,69,01000101,185,10111001
66,01000010,82,01010010,148,10010100
96,01100000,89,01011001,185,10111001
69,01000101,15,00001111,84,01010100
102,01100110,38,00100110,140,10001100
51,00110011,16,00010000,67,01000011
73,01001001,31,00011111,104,01101000
106,01101010,109,01101101,215,11010111
87,01010111,72,01001000,159,10011111
99,01100011,24,00011000,123,01111011
63,00111111,93,01011101,156,10011100
9,00001001,3,00000011,12,00001100
10,00001010,114,01110010,124,01111100
75,01001011,74,01001010,149,10010101
37,00100101,113,01110001,150,10010110
17,00010001,94,01011110,111,01101111
95,01011111,97,01100001,192,11000000
102,01100110,94,01011110,196,11000100
106,01101010,88,01011000,194,11000010
66,01000010,68,01000100,134,10000110
86,01010110,104,01101000,190,10111110
126,01111110,82,01010010,208,11010000
35,00100011,29,00011101,64,01000000
57,00111001,34,00100010,91,01011011
84,01010100,111,01101111,195,11000011
98,01100010,125,01111101,223,11011111
86,01010110,16,00010000,102,01100110
103,01100111,57,00111001,160,10100000
50,00110010,38,00100110,88,01011000
98,01100010,55,00110111,153,10011001
26,00011010,98,01100010,124,01111100
96,01100000,119,01110111,215,11010111
25,00011001,32,00100000,57,00111001
112,01110000,44,00101100,156,10011100
108,01101100,0,00000000,108,01101100
89,01011001,86,01010110,175,10101111
48,00110000,29,00011101,77,01001101
36,00100100,91,01011011,127,01111111
28,00011100,16,00010000,44,00101100
8,00001000,80,01010000,88,01011000
34,00100010,100,01100100,134,10000110
46,00101110,32,00100000,78,01001110
60,00111100,86,01010110,146,10010010
21,00010101,43,00101011,64,01000000
96,01100000,42,00101010,138,10001010
95,01011111,119,01110111,214,11010110
102,01100110,109,01101101,211,11010011
65,01000001,46,00101110,111,01101111
66,01000010,27,00011011,93,01011101
73,01001001,49,00110001,122,01111010
92,01011100,21,00010101,113,01110001
123,01111011,100,01100100,223,11011111
18,00010010,102,01100110,120,01111000
102,01100110,76,01001100,178,10110010
81,01010001,34,00100010,115,01110011
100,01100100,99,01100011,199,11000111
50,00110010,118,01110110,168,10101000
24,00011000,112,01110000,136,10001000
28,00011100,104,01101000,132,10000100
24,00011000,98,01100010,122,01111010
103,01100111,28,00011100,131,10000011
94,01011110,23,00010111,117,01110101
112,01110000,69,01000101,181,10110101
69,01000101,33,00100001,102,01100110
34,00100010,99,01100011,133,10000101
49,00110001,118,01110110,167,10100111
52,00110100,52,00110100,104,01101000
63,00111111,83,01010011,146,10010010
116,01110100,45,00101101,161,10100001
124,01111100,20,00010100,144,10010000
88,01011000,124,01111100,212,11010100
43,00101011,51,00110011,94,01011110
91,01011011,103,01100111,194,11000010
77,01001101,20,00010100,97,01100001
52,00110100,52,00110100,104,01101000
110,01101110,38,00100110,148,10010100
106,01101010,106,01101010,212,11010100
6,00000110,58,00111010,64,01000000
88,01011000,16,00010000,104,01101000
71,01000111,18,00010010,89,01011001
115,01110011,114,01110010,229,11100101
125,01111101,23,00010111,148,10010100
18,00010010,126,01111110,144,10010000
60,00111100,38,00100110,98,01100010
53,00110101,48,00110000,101,01100101
50,00110010,29,00011101,79,01001111
44,00101100,113,01110001,157,10011101
92,01011100,22,00010110,114,01110010
1,00000001,57,00111001,58,00111010
22,00010110,82,01010010,104,01101000
77,01001101,126,01111110,203,11001011
62,00111110,125,01111101,187,10111011
47,00101111,91,01011011,138,10001010
104,01101000,112,01110000,216,11011000
85,01010101,66,01000010,151,10010111
83,01010011,41,00101001,124,01111100
51,00110011,116,01110100,167,10100111
41,00101001,7,00000111,48,00110000
68,01000100,66,01000010,134,10000110
99,01100011,63,00111111,162,10100010
13,00001101,120,01111000,133,10000101
108,01101100,113,01110001,221,11011101
28,00011100,38,00100110,66,01000010
4,00000100,38,00100110,42,00101010
61,00111101,11,00001011,72,01001000
6,00000110,79,01001111,85,01010101
64,01000000,91,01011011,155,10011011
34,00100010,111,01101111,145,10010001
98,01100010,65,01000001,163,10100011
21,00010101,25,00011001,46,00101110
69,01000101,104,01101000,173,10101101
23,00010111,82,01010010,105,01101001
27,00011011,38,00100110,65,01000001
51,00110011,12,00001100,63,00111111
21,00010101,97,01100001,118,01110110
45,00101101,8,00001000,53,00110101
1,00000001,28,00011100,29,00011101
51,00110011,46,00101110,97,01100001
95,01011111,5,00000101,100,01100100
95,01011111,102,01100110,197,11000101
17,00010001,119,01110111,136,10001000
45,00101101,34,00100010,79,01001111
61,00111101,91,01011011,152,10011000
12,00001100,100,01100100,112,01110000
86,01010110,96,01100000,182,10110110
86,01010110,52,00110100,138,10001010
10,00001010,44,00101100,54,00110110
112,01110000,81,01010001,193,11000001
6,00000110,106,01101010,112,01110000
103,01100111,42,00101010,145,10010001
89,01011001,36,00100100,125,01111101
97,01100001,48,00110000,145,10010001
26,00011010,20,00010100,46,00101110
19,00010011,0,00000000,19,00010011
100,01100100,93,01011101,193,11000001
76,01001100,57,00111001,133,10000101
103,01100111,101,01100101,204,11001100
84,01010100,51,00110011,135,10000111
108,01101100,101,01100101,209,11010001
113,01110001,127,01111111,240,11110000
36,00100100,119,01110111,155,10011011
106,01101010,73,01001001,179,10110011
48,00110000,18,00010010,66,01000010
71,01000111,75,01001011,146,10010010
37,00100101,17,00010001,54,00110110
77,01001101,10,00001010,87,01010111
90,01011010,110,01101110,200,11001000
49,00110001,123,01111011,172,10101100
39,00100111,109,01101101,148,10010100
24,00011000,64,01000000,88,01011000
57,00111001,108,01101100,165,10100101
34,00100010,53,00110101,87,01010111
43,00101011,90,01011010,133,10000101
117,01110101,124,01111100,241,11110001
67,01000011,71,01000111,138,10001010
30,00011110,34,00100010,64,01000000
17,00010001,12,00001100,29,00011101
78,01001110,50,00110010,128,10000000
58,00111010,9,00001001,67,01000011
68,01000100,121,01111001,189,10111101
63,00111111,121,01111001,184,10111000
104,01101000,125,01111101,229,11100101
89,01011001,22,00010110,111,01101111
27,00011011,33,00100001,60,00111100
23,00010111,55,00110111,78,01001110
118,01110110,36,00100100,154,10011010
114,01110010,27,00011011,141,10001101
48,00110000,26,00011010,74,01001010
105,01101001,98,01100010,203,11001011
63,00111111,44,00101100,107,01101011
105,01101001,66,01000010,171,10101011
21,00010101,1,00000001,22,00010110
4,00000100,101,01100101,105,01101001
76,01001100,59,00111011,135,10000111
25,00011001,58,00111010,83,01010011
68,01000100,107,01101011,175,10101111
31,00011111,0,00000000,31,00011111
69,01000101,58,00111010,127,01111111
89,01011001,32,00100000,121,01111001
12,00001100,115,01110011,127,01111111
60,00111100,100,01100100,160,10100000
52,00110100,63,00111111,115,01110011
27,00011011,93,01011101,120,01111000
46,00101110,44,00101100,90,01011010
15,00001111,75,01001011,90,01011010
109,01101101,102,01100110,211,11010011
103,01100111,36,00100100,139,10001011
58,00111010,16,00010000,74,01001010
2,00000010,127,01111111,129,10000001
62,00111110,72,01001000,134,10000110
74,01001010,79,01001111,153,10011001
44,00101100,95,01011111,139,10001011
52,00110100,117,01110101,169,10101001
99,01100011,68,01000100,167,10100111
120,01111000,22,00010110,142,10001110
114,01110010,56,00111000,170,10101010
104,01101000,118,01110110,222,11011110
25,00011001,80,01010000,105,01101001
67,01000011,92,01011100,159,10011111
27,00011011,31,00011111,58,00111010
17,00010001,1,00000001,18,00010010
86,01010110,95,01011111,181,10110101
41,00101001,45,00101101,86,01010110
108,01101100,39,00100111,147,10010011
95,01011111,55,00110111,150,10010110
89,01011001,88,01011000,177,10110001
29,00011101,13,00001101,42,00101010
114,01110010,118,01110110,232,11101000
48,00110000,66,01000010,114,01110010
20,00010100,33,00100001,53,00110101
48,00110000,43,00101011,91,01011011
6,00000110,44,00101100,50,00110010
76,01001100,0,00000000,76,01001100
26,00011010,24,00011000,50,00110010
100,01100100,68,01000100,168,10101000
53,00110101,11,00001011,64,01000000
1,00000001,2,00000010,3,00000011
67,01000011,2,00000010,69,01000101
37,00100101,81,01010001,118,01110110
28,00011100,30,00011110,58,00111010
24,00011000,65,01000001,89,01011001
67,01000011,102,01100110,169,10101001
82,01010010,102,01100110,184,10111000
33,00100001,79,01001111,112,01110000
90,01011010,8,00001000,98,01100010
65,01000001,24,00011000,89,01011001
71,01000111,118,01110110,189,10111101
78,01001110,38,00100110,116,01110100
107,01101011,42,00101010,149,10010101
127,01111111,54,00110110,181,10110101
115,01110011,7,00000111,122,01111010
73,01001001,113,01110001,186,10111010
7,00000111,66,01000010,73,01001001
116,01110100,67,01000011,183,10110111
5,00000101,7,00000111,12,00001100
70,01000110,15,00001111,85,01010101
38,00100110,46,00101110,84,01010100
64,01000000,23,00010111,87,01010111
81,01010001,107,01101011,188,10111100
16,00010000,103,01100111,119,01110111
119,01110111,122,01111010,241,11110001
121,01111001,124,01111100,245,11110101
104,01101000,93,01011101,197,11000101
78,01001110,107,01101011,185,10111001
66,01000010,63,00111111,129,10000001
7,00000111,119,01110111,126,01111110
16,00010000,112,01110000,128,10000000
4,00000100,13,00001101,17,00010001
41,00101001,118,01110110,159,10011111
89,01011001,8,00001000,97,01100001
90,01011010,79,01001111,169,10101001
45,00101101,47,00101111,92,01011100
107,01101011,109,01101101,216,11011000
111,01101111,108,01101100,219,11011011
73,01001001,116,01110100,189,10111101
125,01111101,60,00111100,185,10111001
81,01010001,111,01101111,192,11000000
98,01100010,60,00111100,158,10011110
49,00110001,101,01100101,150,10010110
79,01001111,2,00000010,81,01010001
111,01101111,124,01111100,235,11101011
6,00000110,11,00001011,17,00010001
31,00011111,95,01011111,126,01111110
85,01010101,26,00011010,111,01101111
124,01111100,70,01000110,194,11000010
68,01000100,50,00110010,118,01110110
63,00111111,82,01010010,145,10010001
103,01100111,115,01110011,218,11011010
84,01010100,55,00110111,139,10001011
95,01011111,82,01010010,177,10110001
42,00101010,104,01101000,146,10010010
55,00110111,20,00010100,75,01001011
84,01010100,8,00001000,92,01011100
38,00100110,75,01001011,113,01110001
83,01010011,25,00011001,108,01101100
32,00100000,9,00001001,41,00101001
123,01111011,40,00101000,163,10100011
28,00011100,11,00001011,39,00100111
98,01100010,25,00011001,123,01111011
18,00010010,116,01110100,134,10000110
121,01111001,33,00100001,154,10011010
113,01110001,27,00011011,140,10001100
48,00110000,2,00000010,50,00110010
55,00110111,51,00110011,106,01101010
101,01100101,90,01011010,191,10111111
31,00011111,79,01001111,110,01101110
86,01010110,72,01001000,158,10011110
14,00001110,103,01100111,117,01110101
17,00010001,50,00110010,67,01000011
26,00011010,27,00011011,53,00110101
65,01000001,39,00100111,104,01101000
37,00100101,83,01010011,120,01111000
111,01101111,73,01001001,184,10111000
117,01110101,13,00001101,130,10000010
55,00110111,100,01100100,155,10011011
56,00111000,5,00000101,61,00111101
75,01001011,71,01000111,146,10010010
45,00101101,61,00111101,106,01101010
68,01000100,23,00010111,91,01011011
110,01101110,117,01110101,227,11100011
14,00001110,34,00100010,48,00110000
76,01001100,85,01010101,161,10100001
85,01010101,16,00010000,101,01100101
103,01100111,97,01100001,200,11001000
109,01101101,76,01001100,185,10111001
60,00111100,57,00111001,117,01110101
57,00111001,52,00110100,109,01101101
89,01011001,34,00100010,123,01111011
120,01111000,103,01100111,223,11011111
9,00001001,90,01011010,99,01100011
89,01011001,44,00101100,133,10000101
101,01100101,56,00111000,157,10011101
45,00101101,11,00001011,56,00111000
47,00101111,72,01001000,119,01110111
16,00010000,61,00111101,77,01001101
11,00001011,22,00010110,33,00100001
98,01100010,70,01000110,168,10101000
45,00101101,18,00010010,63,00111111
122,01111010,24,00011000,146,10010010
42,00101010,51,00110011,93,01011101
26,00011010,90,01011010,116,01110100
61,00111101,109,01101101,170,10101010
92,01011100,50,00110010,142,10001110
107,01101011,12,00001100,119,01110111
36,00100100,36,00100100,72,01001000
7,00000111,55,00110111,62,00111110
29,00011101,91,01011011,120,01111000
48,00110000,126,01111110,174,10101110
59,00111011,54,00110110,113,01110001
45,00101101,84,01010100,129,10000001
112,01110000,81,01010001,193,11000001
87,01010111,41,00101001,128,10000000
83,01010011,49,00110001,132,10000100
79,01001111,38,00100110,117,01110101
26,00011010,98,01100010,124,01111100
89,01011001,13,00001101,102,01100110
120,01111000,110,01101110,230,11100110
70,01000110,63,00111111,133,10000101
24,00011000,34,00100010,58,00111010
63,00111111,14,00001110,77,01001101
42,00101010,80,01010000,122,01111010
89,01011001,93,01011101,182,10110110
35,00100011,34,00100010,69,01000101
13,00001101,105,01101001,118,01110110
97,01100001,51,00110011,148,10010100
8,00001000,92,01011100,100,01100100
19,00010011,30,00011110,49,00110001
66,01000010,99,01100011,165,10100101
2,00000010,42,00101010,44,00101100
53,00110101,114,01110010,167,10100111
77,01001101,25,00011001,102,01100110
7,00000111,102,01100110,109,01101101
56,00111000,116,01110100,172,10101100
93,01011101,16,00010000,109,01101101
65,01000001,55,00110111,120,01111000
81,01010001,1,00000001,82,01010010
97,01100001,30,00011110,127,01111111
5,00000101,53,00110101,58,00111010
16,00010000,3,00000011,19,00010011
83,01010011,111,01101111,194,11000010
114,01110010,116,01110100,230,11100110
124,01111100,115,01110011,239,11101111
75,01001011,109,01101101,184,10111000
74,01001010,70,01000110,144,10010000
107,01101011,27,00011011,134,10000110
5,00000101,67,01000011,72,01001000
53,00110101,19,00010011,72,01001000
36,00100100,4,00000100,40,00101000
115,01110011,27,00011011,142,10001110
70,01000110,118,01110110,188,10111100
103,01100111,127,01111111,230,11100110
117,01110101,75,01001011,192,11000000
67,01000011,82,01010010,149,10010101
26,00011010,11,00001011,37,00100101
14,00001110,85,01010101,99,01100011
103,01100111,3,00000011,106,01101010
93,01011101,5,00000101,98,01100010
21,00010101,96,01100000,117,01110101
24,00011000,11,00001011,35,00100011
31,00011111,15,00001111,46,00101110
122,01111010,72,01001000,194,11000010
50,00110010,107,01101011,157,10011101
5,00000101,14,00001110,19,00010011
26,00011010,88,01011000,114,01110010
37,00100101,114,01110010,151,10010111
122,01111010,24,00011000,146,10010010
29,00011101,55,00110111,84,01010100
19,00010011,33,00100001,52,00110100
70,01000110,73,01001001,143,10001111
93,01011101,106,01101010,199,11000111
37,00100101,59,00111011,96,01100000
21,00010101,47,00101111,68,01000100
12,00001100,60,00111100,72,01001000
117,01110101,93,01011101,210,11010010
20,00010100,74,01001010,94,01011110
116,01110100,77,01001101,193,11000001
127,01111111,68,01000100,195,11000011
107,01101011,34,00100010,141,10001101
110,01101110,50,00110010,160,10100000
15,00001111,60,00111100,75,01001011
37,00100101,52,00110100,89,01011001
124,01111100,5,00000101,129,10000001
5,00000101,79,01001111,84,01010100
89,01011001,50,00110010,139,10001011
61,00111101,88,01011000,149,10010101
65,01000001,67,01000011,132,10000100
81,01010001,96,01100000,177,10110001
54,00110110,29,00011101,83,01010011
13,00001101,39,00100111,52,00110100
23,00010111,100,01100100,123,01111011
24,00011000,42,00101010,66,01000010
52,00110100,7,00000111,59,00111011
11,00001011,124,01111100,135,10000111
106,01101010,18,00010010,124,01111100
82,01010010,31,00011111,113,01110001
51,00110011,38,00100110,89,01011001
122,01111010,35,00100011,157,10011101
106,01101010,94,01011110,200,11001000
70,01000110,107,01101011,177,10110001
106,01101010,52,00110100,158,10011110
39,00100111,92,01011100,131,10000011
4,00000100,89,01011001,93,01011101
125,01111101,26,00011010,151,10010111
102,01100110,12,00001100,114,01110010
92,01011100,16,00010000,108,01101100
51,00110011,39,00100111,90,01011010
84,01010100,58,00111010,142,10001110
9,00001001,116,01110100,125,01111101
63,00111111,47,00101111,110,01101110
87,01010111,37,00100101,124,01111100
71,01000111,30,00011110,101,01100101
13,00001101,56,00111000,69,01000101
2,00000010,96,01100000,98,01100010
52,00110100,22,00010110,74,01001010
94,01011110,24,00011000,118,01110110
94,01011110,26,00011010,120,01111000
57,00111001,110,01101110,167,10100111
104,01101000,13,00001101,117,01110101
70,01000110,101,01100101,171,10101011
67,01000011,16,00010000,83,01010011
13,00001101,10,00001010,23,00010111
80,01010000,113,01110001,193,11000001
21,00010101,84,01010100,105,01101001
80,01010000,108,01101100,188,10111100
36,00100100,116,01110100,152,10011000
51,00110011,114,01110010,165,10100101
49,00110001,16,00010000,65,01000001
34,00100010,105,01101001,139,10001011
71,01000111,95,01011111,166,10100110
118,01110110,106,01101010,224,11100000
125,01111101,39,00100111,164,10100100
10,00001010,82,01010010,92,01011100
124,01111100,27,00011011,151,10010111
103,01100111,0,00000000,103,01100111
52,00110100,73,01001001,125,01111101
82,01010010,5,00000101,87,01010111
84,01010100,11,00001011,95,01011111
0,00000000,9,00001001,9,00001001
41,00101001,8,00001000,49,00110001
116,01110100,69,01000101,185,10111001
126,01111110,25,00011001,151,10010111
107,01101011,37,00100101,144,10010000
92,01011100,62,00111110,154,10011010
81,01010001,44,00101100,125,01111101
9,00001001,79,01001111,88,01011000
70,01000110,59,00111011,129,10000001
114,01110010,10,00001010,124,01111100
11,00001011,6,00000110,17,00010001
19,00010011,95,01011111,114,01110010
87,01010111,3,00000011,90,01011010
107,01101011,110,01101110,217,11011001
110,01101110,119,01110111,229,11100101
50,00110010,5,00000101,55,00110111
34,00100010,118,01110110,152,10011000
119,01110111,107,01101011,226,11100010
92,01011100,16,00010000,108,01101100
117,01110101,44,00101100,161,10100001
7,00000111,100,01100100,107,01101011
78,01001110,49,00110001,127,01111111
5,00000101,86,01010110,91,01011011
24,00011000,53,00110101,77,01001101
99,01100011,13,00001101,112,01110000
99,01100011,6,00000110,105,01101001
8,00001000,3,00000011,11,00001011
60,00111100,125,01111101,185,10111001
38,00100110,46,00101110,84,01010100
109,01101101,1,00000001,110,01101110
22,00010110,49,00110001,71,01000111
34,00100010,13,00001101,47,00101111
79,01001111,51,00110011,130,10000010
85,01010101,15,00001111,100,01100100
5,00000101,61,00111101,66,01000010
28,00011100,86,01010110,114,01110010
3,00000011,102,01100110,105,01101001
112,01110000,53,00110101,165,10100101
80,01010000,51,00110011,131,10000011
58,00111010,0,00000000,58,00111010
10,00001010,117,01110101,127,01111111
87,01010111,30,00011110,117,01110101
82,01010010,5,00000101,87,01010111
52,00110100,8,00001000,60,00111100
14,00001110,28,00011100,42,00101010
14,00001110,57,00111001,71,01000111
20,00010100,13,00001101,33,00100001
14,00001110,69,01000101,83,01010011
97,01100001,39,00100111,136,10001000
113,01110001,21,00010101,134,10000110
35,00100011,22,00010110,57,00111001
97,01100001,112,01110000,209,11010001
39,00100111,105,01101001,144,10010000
122,01111010,0,00000000,122,01111010
111,01101111,35,00100011,146,10010010
1,00000001,81,01010001,82,01010010
6,00000110,49,00110001,55,00110111
114,01110010,70,01000110,184,10111000
34,00100010,18,00010010,52,00110100
36,00100100,80,01010000,116,01110100
29,00011101,8,00001000,37,00100101
104,01101000,43,00101011,147,10010011
32,00100000,34,00100010,66,01000010
17,00010001,59,00111011,76,01001100
125,01111101,112,01110000,237,11101101
69,01000101,9,00001001,78,01001110
10,00001010,44,00101100,54,00110110
105,01101001,105,01101001,210,11010010
80,01010000,115,01110011,195,11000011
88,01011000,24,00011000,112,01110000
86,01010110,68,01000100,154,10011010
6,00000110,20,00010100,26,00011010
64,01000000,48,00110000,112,01110000
110,01101110,54,00110110,164,10100100
75,01001011,103,01100111,178,10110010
13,00001101,95,01011111,108,01101100
17,00010001,71,01000111,88,01011000
63,00111111,59,00111011,122,01111010
74,01001010,60,00111100,134,10000110
111,01101111,2,00000010,113,01110001
98,01100010,83,01010011,181,10110101
14,00001110,82,01010010,96,01100000
29,00011101,63,00111111,92,01011100
125,01111101,32,00100000,157,10011101
74,01001010,88,01011000,162,10100010
37,00100101,88,01011000,125,01111101
50,00110010,36,00100100,86,01010110
86,01010110,117,01110101,203,11001011
22,00010110,17,00010001,39,00100111
113,01110001,81,01010001,194,11000010
59,00111011,10,00001010,69,01000101
26,00011010,28,00011100,54,00110110
15,00001111,50,00110010,65,01000001
74,01001010,16,00010000,90,01011010
116,01110100,64,01000000,180,10110100
86,01010110,46,00101110,132,10000100
95,01011111,30,00011110,125,01111101
46,00101110,7,00000111,53,00110101
126,01111110,80,01010000,206,11001110
23,00010111,74,01001010,97,01100001
121,01111001,64,01000000,185,10111001
127,01111111,103,01100111,230,11100110
3,00000011,102,01100110,105,01101001
6,00000110,8,00001000,14,00001110
65,01000001,86,01010110,151,10010111
64,01000000,7,00000111,71,01000111
39,00100111,13,00001101,52,00110100
28,00011100,105,01101001,133,10000101
126,01111110,81,01010001,207,11001111
94,01011110,3,00000011,97,01100001
66,01000010,19,00010011,85,01010101
68,01000100,99,01100011,167,10100111
44,00101100,73,01001001,117,01110101
23,00010111,95,01011111,118,01110110
2,00000010,75,01001011,77,01001101
66,01000010,22,00010110,88,01011000
65,01000001,69,01000101,134,10000110
53,00110101,26,00011010,79,01001111
40,00101000,6,00000110,46,00101110
13,00001101,52,00110100,65,01000001
53,00110101,109,01101101,162,10100010
5,00000101,58,00111010,63,00111111
38,00100110,73,01001001,111,01101111
69,01000101,86,01010110,155,10011011
26,00011010,46,00101110,72,01001000
7,00000111,30,00011110,37,00100101
102,01100110,119,01110111,221,11011101
6,00000110,39,00100111,45,00101101
20,00010100,114,01110010,134,10000110
48,00110000,90,01011010,138,10001010
65,01000001,36,00100100,101,01100101
4,00000100,29,00011101,33,00100001
123,01111011,87,01010111,210,11010010
97,01100001,95,01011111,192,11000000
82,01010010,19,00010011,101,01100101
3,00000011,49,00110001,52,00110100
67,01000011,12,00001100,79,01001111
41,00101001,75,01001011,116,01110100
32,00100000,51,00110011,83,01010011
21,00010101,96,01100000,117,01110101
8,00001000,95,01011111,103,01100111
92,01011100,64,01000000,156,10011100
4,00000100,27,00011011,31,00011111
46,00101110,11,00001011,57,00111001
89,01011001,83,01010011,172,10101100
8,00001000,104,01101000,112,01110000
3,00000011,84,01010100,87,01010111
9,00001001,86,01010110,95,01011111
35,00100011,5,00000101,40,00101000
85,01010101,96,01100000,181,10110101
60,00111100,19,00010011,79,01001111
90,01011010,20,00010100,110,01101110
46,00101110,84,01010100,130,10000010
63,00111111,15,00001111,78,01001110
88,01011000,21,00010101,109,01101101
84,01010100,102,01100110,186,10111010
77,01001101,121,01111001,198,11000110
78,01001110,83,01010011,161,10100001
7,00000111,25,00011001,32,00100000
70,01000110,40,00101000,110,01101110
81,01010001,47,00101111,128,10000000
55,00110111,122,01111010,177,10110001
79,01001111,27,00011011,106,01101010
81,01010001,69,01000101,150,10010110
8,00001000,80,01010000,88,01011000
82,01010010,39,00100111,121,01111001
67,01000011,8,00001000,75,01001011
14,00001110,124,01111100,138,10001010
66,01000010,88,01011000,154,10011010
45,00101101,62,00111110,107,01101011
71,01000111,127,01111111,198,11000110
11,00001011,100,01100100,111,01101111
85,01010101,38,00100110,123,01111011
104,01101000,4,00000100,108,01101100
40,00101000,109,01101101,149,10010101
102,01100110,52,00110100,154,10011010
39,00100111,35,00100011,74,01001010
18,00010010,99,01100011,117,01110101
44,00101100,50,00110010,94,01011110
94,01011110,86,01010110,180,10110100
31,00011111,23,00010111,54,00110110
4,00000100,16,00010000,20,00010100
20,00010100,110,01101110,130,10000010
4,00000100,109,01101101,113,01110001
78,01001110,0,00000000,78,01001110
22,00010110,53,00110101,75,01001011
30,00011110,67,01000011,97,01100001
74,01001010,48,00110000,122,01111010
113,01110001,85,01010101,198,11000110
98,01100010,16,00010000,114,01110010
55,00110111,11,00001011,66,01000010
106,01101010,8,00001000,114,01110010
120,01111000,62,00111110,182,10110110
87,01010111,9,00001001,96,01100000
95,01011111,82,01010010,177,10110001
71,01000111,40,00101000,111,01101111
4,00000100,105,01101001,109,01101101
68,01000100,127,01111111,195,11000011
3,00000011,5,00000101,8,00001000
43,00101011,88,01011000,131,10000011
84,01010100,90,01011010,174,10101110
20,00010100,81,01010001,101,01100101
69,01000101,71,01000111,140,10001100
4,00000100,100,01100100,104,01101000
34,00100010,118,01110110,152,10011000
101,01100101,100,01100100,201,11001001
1,00000001,1,00000001,2,00000010
118,01110110,39,00100111,157,10011101
115,01110011,52,00110100,167,10100111
82,01010010,115,01110011,197,11000101
120,01111000,84,01010100,204,11001100
86,01010110,29,00011101,115,01110011
74,01001010,19,00010011,93,01011101
39,00100111,68,01000100,107,01101011
40,00101000,62,00111110,102,01100110
88,01011000,16,00010000,104,01101000
106,01101010,75,01001011,181,10110101
16,00010000,26,00011010,42,00101010
34,00100010,101,01100101,135,10000111
94,01011110,24,00011000,118,01110110
126,01111110,17,00010001,143,10001111
127,01111111,21,00010101,148,10010100
32,00100000,83,01010011,115,01110011
1,00000001,18,00010010,19,00010011
109,01101101,61,00111101,170,10101010
52,00110100,66,01000010,118,01110110
44,00101100,125,01111101,169,10101001
3,00000011,16,00010000,19,00010011
41,00101001,55,00110111,96,01100000
100,01100100,19,00010011,119,01110111
45,00101101,27,00011011,72,01001000
23,00010111,92,01011100,115,01110011
91,01011011,53,00110101,144,10010000
12,00001100,55,00110111,67,01000011
83,01010011,5,00000101,88,01011000
31,00011111,12,00001100,43,00101011
1,00000001,117,01110101,118,01110110
81,01010001,58,00111010,139,10001011
15,00001111,94,01011110,109,01101101
33,00100001,36,00100100,69,01000101
125,01111101,10,00001010,135,10000111
23,00010111,84,01010100,107,01101011
82,01010010,89,01011001,171,10101011
54,00110110,25,00011001,79,01001111
37,00100101,60,00111100,97,01100001
112,01110000,15,00001111,127,01111111
76,01001100,27,00011011,103,01100111
101,01100101,68,01000100,169,10101001
106,01101010,17,00010001,123,01111011
105,01101001,41,00101001,146,10010010
79,01001111,44,00101100,123,01111011
94,01011110,124,01111100,218,11011010
50,00110010,94,01011110,144,10010000
44,00101100,12,00001100,56,00111000
79,01001111,81,01010001,160,10100000
89,01011001,93,01011101,182,10110110
65,01000001,105,01101001,170,10101010
30,00011110,56,00111000,86,01010110
105,01101001,54,00110110,159,10011111
111,01101111,73,01001001,184,10111000
15,00001111,44,00101100,59,00111011
72,01001000,39,00100111,111,01101111
61,00111101,13,00001101,74,01001010
5,00000101,112,01110000,117,01110101
99,01100011,34,00100010,133,10000101
120,01111000,41,00101001,161,10100001
95,01011111,61,00111101,156,10011100
109,01101101,37,00100101,146,10010010
85,01010101,118,01110110,203,11001011
125,01111101,72,01001000,197,11000101
117,01110101,21,00010101,138,10001010
10,00001010,101,01100101,111,01101111
122,01111010,53,00110101,175,10101111
67,01000011,86,01010110,153,10011001
19,00010011,15,00001111,34,00100010
24,00011000,78,01001110,102,01100110
96,01100000,39,00100111,135,10000111
29,00011101,52,00110100,81,01010001
79,01001111,89,01011001,168,10101000
4,00000100,53,00110101,57,00111001
114,01110010,58,00111010,172,10101100
73,01001001,105,01101001,178,10110010
85,01010101,100,01100100,185,10111001
111,01101111,8,00001000,119,01110111
105,01101001,39,00100111,144,10010000
38,00100110,43,00101011,81,01010001
102,01100110,88,01011000,190,10111110
123,01111011,88,01011000,211,11010011
10,00001010,52,00110100,62,00111110
60,00111100,19,00010011,79,01001111
105,01101001,13,00001101,118,01110110
75,01001011,20,00010100,95,01011111
88,01011000,16,00010000,104,01101000
104,01101000,37,00100101,141,10001101
65,01000001,121,01111001,186,10111010
112,01110000,91,01011011,203,11001011
83,01010011,12,00001100,95,01011111
67,01000011,57,00111001,124,01111100
49,00110001,86,01010110,135,10000111
77,01001101,29,00011101,106,01101010
115,01110011,120,01111000,235,11101011
37,00100101,49,00110001,86,01010110
92,01011100,58,00111010,150,10010110
109,01101101,27,00011011,136,10001000
3,00000011,31,00011111,34,00100010
102,01100110,72,01001000,174,10101110
69,01000101,118,01110110,187,10111011
79,01001111,91,01011011,170,10101010
113,01110001,102,01100110,215,11010111
109,01101101,114,01110010,223,11011111
96,01100000,97,01100001,193,11000001
24,00011000,96,01100000,120,01111000
54,00110110,82,01010010,136,10001000
104,01101000,121,01111001,225,11100001
20,00010100,52,00110100,72,01001000
24,00011000,2,00000010,26,00011010
34,00100010,87,01010111,121,01111001
15,00001111,26,00011010,41,00101001
17,00010001,95,01011111,112,01110000
84,01010100,88,01011000,172,10101100
104,01101000,25,00011001,129,10000001
43,00101011,24,00011000,67,01000011
122,01111010,90,01011010,212,11010100
124,01111100,75,01001011,199,11000111
91,01011011,28,00011100,119,01110111
16,00010000,38,00100110,54,00110110
59,00111011,124,01111100,183,10110111
35,00100011,44,00101100,79,01001111
95,01011111,115,01110011,210,11010010
39,00100111,57,00111001,96,01100000
72,01001000,74,01001010,146,10010010
37,00100101,62,00111110,99,01100011
75,01001011,21,00010101,96,01100000
54,00110110,2,00000010,56,00111000
105,01101001,38,00100110,143,10001111
3,00000011,85,01010101,88,01011000
35,00100011,99,01100011,134,10000110
120,01111000,68,01000100,188,10111100
54,00110110,51,00110011,105,01101001
13,00001101,68,01000100,81,01010001
55,00110111,72,01001000,127,01111111
116,01110100,82,01010010,198,11000110
95,01011111,78,01001110,173,10101101
96,01100000,37,00100101,133,10000101
69,01000101,116,01110100,185,10111001
105,01101001,50,00110010,155,10011011
114,01110010,51,00110011,165,10100101
20,00010100,32,00100000,52,00110100
124,01111100,74,01001010,198,11000110
52,00110100,47,00101111,99,01100011
68,01000100,69,01000101,137,10001001
28,00011100,106,01101010,134,10000110
29,00011101,5,00000101,34,00100010
90,01011010,78,01001110,168,10101000
54,00110110,25,00011001,79,01001111
36,00100100,10,00001010,46,00101110
66,01000010,47,00101111,113,01110001
126,01111110,37,00100101,163,10100011
71,01000111,13,00001101,84,01010100
95,01011111,105,01101001,200,11001000
29,00011101,5,00000101,34,00100010
77,01001101,91,01011011,168,10101000
38,00100110,16,00010000,54,00110110
30,00011110,24,00011000,54,00110110
56,00111000,81,01010001,137,10001001
51,00110011,97,01100001,148,10010100
80,01010000,9,00001001,89,01011001
58,00111010,54,00110110,112,01110000
65,01000001,46,00101110,111,01101111
107,01101011,30,00011110,137,10001001
93,01011101,18,00010010,111,01101111
83,01010011,52,00110100,135,10000111
49,00110001,124,01111100,173,10101101
78,01001110,122,01111010,200,11001000
74,01001010,114,01110010,188,10111100
77,01001101,67,01000011,144,10010000
95,01011111,70,01000110,165,10100101
55,00110111,79,01001111,134,10000110
80,01010000,117,01110101,197,11000101
123,01111011,34,00100010,157,10011101
79,01001111,67,01000011,146,10010010
54,00110110,107,01101011,161,10100001
18,00010010,30,00011110,48,00110000
43,00101011,43,00101011,86,01010110
19,00010011,49,00110001,68,01000100
69,01000101,113,01110001,182,10110110
70,01000110,75,01001011,145,10010001
3,00000011,17,00010001,20,00010100
19,00010011,70,01000110,89,01011001
121,01111001,25,00011001,146,10010010
117,01110101,88,01011000,205,11001101
66,01000010,22,00010110,88,01011000
118,01110110,81,01010001,199,11000111
111,01101111,118,01110110,229,11100101
22,00010110,14,00001110,36,00100100
100,01100100,18,00010010,118,01110110
82,01010010,111,01101111,193,11000001
85,01010101,18,00010010,103,01100111
79,01001111,22,00010110,101,01100101
119,01110111,14,00001110,133,10000101
70,01000110,116,01110100,186,10111010
20,00010100,76,01001100,96,01100000
38,00100110,22,00010110,60,00111100
42,00101010,67,01000011,109,01101101
55,00110111,25,00011001,80,01010000
34,00100010,30,00011110,64,01000000
66,01000010,107,01101011,173,10101101
17,00010001,116,01110100,133,10000101
29,00011101,24,00011000,53,00110101
113,01110001,107,01101011,220,11011100
84,01010100,60,00111100,144,10010000
19,00010011,50,00110010,69,01000101
46,00101110,77,01001101,123,01111011
47,00101111,52,00110100,99,01100011
118,01110110,15,00001111,133,10000101
61,00111101,107,01101011,168,10101000
4,00000100,111,01101111,115,01110011
82,01010010,35,00100011,117,01110101
31,00011111,32,00100000,63,00111111
5,00000101,93,01011101,98,01100010
123,01111011,93,01011101,216,11011000
78,01001110,36,00100100,114,01110010
1,00000001,17,00010001,18,00010010
72,01001000,24,00011000,96,01100000
60,00111100,21,00010101,81,01010001
24,00011000,52,00110100,76,01001100
2,00000010,110,01101110,112,01110000
74,01001010,82,01010010,156,10011100
110,01101110,50,00110010,160,10100000
95,01011111,50,00110010,145,10010001
67,01000011,125,01111101,192,11000000
42,00101010,59,00111011,101,01100101
72,01001000,102,01100110,174,10101110
116,01110100,119,01110111,235,11101011
45,00101101,96,01100000,141,10001101
79,01001111,80,01010000,159,10011111
7,00000111,95,01011111,102,01100110
30,00011110,101,01100101,131,10000011
1,00000001,20,00010100,21,00010101
89,01011001,51,00110011,140,10001100
108,01101100,117,01110101,225,11100001
75,01001011,25,00011001,100,01100100
127,01111111,42,00101010,169,10101001
127,01111111,51,00110011,178,10110010
38,00100110,6,00000110,44,00101100
22,00010110,100,01100100,122,01111010
33,00100001,107,01101011,140,10001100
10,00001010,49,00110001,59,00111011
35,00100011,58,00111010,93,01011101
59,00111011,31,00011111,90,01011010
8,00001000,4,00000100,12,00001100
9,00001001,0,00000000,9,00001001
86,01010110,104,01101000,190,10111110
54,00110110,89,01011001,143,10001111
42,00101010,38,00100110,80,01010000
10,00001010,103,01100111,113,01110001
119,01110111,93,01011101,212,11010100
45,00101101,18,00010010,63,00111111
21,00010101,53,00110101,74,01001010
10,00001010,37,00100101,47,00101111
46,00101110,51,00110011,97,01100001
5,00000101,118,01110110,123,01111011
3,00000011,111,01101111,114,01110010
53,00110101,90,01011010,143,10001111
68,01000100,78,01001110,146,10010010
122,01111010,30,00011110,152,10011000
126,01111110,66,01000010,192,11000000
63,00111111,114,01110010,177,10110001
109,01101101,89,01011001,198,11000110
86,01010110,59,00111011,145,10010001
115,01110011,5,00000101,120,01111000
41,00101001,81,01010001,122,01111010
14,00001110,90,01011010,104,01101000
47,00101111,29,00011101,76,01001100
77,01001101,93,01011101,170,10101010
27,00011011,21,00010101,48,00110000
107,01101011,38,00100110,145,10010001
64,01000000,51,00110011,115,01110011
42,00101010,55,00110111,97,01100001
77,01001101,83,01010011,160,10100000
18,00010010,98,01100010,116,01110100
92,01011100,56,00111000,148,10010100
119,01110111,32,00100000,151,10010111
105,01101001,31,00011111,136,10001000
63,00111111,3,00000011,66,01000010
12,00001100,54,00110110,66,01000010
9,00001001,55,00110111,64,01000000
118,01110110,127,01111111,245,11110101
30,00011110,44,00101100,74,01001010
14,00001110,100,01100100,114,01110010
105,01101001,1,00000001,106,01101010
105,01101001,68,01000100,173,10101101
28,00011100,122,01111010,150,10010110
15,00001111,121,01111001,136,10001000
74,01001010,21,00010101,95,01011111
26,00011010,97,01100001,123,01111011
98,01100010,75,01001011,173,10101101
99,01100011,121,01111001,220,11011100
124,01111100,47,00101111,171,10101011
81,01010001,70,01000110,151,10010111
16,00010000,51,00110011,67,01000011
0,00000000,8,00001000,8,00001000
16,00010000,8,00001000,24,00011000
76,01001100,41,00101001,117,01110101
34,00100010,105,01101001,139,10001011
53,00110101,84,01010100,137,10001001
107,01101011,116,01110100,223,11011111
22,00010110,37,00100101,59,00111011
14,00001110,115,01110011,129,10000001
38,00100110,32,00100000,70,01000110
63,00111111,86,01010110,149,10010101
77,01001101,39,00100111,116,01110100
12,00001100,111,01101111,123,01111011
2,00000010,47,00101111,49,00110001
24,00011000,58,00111010,82,01010010
26,00011010,22,00010110,48,00110000
2,00000010,52,00110100,54,00110110
30,00011110,41,00101001,71,01000111
36,00100100,40,00101000,76,01001100
76,01001100,73,01001001,149,10010101
107,01101011,88,01011000,195,11000011
122,01111010,116,01110100,238,11101110
23,00010111,117,01110101,140,10001100
33,00100001,28,00011100,61,00111101
97,01100001,106,01101010,203,11001011
20,00010100,70,01000110,90,01011010
114,01110010,102,01100110,216,11011000
116,01110100,48,00110000,164,10100100
59,00111011,5,00000101,64,01000000
100,01100100,18,00010010,118,01110110
37,00100101,94,01011110,131,10000011
28,00011100,9,00001001,37,00100101
16,00010000,117,01110101,133,10000101
88,01011000,84,01010100,172,10101100
9,00001001,24,00011000,33,00100001
57,00111001,59,00111011,116,01110100
83,01010011,13,00001101,96,01100000
28,00011100,6,00000110,34,00100010
61,00111101,91,01011011,152,10011000
51,00110011,48,00110000,99,01100011
62,00111110,16,00010000,78,01001110
95,01011111,34,00100010,129,10000001
99,01100011,94,01011110,193,11000001
73,01001001,24,00011000,97,01100001
83,01010011,107,01101011,190,10111110
60,00111100,116,01110100,176,10110000
80,01010000,118,01110110,198,11000110
50,00110010,64,01000000,114,01110010
8,00001000,62,00111110,70,01000110
84,01010100,79,01001111,163,10100011
64,01000000,4,00000100,68,01000100
11,00001011,59,00111011,70,01000110
54,00110110,69,01000101,123,01111011
64,01000000,56,00111000,120,01111000
67,01000011,63,00111111,130,10000010
72,01001000,39,00100111,111,01101111
117,01110101,4,00000100,121,01111001
96,01100000,2,00000010,98,01100010
53,00110101,106,01101010,159,10011111
80,01010000,84,01010100,164,10100100
24,00011000,84,01010100,108,01101100
78,01001110,122,01111010,200,11001000
16,00010000,90,01011010,106,01101010
60,00111100,75,01001011,135,10000111
116,01110100,41,00101001,157,10011101
29,00011101,118,01110110,147,10010011
67,01000011,62,00111110,129,10000001
21,00010101,22,00010110,43,00101011
55,00110111,14,00001110,69,01000101
64,01000000,35,00100011,99,01100011
73,01001001,63,00111111,136,10001000
14,00001110,60,00111100,74,01001010
120,01111000,95,01011111,215,11010111
82,01010010,64,01000000,146,10010010
86,01010110,121,01111001,207,11001111
109,01101101,33,00100001,142,10001110
54,00110110,30,00011110,84,01010100
15,00001111,31,00011111,46,00101110
44,00101100,34,00100010,78,01001110
9,00001001,57,00111001,66,01000010
78,01001110,24,00011000,102,01100110
70,01000110,88,01011000,158,10011110
105,01101001,6,00000110,111,01101111
22,00010110,106,01101010,128,10000000
79,01001111,39,00100111,118,01110110
53,00110101,54,00110110,107,01101011
64,01000000,1,00000001,65,01000001
24,00011000,115,01110011,139,10001011
1,00000001,18,00010010,19,00010011
10,00001010,112,01110000,122,01111010
1,00000001,101,01100101,102,01100110
23,00010111,62,00111110,85,01010101
84,01010100,71,01000111,155,10011011
115,01110011,3,00000011,118,01110110
26,00011010,14,00001110,40,00101000
3,00000011,111,01101111,114,01110010
41,00101001,116,01110100,157,10011101
40,00101000,92,01011100,132,10000100
22,00010110,72,01001000,94,01011110
0,00000000,33,00100001,33,00100001
81,01010001,114,01110010,195,11000011
77,01001101,124,01111100,201,11001001
105,01101001,21,00010101,126,01111110
37,00100101,74,01001010,111,01101111
57,00111001,84,01010100,141,10001101
115,01110011,55,00110111,170,10101010
18,00010010,56,00111000,74,01001010
11,00001011,124,01111100,135,10000111
63,00111111,57,00111001,120,01111000
58,00111010,71,01000111,129,10000001
100,01100100,71,01000111,171,10101011
45,00101101,22,00010110,67,01000011
79,01001111,35,00100011,114,01110010
116,01110100,71,01000111,187,10111011
21,00010101,66,01000010,87,01010111
7,00000111,108,01101100,115,01110011
46,00101110,24,00011000,70,01000110
21,00010101,124,01111100,145,10010001
123,01111011,81,01010001,204,11001100
123,01111011,22,00010110,145,10010001
22,00010110,36,00100100,58,00111010
0,00000000,72,01001000,72,01001000
90,01011010,114,01110010,204,11001100
73,01001001,85,01010101,158,10011110
36,00100100,8,00001000,44,00101100
66,01000010,39,00100111,105,01101001
55,00110111,91,01011011,146,10010010
68,01000100,113,01110001,181,10110101
126,01111110,57,00111001,183,10110111
69,01000101,108,01101100,177,10110001
95,01011111,78,01001110,173,10101101
52,00110100,24,00011000,76,01001100
79,01001111,119,01110111,198,11000110
52,00110100,3,00000011,55,00110111
107,01101011,112,01110000,219,11011011
20,00010100,98,01100010,118,01110110
7,00000111,98,01100010,105,01101001
122,01111010,21,00010101,143,10001111
4,00000100,86,01010110,90,01011010
9,00001001,114,01110010,123,01111011
116,01110100,85,01010101,201,11001001
44,00101100,62,00111110,106,01101010
84,01010100,3,00000011,87,01010111
9,00001001,89,01011001,98,01100010
48,00110000,62,00111110,110,01101110
106,01101010,9,00001001,115,01110011
112,01110000,13,00001101,125,01111101
112,01110000,14,00001110,126,01111110
70,01000110,35,00100011,105,01101001
89,01011001,82,01010010,171,10101011
108,01101100,9,00001001,117,01110101
91,01011011,55,00110111,146,10010010
4,00000100,1,00000001,5,00000101
99,01100011,7,00000111,106,01101010
64,01000000,55,00110111,119,01110111
126,01111110,71,01000111,197,11000101
109,01101101,93,01011101,202,11001010
68,01000100,6,00000110,74,01001010
80,01010000,91,01011011,171,10101011
67,01000011,43,00101011,110,01101110
65,01000001,47,00101111,112,01110000
98,01100010,110,01101110,208,11010000
17,00010001,37,00100101,54,00110110
109,01101101,58,00111010,167,10100111
37,00100101,48,00110000,85,01010101
123,01111011,38,00100110,161,10100001
109,01101101,45,00101101,154,10011010
122,01111010,36,00100100,158,10011110
87,01010111,121,01111001,208,11010000
26,00011010,33,00100001,59,00111011
42,00101010,115,01110011,157,10011101
95,01011111,81,01010001,176,10110000
21,00010101,117,01110101,138,10001010
108,01101100,31,00011111,139,10001011
11,00001011,66,01000010,77,01001101
42,00101010,97,01100001,139,10001011
22,00010110,11,00001011,33,00100001
104,01101000,123,01111011,227,11100011
45,00101101,48,00110000,93,01011101
94,01011110,19,00010011,113,01110001
38,00100110,102,01100110,140,10001100
68,01000100,117,01110101,185,10111001
13,00001101,45,00101101,58,00111010
112,01110000,111,01101111,223,11011111
90,01011010,122,01111010,212,11010100
117,01110101,38,00100110,155,10011011
94,01011110,14,00001110,108,01101100
60,00111100,99,01100011,159,10011111
95,01011111,54,00110110,149,10010101
74,01001010,99,01100011,173,10101101
106,01101010,78,01001110,184,10111000
19,00010011,41,00101001,60,00111100
27,00011011,106,01101010,133,10000101
5,00000101,55,00110111,60,00111100
88,01011000,72,01001000,160,10100000
110,01101110,19,00010011,129,10000001
37,00100101,77,01001101,114,01110010
94,01011110,111,01101111,205,11001101
0,00000000,11,00001011,11,00001011
34,00100010,12,00001100,46,00101110
51,00110011,27,00011011,78,01001110
115,01110011,121,01111001,236,11101100
39,00100111,32,00100000,71,01000111
27,00011011,6,00000110,33,00100001
54,00110110,92,01011100,146,10010010
17,00010001,68,01000100,85,01010101
24,00011000,91,01011011,115,01110011
18,00010010,82,01010010,100,01100100
94,01011110,5,00000101,99,01100011
30,00011110,104,01101000,134,10000110
127,01111111,75,01001011,202,11001010
57,00111001,101,01100101,158,10011110
62,00111110,60,00111100,122,01111010
55,00110111,94,01011110,149,10010101
1,00000001,22,00010110,23,00010111
5,00000101,100,01100100,105,01101001
82,01010010,2,00000010,84,01010100
48,00110000,46,00101110,94,01011110
114,01110010,43,00101011,157,10011101
61,00111101,9,00001001,70,01000110
34,00100010,113,01110001,147,10010011
73,01001001,11,00001011,84,01010100
39,00100111,39,00100111,78,01001110
97,01100001,22,00010110,119,01110111
104,01101000,52,00110100,156,10011100
115,01110011,105,01101001,220,11011100
65,01000001,31,00011111,96,01100000
125,01111101,19,00010011,144,10010000
56,00111000,26,00011010,82,01010010
124,01111100,62,00111110,186,10111010
20,00010100,101,01100101,121,01111001
36,00100100,65,01000001,101,01100101
109,01101101,18,00010010,127,01111111
71,01000111,99,01100011,170,10101010
65,01000001,120,01111000,185,10111001
123,01111011,58,00111010,181,10110101
44,00101100,93,01011101,137,10001001
76,01001100,120,01111000,196,11000100
62,00111110,55,00110111,117,01110101
21,00010101,34,00100010,55,00110111
37,00100101,66,01000010,103,01100111
32,00100000,120,01111000,152,10011000
119,01110111,118,01110110,237,11101101
68,01000100,110,01101110,178,10110010
94,01011110,53,00110101,147,10010011
116,01110100,51,00110011,167,10100111
19,00010011,65,01000001,84,01010100
107,01101011,25,00011001,132,10000100
48,00110000,92,01011100,140,10001100
10,00001010,12,00001100,22,00010110
77,01001101,62,00111110,139,10001011
70,01000110,98,01100010,168,10101000
62,00111110,40,00101000,102,01100110
13,00001101,82,01010010,95,01011111
117,01110101,76,01001100,193,11000001
28,00011100,120,01111000,148,10010100
15,00001111,11,00001011,26,00011010
65,01000001,106,01101010,171,10101011
12,00001100,9,00001001,21,00010101
31,00011111,19,00010011,50,00110010
41,00101001,113,01110001,154,10011010
86,01010110,31,00011111,117,01110101
90,01011010,101,01100101,191,10111111
31,00011111,109,01101101,140,10001100
41,00101001,31,00011111,72,01001000
126,01111110,83,01010011,209,11010001
19,00010011,108,01101100,127,01111111
104,01101000,88,01011000,192,11000000
46,00101110,44,00101100,90,01011010
44,00101100,13,00001101,57,00111001
42,00101010,31,00011111,73,01001001
102,01100110,6,00000110,108,01101100
108,01101100,72,01001000,180,10110100
77,01001101,49,00110001,126,01111110
103,01100111,44,00101100,147,10010011
58,00111010,67,01000011,125,01111101
120,01111000,42,00101010,162,10100010
74,01001010,70,01000110,144,10010000
20,00010100,8,00001000,28,00011100
28,00011100,53,00110101,81,01010001
80,01010000,27,00011011,107,01101011
122,01111010,58,00111010,180,10110100
35,00100011,109,01101101,144,10010000
24,00011000,1,00000001,25,00011001
1,00000001,52,00110100,53,00110101
62,00111110,117,01110101,179,10110011
25,00011001,26,00011010,51,00110011
65,01000001,75,01001011,140,10001100
96,01100000,76,01001100,172,10101100
58,00111010,92,01011100,150,10010110
65,01000001,70,01000110,135,10000111
75,01001011,71,01000111,146,10010010
69,01000101,12,00001100,81,01010001
32,00100000,90,01011010,122,01111010
111,01101111,64,01000000,175,10101111
85,01010101,88,01011000,173,10101101
77,01001101,38,00100110,115,01110011
24,00011000,114,01110010,138,10001010
46,00101110,101,01100101,147,10010011
73,01001001,31,00011111,104,01101000
49,00110001,4,00000100,53,00110101
91,01011011,61,00111101,152,10011000
28,00011100,80,01010000,108,01101100
52,00110100,23,00010111,75,01001011
83,01010011,111,01101111,194,11000010
72,01001000,112,01110000,184,10111000
20,00010100,51,00110011,71,01000111
119,01110111,125,01111101,244,11110100
45,00101101,106,01101010,151,10010111
24,00011000,60,00111100,84,01010100
115,01110011,22,00010110,137,10001001
19,00010011,27,00011011,46,00101110
2,00000010,125,01111101,127,01111111
50,00110010,118,01110110,168,10101000
84,01010100,77,01001101,161,10100001
127,01111111,35,00100011,162,10100010
121,01111001,38,00100110,159,10011111
80,01010000,45,00101101,125,01111101
32,00100000,66,01000010,98,01100010
18,00010010,89,01011001,107,01101011
43,00101011,3,00000011,46,00101110
19,00010011,48,00110000,67,01000011
56,00111000,17,00010001,73,01001001
20,00010100,85,01010101,105,01101001
40,00101000,105,01101001,145,10010001
48,00110000,70,01000110,118,01110110
16,00010000,65,01000001,81,01010001
76,01001100,46,00101110,122,01111010
53,00110101,16,00010000,69,01000101
21,00010101,114,01110010,135,10000111
77,01001101,2,00000010,79,01001111
67,01000011,17,00010001,84,01010100
73,01001001,55,00110111,128,10000000
36,00100100,13,00001101,49,00110001
17,00010001,61,00111101,78,01001110
52,00110100,124,01111100,176,10110000
33,00100001,66,01000010,99,01100011
21,00010101,49,00110001,70,01000110
102,01100110,50,00110010,152,10011000
110,01101110,18,00010010,128,10000000
90,01011010,76,01001100,166,10100110
64,01000000,63,00111111,127,01111111
117,01110101,15,00001111,132,10000100
116,01110100,6,00000110,122,01111010
7,00000111,51,00110011,58,00111010
100,01100100,120,01111000,220,11011100
47,00101111,17,00010001,64,01000000
6,00000110,17,00010001,23,00010111
68,01000100,15,00001111,83,01010011
80,01010000,113,01110001,193,11000001
42,00101010,78,01001110,120,01111000
69,01000101,76,01001100,145,10010001
83,01010011,101,01100101,184,10111000
78,01001110,86,01010110,164,10100100
106,01101010,69,01000101,175,10101111
65,01000001,117,01110101,182,10110110
67,01000011,62,00111110,129,10000001
77,01001101,127,01111111,204,11001100
58,00111010,25,00011001,83,01010011
127,01111111,6,00000110,133,10000101
14,00001110,13,00001101,27,00011011
77,01001101,93,01011101,170,10101010
0,00000000,63,00111111,63,00111111
105,01101001,91,01011011,196,11000100
94,01011110,29,00011101,123,01111011
21,00010101,20,00010100,41,00101001
27,00011011,37,00100101,64,01000000
20,00010100,49,00110001,69,01000101
89,01011001,120,01111000,209,11010001
117,01110101,35,00100011,152,10011000
52,00110100,108,01101100,160,10100000
98,01100010,120,01111000,218,11011010
0,00000000,80,01010000,80,01010000
25,00011001,25,00011001,50,00110010
97,01100001,46,00101110,143,10001111
78,01001110,50,00110010,128,10000000
107,01101011,63,00111111,170,10101010
68,01000100,7,00000111,75,01001011
10,00001010,35,00100011,45,00101101
50,00110010,60,00111100,110,01101110
73,01001001,1,00000001,74,01001010
118,01110110,70,01000110,188,10111100
13,00001101,71,01000111,84,01010100
45,00101101,49,00110001,94,01011110
26,00011010,84,01010100,110,01101110
3,00000011,68,01000100,71,01000111
102,01100110,86,01010110,188,10111100
34,00100010,72,01001000,106,01101010
106,01101010,3,00000011,109,01101101
64,01000000,126,01111110,190,10111110
86,01010110,1,00000001,87,01010111
39,00100111,83,01010011,122,01111010
49,00110001,52,00110100,101,01100101
69,01000101,42,00101010,111,01101111
64,01000000,43,00101011,107,01101011
42,00101010,12,00001100,54,00110110
86,01010110,106,01101010,192,11000000
46,00101110,46,00101110,92,01011100
74,01001010,37,00100101,111,01101111
64,01000000,115,01110011,179,10110011
34,00100010,8,00001000,42,00101010
80,01010000,62,00111110,142,10001110
78,01001110,22,00010110,100,01100100
101,01100101,85,01010101,186,10111010
51,00110011,42,00101010,93,01011101
6,00000110,34,00100010,40,00101000
7,00000111,22,00010110,29,00011101
72,01001000,9,00001001,81,01010001
7,00000111,55,00110111,62,00111110
94,01011110,104,01101000,198,11000110
18,00010010,12,00001100,30,00011110
63,00111111,104,01101000,167,10100111
28,00011100,105,01101001,133,10000101
39,00100111,63,00111111,102,01100110
114,01110010,10,00001010,124,01111100
66,01000010,114,01110010,180,10110100
99,01100011,66,01000010,165,10100101
121,01111001,92,01011100,213,11010101
102,01100110,17,00010001,119,01110111
26,00011010,52,00110100,78,01001110
42,00101010,26,00011010,68,01000100
51,00110011,74,01001010,125,01111101
28,00011100,93,01011101,121,01111001
102,01100110,57,00111001,159,10011111
92,01011100,70,01000110,162,10100010
78,01001110,123,01111011,201,11001001
108,01101100,72,01001000,180,10110100
30,00011110,7,00000111,37,00100101
84,01010100,90,01011010,174,10101110
93,01011101,74,01001010,167,10100111
124,01111100,38,00100110,162,10100010
23,00010111,88,01011000,111,01101111
49,00110001,92,01011100,141,10001101
1,00000001,13,00001101,14,00001110
66,01000010,41,00101001,107,01101011
48,00110000,44,00101100,92,01011100
123,01111011,78,01001110,201,11001001
105,01101001,19,00010011,124,01111100
100,01100100,95,01011111,195,11000011
111,01101111,27,00011011,138,10001010
94,01011110,1,00000001,95,01011111
81,01010001,21,00010101,102,01100110
73,01001001,15,00001111,88,01011000
92,01011100,19,00010011,111,01101111
60,00111100,21,00010101,81,01010001
86,01010110,100,01100100,186,10111010
120,01111000,16,00010000,136,10001000
115,01110011,50,00110010,165,10100101
107,01101011,101,01100101,208,11010000
89,01011001,122,01111010,211,11010011
116,01110100,93,01011101,209,11010001
79,01001111,25,00011001,104,01101000
127,01111111,42,00101010,169,10101001
60,00111100,127,01111111,187,10111011
97,01100001,64,01000000,161,10100001
126,01111110,114,01110010,240,11110000
87,01010111,58,00111010,145,10010001
67,01000011,87,01010111,154,10011010
30,00011110,94,01011110,124,01111100
60,00111100,113,01110001,173,10101101
92,01011100,67,01000011,159,10011111
41,00101001,10,00001010,51,00110011
46,00101110,37,00100101,83,01010011
119,01110111,3,00000011,122,01111010
102,01100110,38,00100110,140,10001100
20,00010100,64,01000000,84,01010100
97,01100001,109,01101101,206,11001110
58,00111010,110,01101110,168,10101000
121,01111001,115,01110011,236,11101100
46,00101110,8,00001000,54,00110110
11,00001011,105,01101001,116,01110100
81,01010001,73,01001001,154,10011010
37,00100101,10,00001010,47,00101111
33,00100001,68,01000100,101,01100101
106,01101010,15,00001111,121,01111001
90,01011010,98,01100010,188,10111100
9,00001001,82,01010010,91,01011011
19,00010011,0,00000000,19,00010011
32,00100000,80,01010000,112,01110000
33,00100001,102,01100110,135,10000111
119,01110111,24,00011000,143,10001111
57,00111001,26,00011010,83,01010011
98,01100010,12,00001100,110,01101110
2,00000010,37,00100101,39,00100111
12,00001100,34,00100010,46,00101110
89,01011001,115,01110011,204,11001100
19,00010011,52,00110100,71,01000111
13,00001101,1,00000001,14,00001110
68,01000100,84,01010100,152,10011000
26,00011010,89,01011001,115,01110011
23,00010111,101,01100101,124,01111100
38,00100110,63,00111111,101,01100101
52,00110100,12,00001100,64,01000000
86,01010110,30,00011110,116,01110100
75,01001011,43,00101011,118,01110110
117,01110101,60,00111100,177,10110001
59,00111011,88,01011000,147,10010011
29,00011101,63,00111111,92,01011100
62,00111110,79,01001111,141,10001101
108,01101100,95,01011111,203,11001011
93,01011101,3,00000011,96,01100000
29,00011101,118,01110110,147,10010011
97,01100001,67,01000011,164,10100100
28,00011100,105,01101001,133,10000101
81,01010001,111,01101111,192,11000000
127,01111111,83,01010011,210,11010010
35,00100011,27,00011011,62,00111110
85,01010101,119,01110111,204,11001100
47,00101111,115,01110011,162,10100010
72,01001000,2,00000010,74,01001010
54,00110110,69,01000101,123,01111011
89,01011001,35,00100011,124,01111100
9,00001001,23,00010111,32,00100000
112,01110000,79,01001111,191,10111111
89,01011001,85,01010101,174,10101110
108,01101100,55,00110111,163,10100011
1,00000001,91,01011011,92,01011100
50,00110010,92,01011100,142,10001110
116,01110100,74,01001010,190,10111110
115,01110011,87,01010111,202,11001010
66,01000010,82,01010010,148,10010100
35,00100011,6,00000110,41,00101001
107,01101011,74,01001010,181,10110101
103,01100111,102,01100110,205,11001101
106,01101010,99,01100011,205,11001101
99,01100011,30,00011110,129,10000001
7,00000111,30,00011110,37,00100101
84,01010100,109,01101101,193,11000001
114,01110010,20,00010100,134,10000110
118,01110110,109,01101101,227,11100011
33,00100001,109,01101101,142,10001110
6,00000110,22,00010110,28,00011100
119,01110111,83,01010011,202,11001010
56,00111000,33,00100001,89,01011001
22,00010110,60,00111100,82,01010010
77,01001101,127,01111111,204,11001100
52,00110100,95,01011111,147,10010011
84,01010100,14,00001110,98,01100010
30,00011110,16,00010000,46,00101110
70,01000110,16,00010000,86,01010110
33,00100001,126,01111110,159,10011111
102,01100110,123,01111011,225,11100001
31,00011111,54,00110110,85,01010101
81,01010001,126,01111110,207,11001111
4,00000100,97,01100001,101,01100101
103,01100111,55,00110111,158,10011110
79,01001111,47,00101111,126,01111110
71,01000111,61,00111101,132,10000100
41,00101001,54,00110110,95,01011111
52,00110100,68,01000100,120,01111000
43,00101011,62,00111110,105,01101001
39,00100111,110,01101110,149,10010101
96,01100000,83,01010011,179,10110011
89,01011001,79,01001111,168,10101000
12,00001100,20,00010100,32,00100000
124,01111100,43,00101011,167,10100111
77,01001101,13,00001101,90,01011010
49,00110001,14,00001110,63,00111111
64,01000000,37,00100101,101,01100101
87,01010111,37,00100101,124,01111100
37,00100101,4,00000100,41,00101001
93,01011101,23,00010111,116,01110100
110,01101110,105,01101001,215,11010111
17,00010001,46,00101110,63,00111111
66,01000010,51,00110011,117,01110101
115,01110011,11,00001011,126,01111110
48,00110000,118,01110110,166,10100110
127,01111111,63,00111111,190,10111110
4,00000100,6,00000110,10,00001010
42,00101010,38,00100110,80,01010000
72,01001000,68,01000100,140,10001100
44,00101100,47,00101111,91,01011011
95,01011111,55,00110111,150,10010110
48,00110000,114,01110010,162,10100010
62,00111110,89,01011001,151,10010111
9,00001001,107,01101011,116,01110100
61,00111101,62,00111110,123,01111011
49,00110001,48,00110000,97,01100001
100,01100100,123,01111011,223,11011111
14,00001110,97,01100001,111,01101111
11,00001011,17,00010001,28,00011100
34,00100010,52,00110100,86,01010110
62,00111110,98,01100010,160,10100000
103,01100111,15,00001111,118,01110110
69,01000101,30,00011110,99,01100011
88,01011000,34,00100010,122,01111010
63,00111111,61,00111101,124,01111100
68,01000100,85,01010101,153,10011001
100,01100100,118,01110110,218,11011010
33,00100001,126,01111110,159,10011111
4,00000100,22,00010110,26,00011010
40,00101000,19,00010011,59,00111011
32,00100000,41,00101001,73,01001001
97,01100001,19,00010011,116,01110100
31,00011111,107,01101011,138,10001010
26,00011010,70,01000110,96,01100000
87,01010111,79,01001111,166,10100110
40,00101000,52,00110100,92,01011100
69,01000101,63,00111111,132,10000100
124,01111100,122,01111010,246,11110110
13,00001101,1,00000001,14,00001110
67,01000011,104,01101000,171,10101011
5,00000101,36,00100100,41,00101001
9,00001001,73,01001001,82,01010010
44,00101100,12,00001100,56,00111000
37,00100101,37,00100101,74,01001010
97,01100001,76,01001100,173,10101101
24,00011000,56,00111000,80,01010000
100,01100100,49,00110001,149,10010101
41,00101001,25,00011001,66,01000010
116,01110100,28,00011100,144,10010000
85,01010101,98,01100010,183,10110111
82,01010010,58,00111010,140,10001100
53,00110101,19,00010011,72,01001000
81,01010001,53,00110101,134,10000110
13,00001101,104,01101000,117,01110101
17,00010001,2,00000010,19,00010011
103,01100111,93,01011101,196,11000100
59,00111011,107,01101011,166,10100110
78,01001110,19,00010011,97,01100001
37,00100101,66,01000010,103,01100111
105,01101001,73,01001001,178,10110010
100,01100100,18,00010010,118,01110110
96,01100000,48,00110000,144,10010000
65,01000001,17,00010001,82,01010010
107,01101011,57,00111001,164,10100100
105,01101001,106,01101010,211,11010011
56,00111000,117,01110101,173,10101101
43,00101011,73,01001001,116,01110100
98,01100010,77,01001101,175,10101111
106,01101010,81,01010001,187,10111011
47,00101111,47,00101111,94,01011110
46,00101110,125,01111101,171,10101011
58,00111010,109,01101101,167,10100111
53,00110101,12,00001100,65,01000001
61,00111101,50,00110010,111,01101111
1,00000001,77,01001101,78,01001110
28,00011100,10,00001010,38,00100110
121,01111001,22,00010110,143,10001111
74,01001010,15,00001111,89,01011001
66,01000010,93,01011101,159,10011111
63,00111111,27,00011011,90,01011010
64,01000000,80,01010000,144,10010000
96,01100000,105,01101001,201,11001001
122,01111010,26,00011010,148,10010100
22,00010110,121,01111001,143,10001111
64,01000000,54,00110110,118,01110110
97,01100001,19,00010011,116,01110100
4,00000100,16,00010000,20,00010100
96,01100000,14,00001110,110,01101110
110,01101110,76,01001100,186,10111010
21,00010101,43,00101011,64,01000000
29,00011101,125,01111101,154,10011010
25,00011001,79,01001111,104,01101000
112,01110000,29,00011101,141,10001101
97,01100001,79,01001111,176,10110000
32,00100000,24,00011000,56,00111000
73,01001001,92,01011100,165,10100101
20,00010100,26,00011010,46,00101110
68,01000100,13,00001101,81,01010001
105,01101001,20,00010100,125,01111101
56,00111000,126,01111110,182,10110110
115,01110011,48,00110000,163,10100011
104,01101000,55,00110111,159,10011111
18,00010010,103,01100111,121,01111001
109,01101101,68,01000100,177,10110001
38,00100110,42,00101010,80,01010000
87,01010111,14,00001110,101,01100101
22,00010110,61,00111101,83,01010011
8,00001000,4,00000100,12,00001100
53,00110101,87,01010111,140,10001100
7,00000111,54,00110110,61,00111101
23,00010111,73,01001001,96,01100000
74,01001010,98,01100010,172,10101100
48,00110000,90,01011010,138,10001010
53,00110101,9,00001001,62,00111110
96,01100000,34,00100010,130,10000010
112,01110000,73,01001001,185,10111001
96,01100000,104,01101000,200,11001000
62,00111110,66,01000010,128,10000000
32,00100000,47,00101111,79,01001111
37,00100101,62,00111110,99,01100011
67,01000011,0,00000000,67,01000011
30,00011110,76,01001100,106,01101010
7,00000111,116,01110100,123,01111011
39,00100111,6,00000110,45,00101101
69,01000101,42,00101010,111,01101111
49,00110001,107,01101011,156,10011100
55,00110111,3,00000011,58,00111010
34,00100010,68,01000100,102,01100110
109,01101101,113,01110001,222,11011110
46,00101110,98,01100010,144,10010000
71,01000111,44,00101100,115,01110011
50,00110010,30,00011110,80,01010000
1,00000001,37,00100101,38,00100110
23,00010111,54,00110110,77,01001101
59,00111011,12,00001100,71,01000111
3,00000011,4,00000100,7,00000111
4,00000100,99,01100011,103,01100111
19,00010011,44,00101100,63,00111111
126,01111110,106,01101010,232,11101000
58,00111010,71,01000111,129,10000001
65,01000001,99,01100011,164,10100100
4,00000100,93,01011101,97,01100001
51,00110011,51,00110011,102,01100110
2,00000010,51,00110011,53,00110101
69,01000101,114,01110010,183,10110111
8,00001000,118,01110110,126,01111110
58,00111010,94,01011110,152,10011000
37,00100101,64,01000000,101,01100101
39,00100111,111,01101111,150,10010110
30,00011110,58,00111010,88,01011000
100,01100100,92,01011100,192,11000000
69,01000101,123,01111011,192,11000000
65,01000001,44,00101100,109,01101101
4,00000100,20,00010100,24,00011000
2,00000010,1,00000001,3,00000011
13,00001101,37,00100101,50,00110010
86,01010110,43,00101011,129,10000001
96,01100000,27,00011011,123,01111011
78,01001110,10,00001010,88,01011000
92,01011100,31,00011111,123,01111011
84,01010100,127,01111111,211,11010011
57,00111001,116,01110100,173,10101101
76,01001100,74,01001010,150,10010110
112,01110000,23,00010111,135,10000111
5,00000101,21,00010101,26,00011010
48,00110000,39,00100111,87,01010111
83,01010011,26,00011010,109,01101101
107,01101011,116,01110100,223,11011111
112,01110000,27,00011011,139,10001011
91,01011011,113,01110001,204,11001100
55,00110111,13,00001101,68,01000100
7,00000111,74,01001010,81,01010001
24,00011000,79,01001111,103,01100111
42,00101010,107,01101011,149,10010101
95,01011111,53,00110101,148,10010100
15,00001111,73,01001001,88,01011000
35,00100011,44,00101100,79,01001111
35,00100011,57,00111001,92,01011100
98,01100010,33,00100001,131,10000011
17,00010001,78,01001110,95,01011111
22,00010110,11,00001011,33,00100001
26,00011010,91,01011011,117,01110101
99,01100011,101,01100101,200,11001000
111,01101111,53,00110101,164,10100100
46,00101110,43,00101011,89,01011001
28,00011100,122,01111010,150,10010110
127,01111111,101,01100101,228,11100100
112,01110000,30,00011110,142,10001110
47,00101111,127,01111111,174,10101110
69,01000101,41,00101001,110,01101110
106,01101010,6,00000110,112,01110000
36,00100100,75,01001011,111,01101111
101,01100101,49,00110001,150,10010110
83,01010011,96,01100000,179,10110011
122,01111010,12,00001100,134,10000110
69,01000101,31,00011111,100,01100100
121,01111001,26,00011010,147,10010011
65,01000001,45,00101101,110,01101110
27,00011011,0,00000000,27,00011011
120,01111000,28,00011100,148,10010100
27,00011011,52,00110100,79,01001111
53,00110101,103,01100111,156,10011100
123,01111011,67,01000011,190,10111110
39,00100111,9,00001001,48,00110000
106,01101010,104,01101000,210,11010010
124,01111100,53,00110101,177,10110001
21,00010101,15,00001111,36,00100100
53,00110101,108,01101100,161,10100001
93,01011101,62,00111110,155,10011011
77,01001101,37,00100101,114,01110010
90,01011010,112,01110000,202,11001010
8,00001000,20,00010100,28,00011100
55,00110111,107,01101011,162,10100010
115,01110011,5,00000101,120,01111000
64,01000000,56,00111000,120,01111000
72,01001000,107,01101011,179,10110011
110,01101110,34,00100010,144,10010000
106,01101010,99,01100011,205,11001101
56,00111000,25,00011001,81,01010001
96,01100000,51,00110011,147,10010011
86,01010110,99,01100011,185,10111001
57,00111001,109,01101101,166,10100110
58,00111010,70,01000110,128,10000000
33,00100001,118,01110110,151,10010111
126,01111110,80,01010000,206,11001110
29,00011101,14,00001110,43,00101011
87,01010111,72,01001000,159,10011111
127,01111111,6,00000110,133,10000101
63,00111111,72,01001000,135,10000111
108,01101100,57,00111001,165,10100101
24,00011000,71,01000111,95,01011111
83,01010011,10,00001010,93,01011101
93,01011101,48,00110000,141,10001101
67,01000011,21,00010101,88,01011000
124,01111100,109,01101101,233,11101001
20,00010100,119,01110111,139,10001011
75,01001011,23,00010111,98,01100010
115,01110011,100,01100100,215,11010111
48,00110000,4,00000100,52,00110100
88,01011000,11,00001011,99,01100011
111,01101111,74,01001010,185,10111001
52,00110100,31,00011111,83,01010011
46,00101110,86,01010110,132,10000100
86,01010110,33,00100001,119,01110111
78,01001110,11,00001011,89,01011001
93,01011101,84,01010100,177,10110001
68,01000100,118,01110110,186,10111010
54,00110110,104,01101000,158,10011110
68,01000100,67,01000011,135,10000111
53,00110101,35,00100011,88,01011000
27,00011011,91,01011011,118,01110110
19,00010011,12,00001100,31,00011111
74,01001010,26,00011010,100,01100100
100,01100100,103,01100111,203,11001011
104,01101000,70,01000110,174,10101110
21,00010101,103,01100111,124,01111100
111,01101111,29,00011101,140,10001100
38,00100110,121,01111001,159,10011111
52,00110100,113,01110001,165,10100101
14,00001110,75,01001011,89,01011001
67,01000011,62,00111110,129,10000001
0,00000000,38,00100110,38,00100110
95,01011111,42,00101010,137,10001001
2,00000010,36,00100100,38,00100110
110,01101110,1,00000001,111,01101111
78,01001110,73,01001001,151,10010111
49,00110001,88,01011000,137,10001001
61,00111101,96,01100000,157,10011101
12,00001100,19,00010011,31,00011111
112,01110000,70,01000110,182,10110110
22,00010110,75,01001011,97,01100001
42,00101010,81,01010001,123,01111011
70,01000110,104,01101000,174,10101110
74,01001010,2,00000010,76,01001100
80,01010000,95,01011111,175,10101111
7,00000111,77,01001101,84,01010100
21,00010101,91,01011011,112,01110000
49,00110001,77,01001101,126,01111110
9,00001001,59,00111011,68,01000100
41,00101001,126,01111110,167,10100111
94,01011110,73,01001001,167,10100111
62,00111110,43,00101011,105,01101001
35,00100011,118,01110110,153,10011001
117,01110101,10,00001010,127,01111111
117,01110101,40,00101000,157,10011101
73,01001001,58,00111010,131,10000011
99,01100011,112,01110000,211,11010011
100,01100100,24,00011000,124,01111100
44,00101100,47,00101111,91,01011011
70,01000110,39,00100111,109,01101101
3,00000011,106,01101010,109,01101101
118,01110110,3,00000011,121,01111001
9,00001001,34,00100010,43,00101011
103,01100111,45,00101101,148,10010100
45,00101101,97,01100001,142,10001110
36,00100100,50,00110010,86,01010110
16,00010000,121,01111001,137,10001001
38,00100110,43,00101011,81,01010001
105,01101001,102,01100110,207,11001111
103,01100111,32,00100000,135,10000111
117,01110101,41,00101001,158,10011110
34,00100010,44,00101100,78,01001110
107,01101011,24,00011000,131,10000011
46,00101110,22,00010110,68,01000100
74,01001010,16,00010000,90,01011010
97,01100001,118,01110110,215,11010111
44,00101100,46,00101110,90,01011010
117,01110101,89,01011001,206,11001110
0,00000000,117,01110101,117,01110101
96,01100000,116,01110100,212,11010100
90,01011010,63,00111111,153,10011001
92,01011100,54,00110110,146,10010010
21,00010101,32,00100000,53,00110101
47,00101111,112,01110000,159,10011111
99,01100011,110,01101110,209,11010001
116,01110100,19,00010011,135,10000111
120,01111000,67,01000011,187,10111011
16,00010000,98,01100010,114,01110010
113,01110001,2,00000010,115,01110011
49,00110001,42,00101010,91,01011011
78,01001110,120,01111000,198,11000110
99,01100011,48,00110000,147,10010011
3,00000011,106,01101010,109,01101101
123,01111011,61,00111101,184,10111000
17,00010001,23,00010111,40,00101000
102,01100110,15,00001111,117,01110101
30,00011110,101,01100101,131,10000011
123,01111011,37,00100101,160,10100000
115,01110011,41,00101001,156,10011100
72,01001000,107,01101011,179,10110011
83,01010011,93,01011101,176,10110000
77,01001101,60,00111100,137,10001001
88,01011000,53,00110101,141,10001101
29,00011101,126,01111110,155,10011011
74,01001010,87,01010111,161,10100001
72,01001000,7,00000111,79,01001111
7,00000111,80,01010000,87,01010111
28,00011100,97,01100001,125,01111101
17,00010001,24,00011000,41,00101001
64,01000000,34,00100010,98,01100010
31,00011111,60,00111100,91,01011011
95,01011111,74,01001010,169,10101001
87,01010111,117,01110101,204,11001100
44,00101100,23,00010111,67,01000011
73,01001001,77,01001101,150,10010110
112,01110000,5,00000101,117,01110101
41,00101001,14,00001110,55,00110111
10,00001010,52,00110100,62,00111110
29,00011101,118,01110110,147,10010011
91,01011011,36,00100100,127,01111111
15,00001111,81,01010001,96,01100000
121,01111001,40,00101000,161,10100001
28,00011100,3,00000011,31,00011111
31,00011111,54,00110110,85,01010101
114,01110010,102,01100110,216,11011000
35,00100011,41,00101001,76,01001100
42,00101010,45,00101101,87,01010111
18,00010010,65,01000001,83,01010011
114,01110010,109,01101101,223,11011111
125,01111101,99,01100011,224,11100000
113,01110001,41,00101001,154,10011010
119,01110111,114,01110010,233,11101001
7,00000111,18,00010010,25,00011001
100,01100100,94,01011110,194,11000010
88,01011000,29,00011101,117,01110101
36,00100100,54,00110110,90,01011010
44,00101100,49,00110001,93,01011101
64,01000000,86,01010110,150,10010110
78,01001110,86,01010110,164,10100100
16,00010000,120,01111000,136,10001000
26,00011010,38,00100110,64,01000000
43,00101011,36,00100100,79,01001111
75,01001011,54,00110110,129,10000001
104,01101000,3,00000011,107,01101011
60,00111100,20,00010100,80,01010000
57,00111001,122,01111010,179,10110011
11,00001011,45,00101101,56,00111000
65,01000001,102,01100110,167,10100111
90,01011010,17,00010001,107,01101011
4,00000100,116,01110100,120,01111000
36,00100100,55,00110111,91,01011011
4,00000100,22,00010110,26,00011010
68,01000100,80,01010000,148,10010100
72,01001000,119,01110111,191,10111111
0,00000000,7,00000111,7,00000111
15,00001111,0,00000000,15,00001111
38,00100110,20,00010100,58,00111010
101,01100101,27,00011011,128,10000000
117,01110101,21,00010101,138,10001010
78,01001110,56,00111000,134,10000110
100,01100100,12,00001100,112,01110000
7,00000111,111,01101111,118,01110110
118,01110110,108,01101100,226,11100010
36,00100100,87,01010111,123,01111011
123,01111011,35,00100011,158,10011110
85,01010101,27,00011011,112,01110000
119,01110111,82,01010010,201,11001001
75,01001011,125,01111101,200,11001000
82,01010010,46,00101110,128,10000000
92,01011100,123,01111011,215,11010111
68,01000100,29,00011101,97,01100001
28,00011100,3,00000011,31,00011111
104,01101000,0,00000000,104,01101000
8,00001000,12,00001100,20,00010100
20,00010100,116,01110100,136,10001000
106,01101010,127,01111111,233,11101001
82,01010010,85,01010101,167,10100111
78,01001110,33,00100001,111,01101111
119,01110111,24,00011000,143,10001111
93,01011101,9,00001001,102,01100110
41,00101001,19,00010011,60,00111100
116,01110100,87,01010111,203,11001011
106,01101010,79,01001111,185,10111001
83,01010011,80,01010000,163,10100011
65,01000001,61,00111101,126,01111110
87,01010111,123,01111011,210,11010010
29,00011101,47,00101111,76,01001100
3,00000011,114,01110010,117,01110101
108,01101100,78,01001110,186,10111010
22,00010110,55,00110111,77,01001101
53,00110101,91,01011011,144,10010000
50,00110010,107,01101011,157,10011101
24,00011000,92,01011100,116,01110100
83,01010011,95,01011111,178,10110010
25,00011001,58,00111010,83,01010011
114,01110010,2,00000010,116,01110100
29,00011101,49,00110001,78,01001110
51,00110011,85,01010101,136,10001000
52,00110100,20,00010100,72,01001000
19,00010011,98,01100010,117,01110101
86,01010110,7,00000111,93,01011101
52,00110100,89,01011001,141,10001101
10,00001010,52,00110100,62,00111110
48,00110000,114,01110010,162,10100010
103,01100111,126,01111110,229,11100101
86,01010110,18,00010010,104,01101000
23,00010111,82,01010010,105,01101001
86,01010110,116,01110100,202,11001010
100,01100100,52,00110100,152,10011000
123,01111011,103,01100111,226,11100010
0,00000000,60,00111100,60,00111100
92,01011100,4,00000100,96,01100000
122,01111010,42,00101010,164,10100100
82,01010010,70,01000110,152,10011000
124,01111100,33,00100001,157,10011101
102,01100110,36,00100100,138,10001010
93,01011101,118,01110110,211,11010011
44,00101100,114,01110010,158,10011110
103,01100111,56,00111000,159,10011111
0,00000000,120,01111000,120,01111000
48,00110000,109,01101101,157,10011101
24,00011000,25,00011001,49,00110001
49,00110001,21,00010101,70,01000110
60,00111100,1,00000001,61,00111101
96,01100000,62,00111110,158,10011110
60,00111100,8,00001000,68,01000100
121,01111001,125,01111101,246,11110110
8,00001000,59,00111011,67,01000011
119,01110111,32,00100000,151,10010111
95,01011111,56,00111000,151,10010111
87,01010111,23,00010111,110,01101110
57,00111001,15,00001111,72,01001000
127,01111111,38,00100110,165,10100101
37,00100101,54,00110110,91,01011011
96,01100000,54,00110110,150,10010110
96,01100000,41,00101001,137,10001001
110,01101110,29,00011101,139,10001011
124,01111100,45,00101101,169,10101001
127,01111111,1,00000001,128,10000000
31,00011111,126,01111110,157,10011101
30,00011110,89,01011001,119,01110111
35,00100011,18,00010010,53,00110101
31,00011111,68,01000100,99,01100011
6,00000110,73,01001001,79,01001111
114,01110010,71,01000111,185,10111001
5,00000101,43,00101011,48,00110000
62,00111110,121,01111001,183,10110111
98,01100010,91,01011011,189,10111101
73,01001001,99,01100011,172,10101100
48,00110000,110,01101110,158,10011110
86,01010110,100,01100100,186,10111010
119,01110111,3,00000011,122,01111010
83,01010011,59,00111011,142,10001110
20,00010100,16,00010000,36,00100100
37,00100101,45,00101101,82,01010010
3,00000011,127,01111111,130,10000010
24,00011000,108,01101100,132,10000100
63,00111111,32,00100000,95,01011111
72,01001000,85,01010101,157,10011101
24,00011000,68,01000100,92,01011100
7,00000111,28,00011100,35,00100011
103,01100111,49,00110001,152,10011000
94,01011110,98,01100010,192,11000000
102,01100110,100,01100100,202,11001010
64,01000000,67,01000011,131,10000011
94,01011110,101,01100101,195,11000011
51,00110011,50,00110010,101,01100101
60,00111100,74,01001010,134,10000110
58,00111010,80,01010000,138,10001010
84,01010100,12,00001100,96,01100000
126,01111110,8,00001000,134,10000110
67,01000011,99,01100011,166,10100110
123,01111011,117,01110101,240,11110000
41,00101001,92,01011100,133,10000101
33,00100001,8,00001000,41,00101001
99,01100011,44,00101100,143,10001111
16,00010000,8,00001000,24,00011000
13,00001101,52,00110100,65,01000001
10,00001010,114,01110010,124,01111100
118,01110110,112,01110000,230,11100110
64,01000000,58,00111010,122,01111010
16,00010000,39,00100111,55,00110111
76,01001100,29,00011101,105,01101001
20,00010100,116,01110100,136,10001000
32,00100000,123,01111011,155,10011011
87,01010111,10,00001010,97,01100001
18,00010010,11,00001011,29,00011101
42,00101010,11,00001011,53,00110101
71,01000111,70,01000110,141,10001101
23,00010111,119,01110111,142,10001110
64,01000000,96,01100000,160,10100000
8,00001000,54,00110110,62,00111110
3,00000011,6,00000110,9,00001001
110,01101110,18,00010010,128,10000000
68,01000100,80,01010000,148,10010100
92,01011100,51,00110011,143,10001111
72,01001000,90,01011010,162,10100010
51,00110011,115,01110011,166,10100110
4,00000100,109,01101101,113,01110001
115,01110011,27,00011011,142,10001110
0,00000000,28,00011100,28,00011100
94,01011110,30,00011110,124,01111100
45,00101101,72,01001000,117,01110101
60,00111100,17,00010001,77,01001101
82,01010010,50,00110010,132,10000100
122,01111010,94,01011110,216,11011000
78,01001110,47,00101111,125,01111101
22,00010110,15,00001111,37,00100101
87,01010111,126,01111110,213,11010101
27,00011011,33,00100001,60,00111100
117,01110101,62,00111110,179,10110011
69,01000101,88,01011000,157,10011101
60,00111100,79,01001111,139,10001011
59,00111011,119,01110111,178,10110010
2,00000010,10,00001010,12,00001100
14,00001110,0,00000000,14,00001110
103,01100111,39,00100111,142,10001110
15,00001111,82,01010010,97,01100001
112,01110000,31,00011111,143,10001111
73,01001001,105,01101001,178,10110010
121,01111001,42,00101010,163,10100011
79,01001111,121,01111001,200,11001000
103,01100111,120,01111000,223,11011111
100,01100100,67,01000011,167,10100111
27,00011011,48,00110000,75,01001011
21,00010101,36,00100100,57,00111001
20,00010100,103,01100111,123,01111011
95,01011111,113,01110001,208,11010000
11,00001011,122,01111010,133,10000101
24,00011000,81,01010001,105,01101001
76,01001100,66,01000010,142,10001110
122,01111010,65,01000001,187,10111011
122,01111010,17,00010001,139,10001011
113,01110001,76,01001100,189,10111101
37,00100101,52,00110100,89,01011001
51,00110011,46,00101110,97,01100001
108,01101100,101,01100101,209,11010001
43,00101011,4,00000100,47,00101111
35,00100011,47,00101111,82,01010010
62,00111110,22,00010110,84,01010100
95,01011111,0,00000000,95,01011111
50,00110010,72,01001000,122,01111010
28,00011100,56,00111000,84,01010100
113,01110001,107,01101011,220,11011100
119,01110111,58,00111010,177,10110001
13,00001101,50,00110010,63,00111111
108,01101100,67,01000011,175,10101111
120,01111000,117,01110101,237,11101101
39,00100111,100,01100100,139,10001011
57,00111001,54,00110110,111,01101111
7,00000111,3,00000011,10,00001010
54,00110110,43,00101011,97,01100001
104,01101000,70,01000110,174,10101110
64,01000000,22,00010110,86,01010110
97,01100001,94,01011110,191,10111111
72,01001000,78,01001110,150,10010110
80,01010000,78,01001110,158,10011110
50,00110010,1,00000001,51,00110011
62,00111110,3,00000011,65,01000001
23,00010111,26,00011010,49,00110001
49,00110001,23,00010111,72,01001000
10,00001010,15,00001111,25,00011001
65,01000001,124,01111100,189,10111101
84,01010100,87,01010111,171,10101011
22,00010110,107,01101011,129,10000001
116,01110100,14,00001110,130,10000010
17,00010001,46,00101110,63,00111111
111,01101111,77,01001101,188,10111100
48,00110000,61,00111101,109,01101101
81,01010001,49,00110001,130,10000010
29,00011101,124,01111100,153,10011001
67,01000011,12,00001100,79,01001111
24,00011000,24,00011000,48,00110000
62,00111110,37,00100101,99,01100011
75,01001011,101,01100101,176,10110000
10,00001010,70,01000110,80,01010000
44,00101100,2,00000010,46,00101110
27,00011011,57,00111001,84,01010100
86,01010110,125,01111101,211,11010011
113,01110001,76,01001100,189,10111101
127,01111111,5,00000101,132,10000100
15,00001111,22,00010110,37,00100101
61,00111101,49,00110001,110,01101110
50,00110010,32,00100000,82,01010010
82,01010010,79,01001111,161,10100001
50,00110010,24,00011000,74,01001010
57,00111001,2,00000010,59,00111011
20,00010100,17,00010001,37,00100101
101,01100101,60,00111100,161,10100001
86,01010110,93,01011101,179,10110011
116,01110100,7,00000111,123,01111011
24,00011000,16,00010000,40,00101000
67,01000011,61,00111101,128,10000000
109,01101101,5,00000101,114,01110010
113,01110001,32,00100000,145,10010001
48,00110000,110,01101110,158,10011110
12,00001100,1,00000001,13,00001101
69,01000101,43,00101011,112,01110000
18,00010010,73,01001001,91,01011011
34,00100010,56,00111000,90,01011010
112,01110000,106,01101010,218,11011010
125,01111101,104,01101000,229,11100101
115,01110011,85,01010101,200,11001000
44,00101100,121,01111001,165,10100101
64,01000000,121,01111001,185,10111001
56,00111000,74,01001010,130,10000010
52,00110100,121,01111001,173,10101101
10,00001010,92,01011100,102,01100110
20,00010100,22,00010110,42,00101010
53,00110101,98,01100010,151,10010111
65,01000001,6,00000110,71,01000111
5,00000101,96,01100000,101,01100101
46,00101110,73,01001001,119,01110111
41,00101001,88,01011000,129,10000001
112,01110000,115,01110011,227,11100011
33,00100001,36,00100100,69,01000101
46,00101110,107,01101011,153,10011001
116,01110100,75,01001011,191,10111111
108,01101100,113,01110001,221,11011101
64,01000000,34,00100010,98,01100010
60,00111100,12,00001100,72,01001000
57,00111001,37,00100101,94,01011110
64,01000000,84,01010100,148,10010100
43,00101011,63,00111111,106,01101010
69,01000101,113,01110001,182,10110110
81,01010001,33,00100001,114,01110010
33,00100001,71,01000111,104,01101000
115,01110011,74,01001010,189,10111101
71,01000111,107,01101011,178,10110010
2,00000010,67,01000011,69,01000101
12,00001100,42,00101010,54,00110110
14,00001110,34,00100010,48,00110000
99,01100011,21,00010101,120,01111000
23,00010111,8,00001000,31,00011111
112,01110000,25,00011001,137,10001001
12,00001100,41,00101001,53,00110101
41,00101001,102,01100110,143,10001111
38,00100110,126,01111110,164,10100100
121,01111001,47,00101111,168,10101000
11,00001011,6,00000110,17,00010001
75,01001011,15,00001111,90,01011010
81,01010001,116,01110100,197,11000101
18,00010010,116,01110100,134,10000110
5,00000101,122,01111010,127,01111111
15,00001111,5,00000101,20,00010100
75,01001011,99,01100011,174,10101110
67,01000011,33,00100001,100,01100100
41,00101001,80,01010000,121,01111001
15,00001111,44,00101100,59,00111011
126,01111110,109,01101101,235,11101011
24,00011000,34,00100010,58,00111010
62,00111110,68,01000100,130,10000010
8,00001000,48,00110000,56,00111000
51,00110011,36,00100100,87,01010111
90,01011010,43,00101011,133,10000101
65,01000001,17,00010001,82,01010010
56,00111000,10,00001010,66,01000010
7,00000111,69,01000101,76,01001100
26,00011010,59,00111011,85,01010101
10,00001010,25,00011001,35,00100011
38,00100110,78,01001110,116,01110100
46,00101110,123,01111011,169,10101001
89,01011001,53,00110101,142,10001110
108,01101100,64,01000000,172,10101100
118,01110110,93,01011101,211,11010011
123,01111011,10,00001010,133,10000101
85,01010101,35,00100011,120,01111000
53,00110101,53,00110101,106,01101010
60,00111100,85,01010101,145,10010001
92,01011100,126,01111110,218,11011010
25,00011001,63,00111111,88,01011000
4,00000100,77,01001101,81,01010001
79,01001111,10,00001010,89,01011001
23,00010111,101,01100101,124,01111100
104,01101000,1,00000001,105,01101001
58,00111010,67,01000011,125,01111101
28,00011100,13,00001101,41,00101001
77,01001101,0,00000000,77,01001101
62,00111110,66,01000010,128,10000000
55,00110111,122,01111010,177,10110001
62,00111110,93,01011101,155,10011011
104,01101000,58,00111010,162,10100010
76,01001100,125,01111101,201,11001001
94,01011110,29,00011101,123,01111011
24,00011000,54,00110110,78,01001110
125,01111101,117,01110101,242,11110010
118,01110110,77,01001101,195,11000011
126,01111110,10,00001010,136,10001000
29,00011101,66,01000010,95,01011111
125,01111101,71,01000111,196,11000100
124,01111100,67,01000011,191,10111111
48,00110000,92,01011100,140,10001100
100,01100100,111,01101111,211,11010011
125,01111101,32,00100000,157,10011101
126,01111110,106,01101010,232,11101000
45,00101101,55,00110111,100,01100100
109,01101101,15,00001111,124,01111100
118,01110110,120,01111000,238,11101110
64,01000000,42,00101010,106,01101010
31,00011111,21,00010101,52,00110100
9,00001001,52,00110100,61,00111101
48,00110000,13,00001101,61,00111101
119,01110111,87,01010111,206,11001110
52,00110100,19,00010011,71,01000111
89,01011001,12,00001100,101,01100101
101,01100101,23,00010111,124,01111100
117,01110101,2,00000010,119,01110111
70,01000110,87,01010111,157,10011101
92,01011100,66,01000010,158,10011110
119,01110111,48,00110000,167,10100111
84,01010100,56,00111000,140,10001100
97,01100001,112,01110000,209,11010001
36,00100100,34,00100010,70,01000110
37,00100101,107,01101011,144,10010000
26,00011010,34,00100010,60,00111100
117,01110101,101,01100101,218,11011010
83,01010011,119,01110111,202,11001010
60,00111100,30,00011110,90,01011010
55,00110111,17,00010001,72,01001000
14,00001110,12,00001100,26,00011010
70,01000110,37,00100101,107,01101011
80,01010000,24,00011000,104,01101000
64,01000000,94,01011110,158,10011110
107,01101011,79,01001111,186,10111010
16,00010000,91,01011011,107,01101011
42,00101010,4,00000100,46,00101110
124,01111100,123,01111011,247,11110111
37,00100101,73,01001001,110,01101110
70,01000110,27,00011011,97,01100001
32,00100000,30,00011110,62,00111110
118,01110110,32,00100000,150,10010110
36,00100100,27,00011011,63,00111111
102,01100110,70,01000110,172,10101100
71,01000111,124,01111100,195,11000011
33,00100001,77,01001101,110,01101110
52,00110100,4,00000100,56,00111000
70,01000110,89,01011001,159,10011111
105,01101001,118,01110110,223,11011111
88,01011000,46,00101110,134,10000110
63,00111111,116,01110100,179,10110011
50,00110010,110,01101110,160,10100000
17,00010001,75,01001011,92,01011100
125,01111101,25,00011001,150,10010110
114,01110010,15,00001111,129,10000001
83,01010011,8,00001000,91,01011011
15,00001111,28,00011100,43,00101011
27,00011011,100,01100100,127,01111111
125,01111101,60,00111100,185,10111001
116,01110100,0,00000000,116,01110100
20,00010100,114,01110010,134,10000110
67,01000011,116,01110100,183,10110111
20,00010100,53,00110101,73,01001001
88,01011000,1,00000001,89,01011001
62,00111110,124,01111100,186,10111010
98,01100010,44,00101100,142,10001110
95,01011111,86,01010110,181,10110101
35,00100011,98,01100010,133,10000101
62,00111110,71,01000111,133,10000101
18,00010010,80,01010000,98,01100010
31,00011111,124,01111100,155,10011011
22,00010110,77,01001101,99,01100011
68,01000100,71,01000111,139,10001011
78,01001110,2,00000010,80,01010000
89,01011001,90,01011010,179,10110011
123,01111011,45,00101101,168,10101000
110,01101110,71,01000111,181,10110101
53,00110101,14,00001110,67,01000011
78,01001110,52,00110100,130,10000010
2,00000010,76,01001100,78,01001110
109,01101101,1,00000001,110,01101110
56,00111000,98,01100010,154,10011010
3,00000011,77,01001101,80,01010000
15,00001111,3,00000011,18,00010010
90,01011010,30,00011110,120,01111000
97,01100001,43,00101011,140,10001100
37,00100101,3,00000011,40,00101000
0,00000000,125,01111101,125,01111101
44,00101100,31,00011111,75,01001011
122,01111010,88,01011000,210,11010010
86,01010110,32,00100000,118,01110110
113,01110001,66,01000010,179,10110011
40,00101000,73,01001001,113,01110001
37,00100101,98,01100010,135,10000111
34,00100010,126,01111110,160,10100000
76,01001100,33,00100001,109,01101101
79,01001111,43,00101011,122,01111010
88,01011000,11,00001011,99,01100011
103,01100111,115,01110011,218,11011010
76,01001100,81,01010001,157,10011101
59,00111011,66,01000010,125,01111101
1,00000001,7,00000111,8,00001000
26,00011010,58,00111010,84,01010100
23,00010111,2,00000010,25,00011001
37,00100101,94,01011110,131,10000011
95,01011111,53,00110101,148,10010100
13,00001101,104,01101000,117,01110101
76,01001100,5,00000101,81,01010001
55,00110111,92,01011100,147,10010011
11,00001011,102,01100110,113,01110001
16,00010000,6,00000110,22,00010110
67,01000011,80,01010000,147,10010011
126,01111110,107,01101011,233,11101001
110,01101110,32,00100000,142,10001110
87,01010111,86,01010110,173,10101101
65,01000001,28,00011100,93,01011101
3,00000011,62,00111110,65,01000001
112,01110000,52,00110100,164,10100100
112,01110000,93,01011101,205,11001101
51,00110011,83,01010011,134,10000110
21,00010101,25,00011001,46,00101110
47,00101111,20,00010100,67,01000011
21,00010101,78,01001110,99,01100011
114,01110010,114,01110010,228,11100100
47,00101111,76,01001100,123,01111011
1,00000001,100,01100100,101,01100101
54,00110110,75,01001011,129,10000001
27,00011011,37,00100101,64,01000000
101,01100101,75,01001011,176,10110000
60,00111100,42,00101010,102,01100110
127,01111111,62,00111110,189,10111101
46,00101110,65,01000001,111,01101111
100,01100100,0,00000000,100,01100100
67,01000011,105,01101001,172,10101100
94,01011110,99,01100011,193,11000001
55,00110111,92,01011100,147,10010011
74,01001010,65,01000001,139,10001011
125,01111101,34,00100010,159,10011111
61,00111101,22,00010110,83,01010011
62,00111110,3,00000011,65,01000001
50,00110010,31,00011111,81,01010001
52,00110100,13,00001101,65,01000001
72,01001000,79,01001111,151,10010111
33,00100001,30,00011110,63,00111111
90,01011010,116,01110100,206,11001110
119,01110111,25,00011001,144,10010000
71,01000111,56,00111000,127,01111111
120,01111000,1,00000001,121,01111001
20,00010100,82,01010010,102,01100110
4,00000100,40,00101000,44,00101100
5,00000101,57,00111001,62,00111110
81,01010001,74,01001010,155,10011011
32,00100000,126,01111110,158,10011110
74,01001010,123,01111011,197,11000101
127,01111111,92,01011100,219,11011011
67,01000011,50,00110010,117,01110101
122,01111010,100,01100100,222,11011110
59,00111011,48,00110000,107,01101011
58,00111010,45,00101101,103,01100111
49,00110001,31,00011111,80,01010000
41,00101001,114,01110010,155,10011011
103,01100111,127,01111111,230,11100110
78,01001110,81,01010001,159,10011111
79,01001111,102,01100110,181,10110101
61,00111101,13,00001101,74,01001010
80,01010000,44,00101100,124,01111100
107,01101011,69,01000101,176,10110000
95,01011111,56,00111000,151,10010111
81,01010001,35,00100011,116,01110100
93,01011101,85,01010101,178,10110010
35,00100011,115,01110011,150,10010110
58,00111010,67,01000011,125,01111101
23,00010111,66,01000010,89,01011001
92,01011100,72,01001000,164,10100100
6,00000110,4,00000100,10,00001010
122,01111010,102,01100110,224,11100000
43,00101011,58,00111010,101,01100101
62,00111110,28,00011100,90,01011010
86,01010110,106,01101010,192,11000000
0,00000000,9,00001001,9,00001001
68,01000100,126,01111110,194,11000010
116,01110100,124,01111100,240,11110000
49,00110001,33,00100001,82,01010010
34,00100010,93,01011101,127,01111111
94,01011110,9,00001001,103,01100111
127,01111111,60,00111100,187,10111011
38,00100110,29,00011101,67,01000011
32,00100000,103,01100111,135,10000111
51,00110011,61,00111101,112,01110000
102,01100110,65,01000001,167,10100111
80,01010000,83,01010011,163,10100011
103,01100111,29,00011101,132,10000100
94,01011110,89,01011001,183,10110111
114,01110010,64,01000000,178,10110010
16,00010000,96,01100000,112,01110000
51,00110011,2,00000010,53,00110101
85,01010101,122,01111010,207,11001111
93,01011101,124,01111100,217,11011001
89,01011001,36,00100100,125,01111101
61,00111101,69,01000101,130,10000010
74,01001010,27,00011011,101,01100101
108,01101100,55,00110111,163,10100011
20,00010100,40,00101000,60,00111100
49,00110001,1,00000001,50,00110010
84,01010100,15,00001111,99,01100011
102,01100110,125,01111101,227,11100011
10,00001010,116,01110100,126,01111110
94,01011110,16,00010000,110,01101110
64,01000000,9,00001001,73,01001001
27,00011011,103,01100111,130,10000010
19,00010011,75,01001011,94,01011110
21,00010101,9,00001001,30,00011110
113,01110001,12,00001100,125,01111101
121,01111001,10,00001010,131,10000011
123,01111011,77,01001101,200,11001000
61,00111101,43,00101011,104,01101000
73,01001001,8,00001000,81,01010001
73,01001001,114,01110010,187,10111011
85,01010101,9,00001001,94,01011110
102,01100110,31,00011111,133,10000101
4,00000100,118,01110110,122,01111010
122,01111010,64,01000000,186,10111010
16,00010000,32,00100000,48,00110000
125,01111101,63,00111111,188,10111100
29,00011101,36,00100100,65,01000001
46,00101110,9,00001001,55,00110111
97,01100001,95,01011111,192,11000000
75,01001011,45,00101101,120,01111000
32,00100000,82,01010010,114,01110010
88,01011000,24,00011000,112,01110000
48,00110000,59,00111011,107,01101011
37,00100101,83,01010011,120,01111000
38,00100110,16,00010000,54,00110110
61,00111101,18,00010010,79,01001111
99,01100011,112,01110000,211,11010011
79,01001111,74,01001010,153,10011001
97,01100001,91,01011011,188,10111100
95,01011111,91,01011011,186,10111010
25,00011001,9,00001001,34,00100010
85,01010101,53,00110101,138,10001010
81,01010001,5,00000101,86,01010110
101,01100101,57,00111001,158,10011110
69,01000101,69,01000101,138,10001010
98,01100010,48,00110000,146,10010010
12,00001100,81,01010001,93,01011101
108,01101100,86,01010110,194,11000010
58,00111010,21,00010101,79,01001111
113,01110001,98,01100010,211,11010011
120,01111000,34,00100010,154,10011010
100,01100100,113,01110001,213,11010101
60,00111100,41,00101001,101,01100101
12,00001100,27,00011011,39,00100111
59,00111011,27,00011011,86,01010110
5,00000101,12,00001100,17,00010001
68,01000100,119,01110111,187,10111011
63,00111111,116,01110100,179,10110011
84,01010100,63,00111111,147,10010011
2,00000010,24,00011000,26,00011010
15,00001111,81,01010001,96,01100000
94,01011110,13,00001101,107,01101011
43,00101011,89,01011001,132,10000100
59,00111011,92,01011100,151,10010111
53,00110101,15,00001111,68,01000100
4,00000100,64,01000000,68,01000100
98,01100010,121,01111001,219,11011011
80,01010000,34,00100010,114,01110010
9,00001001,69,01000101,78,01001110
73,01001001,6,00000110,79,01001111
66,01000010,0,00000000,66,01000010
54,00110110,33,00100001,87,01010111
96,01100000,89,01011001,185,10111001
65,01000001,52,00110100,117,01110101
103,01100111,38,00100110,141,10001101
89,01011001,0,00000000,89,01011001
55,00110111,121,01111001,176,10110000
24,00011000,92,01011100,116,01110100
63,00111111,126,01111110,189,10111101
8,00001000,27,00011011,35,00100011
7,00000111,60,00111100,67,01000011
39,00100111,3,00000011,42,00101010
114,01110010,100,01100100,214,11010110
9,00001001,62,00111110,71,01000111
24,00011000,63,00111111,87,01010111
121,01111001,109,01101101,230,11100110
108,01101100,102,01100110,210,11010010
86,01010110,67,01000011,153,10011001
113,01110001,115,01110011,228,11100100
72,01001000,105,01101001,177,10110001
49,00110001,116,01110100,165,10100101
20,00010100,28,00011100,48,00110000
76,01001100,51,00110011,127,01111111
46,00101110,79,01001111,125,01111101
89,01011001,4,00000100,93,01011101
44,00101100,23,00010111,67,01000011
52,00110100,63,00111111,115,01110011
27,00011011,114,01110010,141,10001101
56,00111000,16,00010000,72,01001000
127,01111111,101,01100101,228,11100100
83,01010011,62,00111110,145,10010001
53,00110101,17,00010001,70,01000110
100,01100100,92,01011100,192,11000000
110,01101110,37,00100101,147,10010011
19,00010011,78,01001110,97,01100001
100,01100100,117,01110101,217,11011001
116,01110100,25,00011001,141,10001101
88,01011000,67,01000011,155,10011011
124,01111100,20,00010100,144,10010000
48,00110000,105,01101001,153,10011001
43,00101011,18,00010010,61,00111101
44,00101100,45,00101101,89,01011001
92,01011100,72,01001000,164,10100100
53,00110101,39,00100111,92,01011100
78,01001110,33,00100001,111,01101111
88,01011000,89,01011001,177,10110001
18,00010010,110,01101110,128,10000000
67,01000011,23,00010111,90,01011010
50,00110010,124,01111100,174,10101110
98,01100010,20,00010100,118,01110110
47,00101111,104,01101000,151,10010111
94,01011110,89,01011001,183,10110111
100,01100100,42,00101010,142,10001110
17,00010001,85,01010101,102,01100110
60,00111100,68,01000100,128,10000000
51,00110011,97,01100001,148,10010100
71,01000111,35,00100011,106,01101010
8,00001000,45,00101101,53,00110101
69,01000101,71,01000111,140,10001100
34,00100010,120,01111000,154,10011010
24,00011000,65,01000001,89,01011001
97,01100001,27,00011011,124,01111100
5,00000101,17,00010001,22,00010110
56,00111000,99,01100011,155,10011011
27,00011011,95,01011111,122,01111010
78,01001110,76,01001100,154,10011010
44,00101100,43,00101011,87,01010111
58,00111010,25,00011001,83,01010011
99,01100011,8,00001000,107,01101011
50,00110010,57,00111001,107,01101011
43,00101011,77,01001101,120,01111000
19,00010011,56,00111000,75,01001011
48,00110000,109,01101101,157,10011101
76,01001100,59,00111011,135,10000111
78,01001110,2,00000010,80,01010000
120,01111000,42,00101010,162,10100010
39,00100111,116,01110100,155,10011011
33,00100001,112,01110000,145,10010001
50,00110010,54,00110110,104,01101000
18,00010010,115,01110011,133,10000101
30,00011110,7,00000111,37,00100101
76,01001100,115,01110011,191,10111111
77,01001101,78,01001110,155,10011011
84,01010100,59,00111011,143,10001111
83,01010011,110,01101110,193,11000001
40,00101000,105,01101001,145,10010001
77,01001101,72,01001000,149,10010101
18,00010010,65,01000001,83,01010011
14,00001110,105,01101001,119,01110111
4,00000100,10,00001010,14,00001110
98,01100010,127,01111111,225,11100001
56,00111000,102,01100110,158,10011110
118,01110110,38,00100110,156,10011100
55,00110111,34,00100010,89,01011001
119,01110111,85,01010101,204,11001100
9,00001001,37,00100101,46,00101110
60,00111100,66,01000010,126,01111110
20,00010100,82,01010010,102,01100110
69,01000101,79,01001111,148,10010100
26,00011010,110,01101110,136,10001000
82,01010010,48,00110000,130,10000010
127,01111111,116,01110100,243,11110011
47,00101111,2,00000010,49,00110001
33,00100001,61,00111101,94,01011110
77,01001101,22,00010110,99,01100011
79,01001111,93,01011101,172,10101100
6,00000110,18,00010010,24,00011000
30,00011110,87,01010111,117,01110101
102,01100110,92,01011100,194,11000010
121,01111001,73,01001001,194,11000010
11,00001011,26,00011010,37,00100101
52,00110100,92,01011100,144,10010000
57,00111001,106,01101010,163,10100011
35,00100011,9,00001001,44,00101100
61,00111101,118,01110110,179,10110011
11,00001011,18,00010010,29,00011101
28,00011100,101,01100101,129,10000001
107,01101011,43,00101011,150,10010110
11,00001011,105,01101001,116,01110100
20,00010100,121,01111001,141,10001101
42,00101010,113,01110001,155,10011011
1,00000001,18,00010010,19,00010011
15,00001111,42,00101010,57,00111001
31,00011111,57,00111001,88,01011000
109,01101101,86,01010110,195,11000011
41,00101001,60,00111100,101,01100101
110,01101110,28,00011100,138,10001010
92,01011100,111,01101111,203,11001011
39,00100111,120,01111000,159,10011111
42,00101010,114,01110010,156,10011100
121,01111001,73,01001001,194,11000010
23,00010111,70,01000110,93,01011101
103,01100111,74,01001010,177,10110001
73,01001001,2,00000010,75,01001011
50,00110010,97,01100001,147,10010011
78,01001110,93,01011101,171,10101011
74,01001010,56,00111000,130,10000010
64,01000000,40,00101000,104,01101000
96,01100000,86,01010110,182,10110110
10,00001010,71,01000111,81,01010001
59,00111011,85,01010101,144,10010000
104,01101000,47,00101111,151,10010111
61,00111101,106,01101010,167,10100111
44,00101100,20,00010100,64,01000000
49,00110001,38,00100110,87,01010111
16,00010000,81,01010001,97,01100001
87,01010111,120,01111000,207,11001111
39,00100111,53,00110101,92,01011100
96,01100000,110,01101110,206,11001110
103,01100111,126,01111110,229,11100101
113,01110001,64,01000000,177,10110001
78,01001110,67,01000011,145,10010001
69,01000101,118,01110110,187,10111011
37,00100101,11,00001011,48,00110000
65,01000001,3,00000011,68,01000100
123,01111011,70,01000110,193,11000001
34,00100010,59,00111011,93,01011101
105,01101001,91,01011011,196,11000100
18,00010010,9,00001001,27,00011011
105,01101001,123,01111011,228,11100100
100,01100100,13,00001101,113,01110001
114,01110010,88,01011000,202,11001010
103,01100111,110,01101110,213,11010101
71,01000111,89,01011001,160,10100000
77,01001101,30,00011110,107,01101011
70,01000110,50,00110010,120,01111000
8,00001000,105,01101001,113,01110001
51,00110011,26,00011010,77,01001101
10,00001010,34,00100010,44,00101100
53,00110101,25,00011001,78,01001110
68,01000100,111,01101111,179,10110011
10,00001010,77,01001101,87,01010111
94,01011110,62,00111110,156,10011100
127,01111111,95,01011111,222,11011110
34,00100010,102,01100110,136,10001000
87,01010111,49,00110001,136,10001000
62,00111110,108,01101100,170,10101010
98,01100010,120,01111000,218,11011010
80,01010000,22,00010110,102,01100110
25,00011001,75,01001011,100,01100100
7,00000111,121,01111001,128,10000000
126,01111110,52,00110100,178,10110010
68,01000100,28,00011100,96,01100000
89,01011001,100,01100100,189,10111101
105,01101001,74,01001010,179,10110011
119,01110111,19,00010011,138,10001010
122,01111010,21,00010101,143,10001111
118,01110110,23,00010111,141,10001101
31,00011111,93,01011101,124,01111100
109,01101101,53,00110101,162,10100010
96,01100000,43,00101011,139,10001011
20,00010100,126,01111110,146,10010010
80,01010000,1,00000001,81,01010001
4,00000100,117,01110101,121,01111001
30,00011110,93,01011101,123,01111011
110,01101110,40,00101000,150,10010110
9,00001001,61,00111101,70,01000110
97,01100001,1,00000001,98,01100010
25,00011001,80,01010000,105,01101001
26,00011010,97,01100001,123,01111011
73,01001001,39,00100111,112,01110000
27,00011011,60,00111100,87,01010111
70,01000110,104,01101000,174,10101110
90,01011010,28,00011100,118,01110110
65,01000001,85,01010101,150,10010110
80,01010000,81,01010001,161,10100001
70,01000110,41,00101001,111,01101111
61,00111101,45,00101101,106,01101010
81,01010001,105,01101001,186,10111010
5,00000101,97,01100001,102,01100110
68,01000100,108,01101100,176,10110000
105,01101001,31,00011111,136,10001000
41,00101001,55,00110111,96,01100000
101,01100101,46,00101110,147,10010011
110,01101110,19,00010011,129,10000001
36,00100100,103,01100111,139,10001011
6,00000110,126,01111110,132,10000100
116,01110100,41,00101001,157,10011101
77,01001101,65,01000001,142,10001110
70,01000110,26,00011010,96,01100000
40,00101000,2,00000010,42,00101010
76,01001100,87,01010111,163,10100011
46,00101110,84,01010100,130,10000010
50,00110010,105,01101001,155,10011011
113,01110001,67,01000011,180,10110100
3,00000011,101,01100101,104,01101000
18,00010010,63,00111111,81,01010001
4,00000100,112,01110000,116,01110100
108,01101100,7,00000111,115,01110011
17,00010001,49,00110001,66,01000010
27,00011011,49,00110001,76,01001100
96,01100000,90,01011010,186,10111010
78,01001110,113,01110001,191,10111111
77,01001101,10,00001010,87,01010111
39,00100111,89,01011001,128,10000000
95,01011111,43,00101011,138,10001010
21,00010101,41,00101001,62,00111110
125,01111101,10,00001010,135,10000111
42,00101010,105,01101001,147,10010011
67,01000011,70,01000110,137,10001001
42,00101010,80,01010000,122,01111010
31,00011111,62,00111110,93,01011101
65,01000001,86,01010110,151,10010111
42,00101010,97,01100001,139,10001011
7,00000111,56,00111000,63,00111111
2,00000010,31,00011111,33,00100001
25,00011001,51,00110011,76,01001100
73,01001001,43,00101011,116,01110100
97,01100001,37,00100101,134,10000110
101,01100101,2,00000010,103,01100111
56,00111000,101,01100101,157,10011101
107,01101011,51,00110011,158,10011110
115,01110011,67,01000011,182,10110110
100,01100100,87,01010111,187,10111011
38,00100110,72,01001000,110,01101110
51,00110011,3,00000011,54,00110110
100,01100100,27,00011011,127,01111111
77,01001101,78,01001110,155,10011011
29,00011101,115,01110011,144,10010000
55,00110111,28,00011100,83,01010011
112,01110000,62,00111110,174,10101110
106,01101010,66,01000010,172,10101100
28,00011100,81,01010001,109,01101101
38,00100110,1,00000001,39,00100111
91,01011011,102,01100110,193,11000001
31,00011111,14,00001110,45,00101101
39,00100111,62,00111110,101,01100101
103,01100111,122,01111010,225,11100001
60,00111100,117,01110101,177,10110001
122,01111010,99,01100011,221,11011101
92,01011100,72,01001000,164,10100100
6,00000110,69,01000101,75,01001011
105,01101001,55,00110111,160,10100000
44,00101100,25,00011001,69,01000101
2,00000010,90,01011010,92,01011100
108,01101100,122,01111010,230,11100110
15,00001111,69,01000101,84,01010100
86,01010110,10,00001010,96,01100000
0,00000000,55,00110111,55,00110111
21,00010101,8,00001000,29,00011101
96,01100000,17,00010001,113,01110001
12,00001100,31,00011111,43,00101011
125,01111101,118,01110110,243,11110011
51,00110011,102,01100110,153,10011001
65,01000001,100,01100100,165,10100101
52,00110100,43,00101011,95,01011111
83,01010011,9,00001001,92,01011100
46,00101110,82,01010010,128,10000000
119,01110111,57,00111001,176,10110000
70,01000110,99,01100011,169,10101001
102,01100110,101,01100101,203,11001011
102,01100110,77,01001101,179,10110011
3,00000011,35,00100011,38,00100110
65,01000001,10,00001010,75,01001011
22,00010110,113,01110001,135,10000111
120,01111000,14,00001110,134,10000110
21,00010101,65,01000001,86,01010110
100,01100100,48,00110000,148,10010100
4,00000100,110,01101110,114,01110010
77,01001101,2,00000010,79,01001111
102,01100110,98,01100010,200,11001000
23,00010111,110,01101110,133,10000101
32,00100000,76,01001100,108,01101100
109,01101101,66,01000010,175,10101111
106,01101010,115,01110011,221,11011101
72,01001000,98,01100010,170,10101010
1,00000001,19,00010011,20,00010100
88,01011000,90,01011010,178,10110010
50,00110010,48,00110000,98,01100010
36,00100100,81,01010001,117,01110101
95,01011111,21,00010101,116,01110100
34,00100010,81,01010001,115,01110011
36,00100100,58,00111010,94,01011110
97,01100001,10,00001010,107,01101011
4,00000100,26,00011010,30,00011110
92,01011100,112,01110000,204,11001100
114,01110010,96,01100000,210,11010010
91,01011011,28,00011100,119,01110111
97,01100001,11,00001011,108,01101100
119,01110111,79,01001111,198,11000110
116,01110100,60,00111100,176,10110000
110,01101110,39,00100111,149,10010101
99,01100011,39,00100111,138,10001010
116,01110100,48,00110000,164,10100100
56,00111000,24,00011000,80,01010000
49,00110001,67,01000011,116,01110100
52,00110100,109,01101101,161,10100001
66,01000010,94,01011110,160,10100000
90,01011010,109,01101101,199,11000111
96,01100000,107,01101011,203,11001011
65,01000001,8,00001000,73,01001001
17,00010001,78,01001110,95,01011111
82,01010010,28,00011100,110,01101110
81,01010001,33,00100001,114,01110010
87,01010111,84,01010100,171,10101011
63,00111111,113,01110001,176,10110000
74,01001010,79,01001111,153,10011001
126,01111110,89,01011001,215,11010111
71,01000111,52,00110100,123,01111011
72,01001000,52,00110100,124,01111100
118,01110110,23,00010111,141,10001101
127,01111111,26,00011010,153,10011001
98,01100010,58,00111010,156,10011100
68,01000100,89,01011001,157,10011101
96,01100000,50,00110010,146,10010010
123,01111011,116,01110100,239,11101111
82,01010010,94,01011110,176,10110000
45,00101101,118,01110110,163,10100011
48,00110000,52,00110100,100,01100100
63,00111111,94,01011110,157,10011101
13,00001101,14,00001110,27,00011011
59,00111011,38,00100110,97,01100001
120,01111000,118,01110110,238,11101110
99,01100011,48,00110000,147,10010011
52,00110100,4,00000100,56,00111000
0,00000000,48,00110000,48,00110000
75,01001011,93,01011101,168,10101000
118,01110110,122,01111010,240,11110000
75,01001011,50,00110010,125,01111101
46,00101110,118,01110110,164,10100100
126,01111110,43,00101011,169,10101001
88,01011000,83,01010011,171,10101011
127,01111111,123,01111011,250,11111010
40,00101000,86,01010110,126,01111110
32,00100000,46,00101110,78,01001110
124,01111100,114,01110010,238,11101110
12,00001100,27,00011011,39,00100111
7,00000111,116,01110100,123,01111011
13,00001101,75,01001011,88,01011000
2,00000010,49,00110001,51,00110011
3,00000011,28,00011100,31,00011111
56,00111000,63,00111111,119,01110111
53,00110101,9,00001001,62,00111110
122,01111010,45,00101101,167,10100111
60,00111100,55,00110111,115,01110011
28,00011100,62,00111110,90,01011010
19,00010011,119,01110111,138,10001010
52,00110100,87,01010111,139,10001011
51,00110011,91,01011011,142,10001110
101,01100101,70,01000110,171,10101011
20,00010100,79,01001111,99,01100011
90,01011010,85,01010101,175,10101111
124,01111100,85,01010101,209,11010001
16,00010000,3,00000011,19,00010011
92,01011100,115,01110011,207,11001111
116,01110100,70,01000110,186,10111010
86,01010110,27,00011011,113,01110001
18,00010010,87,01010111,105,01101001
90,01011010,12,00001100,102,01100110
59,00111011,124,01111100,183,10110111
7,00000111,73,01001001,80,01010000
3,00000011,94,01011110,97,01100001
15,00001111,7,00000111,22,00010110
116,01110100,89,01011001,205,11001101
30,00011110,24,00011000,54,00110110
113,01110001,118,01110110,231,11100111
35,00100011,35,00100011,70,01000110
64,01000000,34,00100010,98,01100010
70,01000110,47,00101111,117,01110101
45,00101101,3,00000011,48,00110000
70,01000110,50,00110010,120,01111000
120,01111000,86,01010110,206,11001110
103,01100111,120,01111000,223,11011111
112,01110000,7,00000111,119,01110111
29,00011101,30,00011110,59,00111011
13,00001101,3,00000011,16,00010000
67,01000011,44,00101100,111,01101111
50,00110010,38,00100110,88,01011000
65,01000001,98,01100010,163,10100011
19,00010011,79,01001111,98,01100010
118,01110110,16,00010000,134,10000110
47,00101111,87,01010111,134,10000110
40,00101000,119,01110111,159,10011111
119,01110111,98,01100010,217,11011001
15,00001111,49,00110001,64,01000000
61,00111101,98,01100010,159,10011111
55,00110111,111,01101111,166,10100110
75,01001011,122,01111010,197,11000101
68,01000100,29,00011101,97,01100001
8,00001000,75,01001011,83,01010011
80,01010000,65,01000001,145,10010001
47,00101111,81,01010001,128,10000000
109,01101101,95,01011111,204,11001100
104,01101000,109,01101101,213,11010101
122,01111010,117,01110101,239,11101111
125,01111101,14,00001110,139,10001011
126,01111110,46,00101110,172,10101100
56,00111000,123,01111011,179,10110011
58,00111010,113,01110001,171,10101011
72,01001000,65,01000001,137,10001001
91,01011011,107,01101011,198,11000110
73,01001001,65,01000001,138,10001010
3,00000011,48,00110000,51,00110011
125,01111101,63,00111111,188,10111100
46,00101110,33,00100001,79,01001111
1,00000001,35,00100011,36,00100100
120,01111000,65,01000001,185,10111001
97,01100001,68,01000100,165,10100101
127,01111111,26,00011010,153,10011001
50,00110010,27,00011011,77,01001101
114,01110010,47,00101111,161,10100001
10,00001010,20,00010100,30,00011110
117,01110101,38,00100110,155,10011011
88,01011000,68,01000100,156,10011100
77,01001101,90,01011010,167,10100111
107,01101011,61,00111101,168,10101000
37,00100101,127,01111111,164,10100100
50,00110010,74,01001010,124,01111100
43,00101011,28,00011100,71,01000111
43,00101011,10,00001010,53,00110101
87,01010111,62,00111110,149,10010101
100,01100100,7,00000111,107,01101011
111,01101111,113,01110001,224,11100000
81,01010001,52,00110100,133,10000101
64,01000000,0,00000000,64,01000000
74,01001010,118,01110110,192,11000000
27,00011011,1,00000001,28,00011100
116,01110100,75,01001011,191,10111111
122,01111010,94,01011110,216,11011000
38,00100110,123,01111011,161,10100001
48,00110000,66,01000010,114,01110010
31,00011111,62,00111110,93,01011101
14,00001110,75,01001011,89,01011001
59,00111011,85,01010101,144,10010000
54,00110110,125,01111101,179,10110011
71,01000111,76,01001100,147,10010011
116,01110100,48,00110000,164,10100100
43,00101011,113,01110001,156,10011100
112,01110000,5,00000101,117,01110101
61,00111101,65,01000001,126,01111110
33,00100001,101,01100101,134,10000110
64,01000000,44,00101100,108,01101100
47,00101111,65,01000001,112,01110000
18,00010010,91,01011011,109,01101101
127,01111111,114,01110010,241,11110001
8,00001000,45,00101101,53,00110101
115,01110011,78,01001110,193,11000001
24,00011000,120,01111000,144,10010000
18,00010010,9,00001001,27,00011011
59,00111011,25,00011001,84,01010100
62,00111110,123,01111011,185,10111001
25,00011001,39,00100111,64,01000000
24,00011000,116,01110100,140,10001100
104,01101000,44,00101100,148,10010100
1,00000001,6,00000110,7,00000111
46,00101110,43,00101011,89,01011001
35,00100011,94,01011110,129,10000001
113,01110001,115,01110011,228,11100100
111,01101111,68,01000100,179,10110011
108,01101100,81,01010001,189,10111101
8,00001000,116,01110100,124,01111100
40,00101000,67,01000011,107,01101011
102,01100110,103,01100111,205,11001101
117,01110101,1,00000001,118,01110110
0,00000000,92,01011100,92,01011100
47,00101111,116,01110100,163,10100011
34,00100010,17,00010001,51,00110011
66,01000010,26,00011010,92,01011100
36,00100100,23,00010111,59,00111011
64,01000000,94,01011110,158,10011110
65,01000001,68,01000100,133,10000101
86,01010110,91,01011011,177,10110001
6,00000110,125,01111101,131,10000011
125,01111101,88,01011000,213,11010101
85,01010101,42,00101010,127,01111111
126,01111110,107,01101011,233,11101001
122,01111010,55,00110111,177,10110001
116,01110100,4,00000100,120,01111000
35,00100011,39,00100111,74,01001010
99,01100011,1,00000001,100,01100100
106,01101010,40,00101000,146,10010010
23,00010111,41,00101001,64,01000000
3,00000011,124,01111100,127,01111111
28,00011100,2,00000010,30,00011110
47,00101111,89,01011001,136,10001000
87,01010111,99,01100011,186,10111010
88,01011000,46,00101110,134,10000110
119,01110111,93,01011101,212,11010100
126,01111110,56,00111000,182,10110110
105,01101001,62,00111110,167,10100111
37,00100101,63,00111111,100,01100100
13,00001101,20,00010100,33,00100001
121,01111001,18,00010010,139,10001011
37,00100101,6,00000110,43,00101011
87,01010111,10,00001010,97,01100001
58,00111010,100,01100100,158,10011110
65,01000001,44,00101100,109,01101101
117,01110101,104,01101000,221,11011101
83,01010011,15,00001111,98,01100010
75,01001011,127,01111111,202,11001010
73,01001001,108,01101100,181,10110101
81,01010001,42,00101010,123,01111011
41,00101001,25,00011001,66,01000010
68,01000100,79,01001111,147,10010011
2,00000010,127,01111111,129,10000001
89,01011001,7,00000111,96,01100000
119,01110111,63,00111111,182,10110110
106,01101010,17,00010001,123,01111011
112,01110000,124,01111100,236,11101100
10,00001010,35,00100011,45,00101101
37,00100101,126,01111110,163,10100011
87,01010111,41,00101001,128,10000000
111,01101111,93,01011101,204,11001100
122,01111010,47,00101111,169,10101001
124,01111100,46,00101110,170,10101010
37,00100101,41,00101001,78,01001110
39,00100111,38,00100110,77,01001101
111,01101111,121,01111001,232,11101000
80,01010000,52,00110100,132,10000100
93,01011101,18,00010010,111,01101111
107,01101011,48,00110000,155,10011011
87,01010111,5,00000101,92,01011100
119,01110111,120,01111000,239,11101111
59,00111011,54,00110110,113,01110001
118,01110110,43,00101011,161,10100001
109,01101101,12,00001100,121,01111001
27,00011011,15,00001111,42,00101010
27,00011011,109,01101101,136,10001000
16,00010000,58,00111010,74,01001010
49,00110001,102,01100110,151,10010111
58,00111010,31,00011111,89,01011001
50,00110010,4,00000100,54,00110110
24,00011000,24,00011000,48,00110000
76,01001100,54,00110110,130,10000010
110,01101110,33,00100001,143,10001111
123,01111011,1,00000001,124,01111100
76,01001100,67,01000011,143,10001111
89,01011001,47,00101111,136,10001000
18,00010010,52,00110100,70,01000110
19,00010011,91,01011011,110,01101110
81,01010001,95,01011111,176,10110000
27,00011011,20,00010100,47,00101111
117,01110101,30,00011110,147,10010011
114,01110010,45,00101101,159,10011111
82,01010010,114,01110010,196,11000100
9,00001001,81,01010001,90,01011010
88,01011000,96,01100000,184,10111000
59,00111011,15,00001111,74,01001010
117,01110101,86,01010110,203,11001011
126,01111110,12,00001100,138,10001010
125,01111101,38,00100110,163,10100011
109,01101101,97,01100001,206,11001110
7,00000111,3,00000011,10,00001010
83,01010011,48,00110000,131,10000011
76,01001100,37,00100101,113,01110001
57,00111001,107,01101011,164,10100100
89,01011001,56,00111000,145,10010001
57,00111001,12,00001100,69,01000101
126,01111110,56,00111000,182,10110110
53,00110101,111,01101111,164,10100100
21,00010101,112,01110000,133,10000101
121,01111001,51,00110011,172,10101100
3,00000011,93,01011101,96,01100000
79,01001111,73,01001001,152,10011000
88,01011000,124,01111100,212,11010100
55,00110111,2,00000010,57,00111001
109,01101101,83,01010011,192,11000000
23,00010111,21,00010101,44,00101100
59,00111011,90,01011010,149,10010101
106,01101010,49,00110001,155,10011011
86,01010110,106,01101010,192,11000000
99,01100011,75,01001011,174,10101110
2,00000010,49,00110001,51,00110011
108,01101100,84,01010100,192,11000000
11,00001011,51,00110011,62,00111110
107,01101011,118,01110110,225,11100001
37,00100101,11,00001011,48,00110000
27,00011011,112,01110000,139,10001011
116,01110100,64,01000000,180,10110100
114,01110010,35,00100011,149,10010101
64,01000000,44,00101100,108,01101100
99,01100011,26,00011010,125,01111101
107,01101011,96,01100000,203,11001011
108,01101100,77,01001101,185,10111001
125,01111101,121,01111001,246,11110110
72,01001000,51,00110011,123,01111011
51,00110011,59,00111011,110,01101110
16,00010000,62,00111110,78,01001110
7,00000111,63,00111111,70,01000110
51,00110011,72,01001000,123,01111011
0,00000000,14,00001110,14,00001110
57,00111001,8,00001000,65,01000001
42,00101010,91,01011011,133,10000101
103,01100111,116,01110100,219,11011011
20,00010100,34,00100010,54,00110110
24,00011000,2,00000010,26,00011010
65,01000001,23,00010111,88,01011000
95,01011111,42,00101010,137,10001001
28,00011100,40,00101000,68,01000100
87,01010111,33,00100001,120,01111000
116,01110100,90,01011010,206,11001110
76,01001100,79,01001111,155,10011011
20,00010100,46,00101110,66,01000010
95,01011111,62,00111110,157,10011101
122,01111010,11,00001011,133,10000101
99,01100011,36,00100100,135,10000111
76,01001100,25,00011001,101,01100101
20,00010100,14,00001110,34,00100010
125,01111101,47,00101111,172,10101100
29,00011101,78,01001110,107,01101011
95,01011111,75,01001011,170,10101010
111,01101111,25,00011001,136,10001000
91,01011011,71,01000111,162,10100010
76,01001100,0,00000000,76,01001100
93,01011101,21,00010101,114,01110010
6,00000110,54,00110110,60,00111100
121,01111001,32,00100000,153,10011001
47,00101111,87,01010111,134,10000110
70,01000110,98,01100010,168,10101000
84,01010100,3,00000011,87,01010111
33,00100001,66,01000010,99,01100011
41,00101001,69,01000101,110,01101110
68,01000100,27,00011011,95,01011111
12,00001100,81,01010001,93,01011101
23,00010111,118,01110110,141,10001101
74,01001010,122,01111010,196,11000100
55,00110111,81,01010001,136,10001000
122,01111010,86,01010110,208,11010000
36,00100100,106,01101010,142,10001110
32,00100000,21,00010101,53,00110101
120,01111000,88,01011000,208,11010000
36,00100100,1,00000001,37,00100101
119,01110111,21,00010101,140,10001100
78,01001110,48,00110000,126,01111110
108,01101100,3,00000011,111,01101111
19,00010011,49,00110001,68,01000100
14,00001110,42,00101010,56,00111000
58,00111010,113,01110001,171,10101011
119,01110111,102,01100110,221,11011101
14,00001110,37,00100101,51,00110011
71,01000111,62,00111110,133,10000101
53,00110101,85,01010101,138,10001010
36,00100100,62,00111110,98,01100010
6,00000110,38,00100110,44,00101100
18,00010010,73,01001001,91,01011011
101,01100101,102,01100110,203,11001011
59,00111011,89,01011001,148,10010100
55,00110111,71,01000111,126,01111110
90,01011010,87,01010111,177,10110001
19,00010011,83,01010011,102,01100110
5,00000101,55,00110111,60,00111100
52,00110100,59,00111011,111,01101111
124,01111100,38,00100110,162,10100010
43,00101011,119,01110111,162,10100010
25,00011001,102,01100110,127,01111111
53,00110101,123,01111011,176,10110000
2,00000010,19,00010011,21,00010101
47,00101111,10,00001010,57,00111001
110,01101110,64,01000000,174,10101110
91,01011011,66,01000010,157,10011101
53,00110101,20,00010100,73,01001001
124,01111100,70,01000110,194,11000010
44,00101100,127,01111111,171,10101011
43,00101011,48,00110000,91,01011011
107,01101011,96,01100000,203,11001011
109,01101101,16,00010000,125,01111101
127,01111111,103,01100111,230,11100110
105,01101001,61,00111101,166,10100110
68,01000100,119,01110111,187,10111011
19,00010011,112,01110000,131,10000011
8,00001000,114,01110010,122,01111010
80,01010000,97,01100001,177,10110001
53,00110101,57,00111001,110,01101110
16,00010000,32,00100000,48,00110000
98,01100010,82,01010010,180,10110100
29,00011101,108,01101100,137,10001001
115,01110011,23,00010111,138,10001010
118,01110110,62,00111110,180,10110100
79,01001111,102,01100110,181,10110101
84,01010100,30,00011110,114,01110010
110,01101110,58,00111010,168,10101000
86,01010110,122,01111010,208,11010000
92,01011100,71,01000111,163,10100011
101,01100101,50,00110010,151,10010111
117,01110101,61,00111101,178,10110010
45,00101101,22,00010110,67,01000011
56,00111000,0,00000000,56,00111000
0,00000000,40,00101000,40,00101000
40,00101000,85,01010101,125,01111101
92,01011100,73,01001001,165,10100101
11,00001011,57,00111001,68,01000100
94,01011110,80,01010000,174,10101110
64,01000000,30,00011110,94,01011110
45,00101101,73,01001001,118,01110110
66,01000010,14,00001110,80,01010000
12,00001100,41,00101001,53,00110101
14,00001110,100,01100100,114,01110010
43,00101011,102,01100110,145,10010001
73,01001001,11,00001011,84,01010100
126,01111110,124,01111100,250,11111010
90,01011010,83,01010011,173,10101101
54,00110110,47,00101111,101,01100101
43,00101011,74,01001010,117,01110101
20,00010100,105,01101001,125,01111101
112,01110000,52,00110100,164,10100100
32,00100000,19,00010011,51,00110011
108,01101100,105,01101001,213,11010101
105,01101001,94,01011110,199,11000111
80,01010000,26,00011010,106,01101010
41,00101001,114,01110010,155,10011011
54,00110110,100,01100100,154,10011010
80,01010000,8,00001000,88,01011000
118,01110110,70,01000110,188,10111100
21,00010101,123,01111011,144,10010000
87,01010111,100,01100100,187,10111011
28,00011100,48,00110000,76,01001100
73,01001001,35,00100011,108,01101100
126,01111110,119,01110111,245,11110101
29,00011101,122,01111010,151,10010111
46,00101110,46,00101110,92,01011100
47,00101111,115,01110011,162,10100010
95,01011111,114,01110010,209,11010001
72,01001000,49,00110001,121,01111001
97,01100001,60,00111100,157,10011101
6,00000110,41,00101001,47,00101111
103,01100111,99,01100011,202,11001010
98,01100010,86,01010110,184,10111000
110,01101110,30,00011110,140,10001100
0,00000000,39,00100111,39,00100111
121,01111001,70,01000110,191,10111111
78,01001110,47,00101111,125,01111101
87,01010111,86,01010110,173,10101101
103,01100111,71,01000111,174,10101110
43,00101011,55,00110111,98,01100010
26,00011010,71,01000111,97,01100001
120,01111000,47,00101111,167,10100111
6,00000110,61,00111101,67,01000011
40,00101000,30,00011110,70,01000110
100,01100100,7,00000111,107,01101011
11,00001011,52,00110100,63,00111111
27,00011011,18,00010010,45,00101101
81,01010001,10,00001010,91,01011011
20,00010100,49,00110001,69,01000101
65,01000001,21,00010101,86,01010110
62,00111110,92,01011100,154,10011010
105,01101001,70,01000110,175,10101111
60,00111100,50,00110010,110,01101110
28,00011100,66,01000010,94,01011110
127,01111111,74,01001010,201,11001001
105,01101001,118,01110110,223,11011111
28,00011100,80,01010000,108,01101100
36,00100100,126,01111110,162,10100010
105,01101001,48,00110000,153,10011001
119,01110111,93,01011101,212,11010100
18,00010010,1,00000001,19,00010011
110,01101110,82,01010010,192,11000000
46,00101110,58,00111010,104,01101000
41,00101001,80,01010000,121,01111001
83,01010011,70,01000110,153,10011001
95,01011111,10,00001010,105,01101001
30,00011110,116,01110100,146,10010010
95,01011111,99,01100011,194,11000010
22,00010110,10,00001010,32,00100000
107,01101011,13,00001101,120,01111000
96,01100000,14,00001110,110,01101110
56,00111000,13,00001101,69,01000101
102,01100110,32,00100000,134,10000110
40,00101000,35,00100011,75,01001011
49,00110001,27,00011011,76,01001100
92,01011100,108,01101100,200,11001000
90,01011010,12,00001100,102,01100110
95,01011111,51,00110011,146,10010010
33,00100001,56,00111000,89,01011001
46,00101110,69,01000101,115,01110011
109,01101101,123,01111011,232,11101000
59,00111011,84,01010100,143,10001111
16,00010000,39,00100111,55,00110111
35,00100011,24,00011000,59,00111011
26,00011010,7,00000111,33,00100001
36,00100100,101,01100101,137,10001001
24,00011000,82,01010010,106,01101010
29,00011101,26,00011010,55,00110111
87,01010111,46,00101110,133,10000101
43,00101011,22,00010110,65,01000001
45,00101101,43,00101011,88,01011000
2,00000010,81,01010001,83,01010011
61,00111101,64,01000000,125,01111101
96,01100000,43,00101011,139,10001011
4,00000100,38,00100110,42,00101010
28,00011100,58,00111010,86,01010110
34,00100010,29,00011101,63,00111111
40,00101000,108,01101100,148,10010100
121,01111001,16,00010000,137,10001001
30,00011110,127,01111111,157,10011101
8,00001000,44,00101100,52,00110100
98,01100010,65,01000001,163,10100011
23,00010111,123,01111011,146,10010010
93,01011101,84,01010100,177,10110001
69,01000101,29,00011101,98,01100010
41,00101001,61,00111101,102,01100110
64,01000000,39,00100111,103,01100111
81,01010001,23,00010111,104,01101000
91,01011011,12,00001100,103,01100111
51,00110011,87,01010111,138,10001010
81,01010001,91,01011011,172,10101100
91,01011011,108,01101100,199,11000111
70,01000110,52,00110100,122,01111010
51,00110011,74,01001010,125,01111101
47,00101111,9,00001001,56,00111000
97,01100001,49,00110001,146,10010010
60,00111100,75,01001011,135,10000111
117,01110101,28,00011100,145,10010001
66,01000010,57,00111001,123,01111011
117,01110101,6,00000110,123,01111011
33,00100001,11,00001011,44,00101100
51,00110011,91,01011011,142,10001110
23,00010111,79,01001111,102,01100110
32,00100000,68,01000100,100,01100100
89,01011001,103,01100111,192,11000000
110,01101110,56,00111000,166,10100110
15,00001111,88,01011000,103,01100111
34,00100010,34,00100010,68,01000100
42,00101010,24,00011000,66,01000010
112,01110000,27,00011011,139,10001011
34,00100010,26,00011010,60,00111100
100,01100100,90,01011010,190,10111110
122,01111010,117,01110101,239,11101111
126,01111110,109,01101101,235,11101011
43,00101011,37,00100101,80,01010000
120,01111000,98,01100010,218,11011010
100,01100100,51,00110011,151,10010111
55,00110111,115,01110011,170,10101010
107,01101011,76,01001100,183,10110111
40,00101000,45,00101101,85,01010101
19,00010011,20,00010100,39,00100111
74,01001010,23,00010111,97,01100001
86,01010110,54,00110110,140,10001100
66,01000010,59,00111011,125,01111101
127,01111111,32,00100000,159,10011111
51,00110011,50,00110010,101,01100101
96,01100000,40,00101000,136,10001000
106,01101010,114,01110010,220,11011100
120,01111000,2,00000010,122,01111010
82,01010010,61,00111101,143,10001111
84,01010100,47,00101111,131,10000011
122,01111010,78,01001110,200,11001000
87,01010111,78,01001110,165,10100101
117,01110101,55,00110111,172,10101100
51,00110011,53,00110101,104,01101000
26,00011010,63,00111111,89,01011001
71,01000111,63,00111111,134,10000110
18,00010010,105,01101001,123,01111011
63,00111111,22,00010110,85,01010101
28,00011100,59,00111011,87,01010111
94,01011110,4,00000100,98,01100010
111,01101111,120,01111000,231,11100111
107,01101011,63,00111111,170,10101010
108,01101100,31,00011111,139,10001011
105,01101001,20,00010100,125,01111101
49,00110001,38,00100110,87,01010111
91,01011011,70,01000110,161,10100001
105,01101001,126,01111110,231,11100111
6,00000110,34,00100010,40,00101000
76,01001100,75,01001011,151,10010111
97,01100001,54,00110110,151,10010111
41,00101001,68,01000100,109,01101101
49,00110001,23,00010111,72,01001000
20,00010100,1,00000001,21,00010101
108,01101100,14,00001110,122,01111010
126,01111110,54,00110110,180,10110100
8,00001000,88,01011000,96,01100000
124,01111100,53,00110101,177,10110001
80,01010000,104,01101000,184,10111000
98,01100010,106,01101010,204,11001100
25,00011001,107,01101011,132,10000100
59,00111011,54,00110110,113,01110001
116,01110100,23,00010111,139,10001011
0,00000000,122,01111010,122,01111010
52,00110100,90,01011010,142,10001110
8,00001000,29,00011101,37,00100101
26,00011010,29,00011101,55,00110111
40,00101000,15,00001111,55,00110111
1,00000001,62,00111110,63,00111111
73,01001001,25,00011001,98,01100010
123,01111011,44,00101100,167,10100111
27,00011011,78,01001110,105,01101001
113,01110001,31,00011111,144,10010000
113,01110001,32,00100000,145,10010001
127,01111111,71,01000111,198,11000110
39,00100111,123,01111011,162,10100010
10,00001010,110,01101110,120,01111000
41,00101001,1,00000001,42,00101010
30,00011110,31,00011111,61,00111101
42,00101010,51,00110011,93,01011101
119,01110111,76,01001100,195,11000011
69,01000101,32,00100000,101,01100101
97,01100001,15,00001111,112,01110000
46,00101110,35,00100011,81,01010001
57,00111001,116,01110100,173,10101101
102,01100110,94,01011110,196,11000100
69,01000101,89,01011001,158,10011110
37,00100101,23,00010111,60,00111100
53,00110101,61,00111101,114,01110010
24,00011000,51,00110011,75,01001011
22,00010110,118,01110110,140,10001100
70,01000110,20,00010100,90,01011010
81,01010001,62,00111110,143,10001111
88,01011000,98,01100010,186,10111010
65,01000001,39,00100111,104,01101000
43,00101011,23,00010111,66,01000010
27,00011011,32,00100000,59,00111011
89,01011001,64,01000000,153,10011001
115,01110011,24,00011000,139,10001011
101,01100101,87,01010111,188,10111100
113,01110001,81,01010001,194,11000010
126,01111110,93,01011101,219,11011011
52,00110100,3,00000011,55,00110111
117,01110101,114,01110010,231,11100111
76,01001100,99,01100011,175,10101111
35,00100011,42,00101010,77,01001101
86,01010110,124,01111100,210,11010010
94,01011110,70,01000110,164,10100100
62,00111110,57,00111001,119,01110111
45,00101101,72,01001000,117,01110101
57,00111001,111,01101111,168,10101000
16,00010000,70,01000110,86,01010110
10,00001010,76,01001100,86,01010110
122,01111010,71,01000111,193,11000001
72,01001000,61,00111101,133,10000101
93,01011101,70,01000110,163,10100011
7,00000111,18,00010010,25,00011001
64,01000000,61,00111101,125,01111101
122,01111010,43,00101011,165,10100101
15,00001111,106,01101010,121,01111001
90,01011010,52,00110100,142,10001110
102,01100110,8,00001000,110,01101110
18,00010010,108,01101100,126,01111110
82,01010010,78,01001110,160,10100000
76,01001100,92,01011100,168,10101000
41,00101001,80,01010000,121,01111001
54,00110110,126,01111110,180,10110100
101,01100101,98,01100010,199,11000111
123,01111011,45,00101101,168,10101000
55,00110111,91,01011011,146,10010010
24,00011000,64,01000000,88,01011000
118,01110110,9,00001001,127,01111111
76,01001100,98,01100010,174,10101110
85,01010101,14,00001110,99,01100011
4,00000100,9,00001001,13,00001101
21,00010101,19,00010011,40,00101000
87,01010111,27,00011011,114,01110010
126,01111110,115,01110011,241,11110001
81,01010001,10,00001010,91,01011011
30,00011110,43,00101011,73,01001001
32,00100000,7,00000111,39,00100111
36,00100100,112,01110000,148,10010100
59,00111011,55,00110111,114,01110010
78,01001110,102,01100110,180,10110100
0,00000000,3,00000011,3,00000011
91,01011011,43,00101011,134,10000110
26,00011010,29,00011101,55,00110111
71,01000111,62,00111110,133,10000101
88,01011000,48,00110000,136,10001000
85,01010101,32,00100000,117,01110101
7,00000111,94,01011110,101,01100101
71,01000111,69,01000101,140,10001100
80,01010000,8,00001000,88,01011000
56,00111000,125,01111101,181,10110101
103,01100111,88,01011000,191,10111111
59,00111011,75,01001011,134,10000110
122,01111010,86,01010110,208,11010000
34,00100010,56,00111000,90,01011010
105,01101001,35,00100011,140,10001100
102,01100110,42,00101010,144,10010000
101,01100101,5,00000101,106,01101010
47,00101111,90,01011010,137,10001001
50,00110010,109,01101101,159,10011111
3,00000011,25,00011001,28,00011100
107,01101011,65,01000001,172,10101100
38,00100110,114,01110010,152,10011000
43,00101011,87,01010111,130,10000010
22,00010110,109,01101101,131,10000011
29,00011101,35,00100011,64,01000000
3,00000011,83,01010011,86,01010110
103,01100111,61,00111101,164,10100100
66,01000010,20,00010100,86,01010110
19,00010011,112,01110000,131,10000011
69,01000101,48,00110000,117,01110101
124,01111100,5,00000101,129,10000001
47,00101111,82,01010010,129,10000001
36,00100100,91,01011011,127,01111111
74,01001010,65,01000001,139,10001011
127,01111111,38,00100110,165,10100101
1,00000001,75,01001011,76,01001100
47,00101111,54,00110110,101,01100101
79,01001111,51,00110011,130,10000010
41,00101001,11,00001011,52,00110100
7,00000111,63,00111111,70,01000110
123,01111011,99,01100011,222,11011110
22,00010110,125,01111101,147,10010011
38,00100110,14,00001110,52,00110100
78,01001110,80,01010000,158,10011110
111,01101111,32,00100000,143,10001111
105,01101001,118,01110110,223,11011111
105,01101001,106,01101010,211,11010011
11,00001011,113,01110001,124,01111100
119,01110111,33,00100001,152,10011000
27,00011011,100,01100100,127,01111111
118,01110110,94,01011110,212,11010100
52,00110100,97,01100001,149,10010101
63,00111111,22,00010110,85,01010101
118,01110110,0,00000000,118,01110110
32,00100000,32,00100000,64,01000000
31,00011111,63,00111111,94,01011110
21,00010101,98,01100010,119,01110111
102,01100110,57,00111001,159,10011111
11,00001011,92,01011100,103,01100111
114,01110010,85,01010101,199,11000111
46,00101110,38,00100110,84,01010100
22,00010110,15,00001111,37,00100101
90,01011010,43,00101011,133,10000101
126,01111110,36,00100100,162,10100010
60,00111100,116,01110100,176,10110000
69,01000101,37,00100101,106,01101010
67,01000011,86,01010110,153,10011001
98,01100010,55,00110111,153,10011001
71,01000111,64,01000000,135,10000111
47,00101111,100,01100100,147,10010011
122,01111010,28,00011100,150,10010110
91,01011011,31,00011111,122,01111010
32,00100000,106,01101010,138,10001010
71,01000111,32,00100000,103,01100111
110,01101110,1,00000001,111,01101111
46,00101110,41,00101001,87,01010111
2,00000010,103,01100111,105,01101001
125,01111101,62,00111110,187,10111011
0,00000000,69,01000101,69,01000101
84,01010100,25,00011001,109,01101101
127,01111111,98,01100010,225,11100001
46,00101110,60,00111100,106,01101010
125,01111101,8,00001000,133,10000101
90,01011010,101,01100101,191,10111111
107,01101011,93,01011101,200,11001000
70,01000110,69,01000101,139,10001011
12,00001100,42,00101010,54,00110110
71,01000111,73,01001001,144,10010000
114,01110010,90,01011010,204,11001100
10,00001010,79,01001111,89,01011001
9,00001001,5,00000101,14,00001110
3,00000011,53,00110101,56,00111000
42,00101010,29,00011101,71,01000111
6,00000110,72,01001000,78,01001110
89,01011001,108,01101100,197,11000101
4,00000100,92,01011100,96,01100000
71,01000111,102,01100110,173,10101101
49,00110001,20,00010100,69,01000101
95,01011111,48,00110000,143,10001111
89,01011001,32,00100000,121,01111001
31,00011111,20,00010100,51,00110011
47,00101111,110,01101110,157,10011101
51,00110011,56,00111000,107,01101011
97,01100001,32,00100000,129,10000001
31,00011111,85,01010101,116,01110100
76,01001100,2,00000010,78,01001110
71,01000111,42,00101010,113,01110001
122,01111010,103,01100111,225,11100001
103,01100111,89,01011001,192,11000000
70,01000110,98,01100010,168,10101000
18,00010010,46,00101110,64,01000000
42,00101010,127,01111111,169,10101001
66,01000010,76,01001100,142,10001110
32,00100000,121,01111001,153,10011001
73,01001001,86,01010110,159,10011111
22,00010110,37,00100101,59,00111011
44,00101100,35,00100011,79,01001111
94,01011110,76,01001100,170,10101010
74,01001010,37,00100101,111,01101111
92,01011100,68,01000100,160,10100000
66,01000010,70,01000110,136,10001000
54,00110110,93,01011101,147,10010011
58,00111010,65,01000001,123,01111011
45,00101101,81,01010001,126,01111110
122,01111010,89,01011001,211,11010011
29,00011101,98,01100010,127,01111111
97,01100001,84,01010100,181,10110101
71,01000111,96,01100000,167,10100111
37,00100101,88,01011000,125,01111101
85,01010101,121,01111001,206,11001110
39,00100111,57,00111001,96,01100000
19,00010011,90,01011010,109,01101101
43,00101011,64,01000000,107,01101011
31,00011111,122,01111010,153,10011001
2,00000010,55,00110111,57,00111001
5,00000101,98,01100010,103,01100111
17,00010001,88,01011000,105,01101001
61,00111101,51,00110011,112,01110000
66,01000010,74,01001010,140,10001100
108,01101100,38,00100110,146,10010010
28,00011100,44,00101100,72,01001000
13,00001101,44,00101100,57,00111001
58,00111010,109,01101101,167,10100111
29,00011101,97,01100001,126,01111110
104,01101000,87,01010111,191,10111111
58,00111010,58,00111010,116,01110100
31,00011111,68,01000100,99,01100011
18,00010010,27,00011011,45,00101101
127,01111111,110,01101110,237,11101101
57,00111001,23,00010111,80,01010000
5,00000101,30,00011110,35,00100011
23,00010111,65,01000001,88,01011000
68,01000100,56,00111000,124,01111100
26,00011010,88,01011000,114,01110010
35,00100011,78,01001110,113,01110001
59,00111011,20,00010100,79,01001111
54,00110110,51,00110011,105,01101001
71,01000111,8,00001000,79,01001111
33,00100001,21,00010101,54,00110110
46,00101110,52,00110100,98,01100010
79,01001111,112,01110000,191,10111111
90,01011010,92,01011100,182,10110110
8,00001000,55,00110111,63,00111111
3,00000011,97,01100001,100,01100100
16,00010000,74,01001010,90,01011010
34,00100010,114,01110010,148,10010100
82,01010010,19,00010011,101,01100101
64,01000000,97,01100001,161,10100001
5,00000101,64,01000000,69,01000101
3,00000011,68,01000100,71,01000111
52,00110100,93,01011101,145,10010001
73,01001001,82,01010010,155,10011011
39,00100111,89,01011001,128,10000000
106,01101010,6,00000110,112,01110000
33,00100001,57,00111001,90,01011010
50,00110010,58,00111010,108,01101100
116,01110100,26,00011010,142,10001110
42,00101010,124,01111100,166,10100110
81,01010001,62,00111110,143,10001111
29,00011101,16,00010000,45,00101101
8,00001000,2,00000010,10,00001010
42,00101010,65,01000001,107,01101011
24,00011000,122,01111010,146,10010010
116,01110100,9,00001001,125,01111101
93,01011101,8,00001000,101,01100101
16,00010000,13,00001101,29,00011101
104,01101000,79,01001111,183,10110111
78,01001110,64,01000000,142,10001110
37,00100101,28,00011100,65,01000001
5,00000101,0,00000000,5,00000101
32,00100000,51,00110011,83,01010011
58,00111010,39,00100111,97,01100001
23,00010111,93,01011101,116,01110100
38,00100110,108,01101100,146,10010010
91,01011011,99,01100011,190,10111110
100,01100100,63,00111111,163,10100011
20,00010100,9,00001001,29,00011101
60,00111100,38,00100110,98,01100010
27,00011011,78,01001110,105,01101001
18,00010010,72,01001000,90,01011010
93,01011101,23,00010111,116,01110100
3,00000011,6,00000110,9,00001001
35,00100011,27,00011011,62,00111110
102,01100110,65,01000001,167,10100111
53,00110101,13,00001101,66,01000010
1,00000001,39,00100111,40,00101000
33,00100001,42,00101010,75,01001011
61,00111101,99,01100011,160,10100000
1,00000001,47,00101111,48,00110000
8,00001000,110,01101110,118,01110110
87,01010111,121,01111001,208,11010000
118,01110110,60,00111100,178,10110010
11,00001011,68,01000100,79,01001111
26,00011010,54,00110110,80,01010000
86,01010110,28,00011100,114,01110010
119,01110111,96,01100000,215,11010111
111,01101111,50,00110010,161,10100001
26,00011010,50,00110010,76,01001100
112,01110000,70,01000110,182,10110110
94,01011110,52,00110100,146,10010010
96,01100000,126,01111110,222,11011110
41,00101001,118,01110110,159,10011111
101,01100101,59,00111011,160,10100000
87,01010111,39,00100111,126,01111110
87,01010111,99,01100011,186,10111010
63,00111111,84,01010100,147,10010011
95,01011111,102,01100110,197,11000101
122,01111010,120,01111000,242,11110010
28,00011100,27,00011011,55,00110111
95,01011111,21,00010101,116,01110100
33,00100001,113,01110001,146,10010010
33,00100001,68,01000100,101,01100101
48,00110000,22,00010110,70,01000110
88,01011000,74,01001010,162,10100010
37,00100101,3,00000011,40,00101000
62,00111110,36,00100100,98,01100010
43,00101011,92,01011100,135,10000111
74,01001010,38,00100110,112,01110000
103,01100111,16,00010000,119,01110111
24,00011000,0,00000000,24,00011000
11,00001011,77,01001101,88,01011000
95,01011111,11,00001011,106,01101010
10,00001010,12,00001100,22,00010110
113,01110001,59,00111011,172,10101100
60,00111100,28,00011100,88,01011000
118,01110110,42,00101010,160,10100000
55,00110111,84,01010100,139,10001011
48,00110000,3,00000011,51,00110011
43,00101011,83,01010011,126,01111110
108,01101100,68,01000100,176,10110000
3,00000011,71,01000111,74,01001010
42,00101010,41,00101001,83,01010011
50,00110010,120,01111000,170,10101010
73,01001001,58,00111010,131,10000011
14,00001110,22,00010110,36,00100100
51,00110011,15,00001111,66,01000010
115,01110011,19,00010011,134,10000110
49,00110001,81,01010001,130,10000010
75,01001011,101,01100101,176,10110000
8,00001000,51,00110011,59,00111011
68,01000100,122,01111010,190,10111110
100,01100100,31,00011111,131,10000011
61,00111101,84,01010100,145,10010001
66,01000010,1,00000001,67,01000011
68,01000100,102,01100110,170,10101010
94,01011110,83,01010011,177,10110001
20,00010100,127,01111111,147,10010011
41,00101001,86,01010110,127,01111111
9,00001001,108,01101100,117,01110101
102,01100110,55,00110111,157,10011101
37,00100101,7,00000111,44,00101100
110,01101110,21,00010101,131,10000011
80,01010000,43,00101011,123,01111011
127,01111111,83,01010011,210,11010010
61,00111101,56,00111000,117,01110101
102,01100110,62,00111110,164,10100100
33,00100001,98,01100010,131,10000011
93,01011101,75,01001011,168,10101000
83,01010011,124,01111100,207,11001111
75,01001011,61,00111101,136,10001000
60,00111100,117,01110101,177,10110001
79,01001111,101,01100101,180,10110100
47,00101111,93,01011101,140,10001100
62,00111110,15,00001111,77,01001101
114,01110010,91,01011011,205,11001101
113,01110001,78,01001110,191,10111111
53,00110101,121,01111001,174,10101110
50,00110010,70,01000110,120,01111000
66,01000010,120,01111000,186,10111010
118,01110110,51,00110011,169,10101001
22,00010110,15,00001111,37,00100101
121,01111001,4,00000100,125,01111101
37,00100101,12,00001100,49,00110001
102,01100110,76,01001100,178,10110010
109,01101101,85,01010101,194,11000010
120,01111000,71,01000111,191,10111111
10,00001010,4,00000100,14,00001110
14,00001110,54,00110110,68,01000100
87,01010111,58,00111010,145,10010001
24,00011000,127,01111111,151,10010111
9,00001001,56,00111000,65,01000001
113,01110001,32,00100000,145,10010001
93,01011101,13,00001101,106,01101010
16,00010000,70,01000110,86,01010110
127,01111111,121,01111001,248,11111000
64,01000000,123,01111011,187,10111011
83,01010011,6,00000110,89,01011001
63,00111111,121,01111001,184,10111000
61,00111101,39,00100111,100,01100100
116,01110100,69,01000101,185,10111001
105,01101001,97,01100001,202,11001010
108,01101100,77,01001101,185,10111001
114,01110010,77,01001101,191,10111111
20,00010100,31,00011111,51,00110011
73,01001001,37,00100101,110,01101110
112,01110000,79,01001111,191,10111111
100,01100100,12,00001100,112,01110000
116,01110100,112,01110000,228,11100100
127,01111111,2,00000010,129,10000001
85,01010101,64,01000000,149,10010101
120,01111000,44,00101100,164,10100100
31,00011111,118,01110110,149,10010101
55,00110111,111,01101111,166,10100110
32,00100000,68,01000100,100,01100100
88,01011000,74,01001010,162,10100010
41,00101001,98,01100010,139,10001011
51,00110011,55,00110111,106,01101010
106,01101010,54,00110110,160,10100000
120,01111000,42,00101010,162,10100010
115,01110011,126,01111110,241,11110001
28,00011100,36,00100100,64,01000000
85,01010101,78,01001110,163,10100011
70,01000110,125,01111101,195,11000011
111,01101111,0,00000000,111,01101111
48,00110000,74,01001010,122,01111010
43,00101011,45,00101101,88,01011000
2,00000010,100,01100100,102,01100110
17,00010001,34,00100010,51,00110011
116,01110100,96,01100000,212,11010100
80,01010000,13,00001101,93,01011101
0,00000000,63,00111111,63,00111111
101,01100101,21,00010101,122,01111010
108,01101100,42,00101010,150,10010110
60,00111100,111,01101111,171,10101011
76,01001100,55,00110111,131,10000011
96,01100000,10,00001010,106,01101010
73,01001001,62,00111110,135,10000111
104,01101000,56,00111000,160,10100000
26,00011010,30,00011110,56,00111000
98,01100010,120,01111000,218,11011010
85,01010101,27,00011011,112,01110000
35,00100011,99,01100011,134,10000110
98,01100010,118,01110110,216,11011000
30,00011110,92,01011100,122,01111010
113,01110001,63,00111111,176,10110000
101,01100101,120,01111000,221,11011101
83,01010011,118,01110110,201,11001001
5,00000101,42,00101010,47,00101111
88,01011000,38,00100110,126,01111110
112,01110000,44,00101100,156,10011100
108,01101100,8,00001000,116,01110100
80,01010000,54,00110110,134,10000110
11,00001011,42,00101010,53,00110101
4,00000100,98,01100010,102,01100110
109,01101101,98,01100010,207,11001111
108,01101100,46,00101110,154,10011010
83,01010011,29,00011101,112,01110000
73,01001001,15,00001111,88,01011000
63,00111111,88,01011000,151,10010111
120,01111000,121,01111001,241,11110001
74,01001010,72,01001000,146,10010010
49,00110001,57,00111001,106,01101010
108,01101100,47,00101111,155,10011011
30,00011110,125,01111101,155,10011011
46,00101110,105,01101001,151,10010111
7,00000111,79,01001111,86,01010110
44,00101100,98,01100010,142,10001110
74,01001010,98,01100010,172,10101100
44,00101100,16,00010000,60,00111100
12,00001100,82,01010010,94,01011110
31,00011111,117,01110101,148,10010100
126,01111110,32,00100000,158,10011110
18,00010010,98,01100010,116,01110100
61,00111101,21,00010101,82,01010010
113,01110001,50,00110010,163,10100011
57,00111001,59,00111011,116,01110100
122,01111010,127,01111111,249,11111001
119,01110111,110,01101110,229,11100101
25,00011001,99,01100011,124,01111100
50,00110010,9,00001001,59,00111011
10,00001010,115,01110011,125,01111101
85,01010101,91,01011011,176,10110000
39,00100111,19,00010011,58,00111010
57,00111001,28,00011100,85,01010101
110,01101110,69,01000101,179,10110011
42,00101010,58,00111010,100,01100100
119,01110111,44,00101100,163,10100011
20,00010100,108,01101100,128,10000000
36,00100100,116,01110100,152,10011000
126,01111110,60,00111100,186,10111010
56,00111000,13,00001101,69,01000101
59,00111011,94,01011110,153,10011001
49,00110001,81,01010001,130,10000010
30,00011110,118,01110110,148,10010100
47,00101111,2,00000010,49,00110001
8,00001000,70,01000110,78,01001110
67,01000011,15,00001111,82,01010010
43,00101011,47,00101111,90,01011010
51,00110011,73,01001001,124,01111100
80,01010000,111,01101111,191,10111111
87,01010111,2,00000010,89,01011001
57,00111001,5,00000101,62,00111110
15,00001111,29,00011101,44,00101100
5,00000101,101,01100101,106,01101010
92,01011100,31,00011111,123,01111011
10,00001010,73,01001001,83,01010011
19,00010011,82,01010010,101,01100101
112,01110000,12,00001100,124,01111100
61,00111101,73,01001001,134,10000110
103,01100111,104,01101000,207,11001111
35,00100011,40,00101000,75,01001011
57,00111001,66,01000010,123,01111011
121,01111001,62,00111110,183,10110111
46,00101110,13,00001101,59,00111011
95,01011111,19,00010011,114,01110010
84,01010100,34,00100010,118,01110110
14,00001110,40,00101000,54,00110110
100,01100100,34,00100010,134,10000110
125,01111101,83,01010011,208,11010000
101,01100101,91,01011011,192,11000000
97,01100001,70,01000110,167,10100111
90,01011010,66,01000010,156,10011100
45,00101101,0,00000000,45,00101101
21,00010101,48,00110000,69,01000101
34,00100010,22,00010110,56,00111000
113,01110001,24,00011000,137,10001001
83,01010011,65,01000001,148,10010100
68,01000100,60,00111100,128,10000000
20,00010100,27,00011011,47,00101111
22,00010110,73,01001001,95,01011111
114,01110010,60,00111100,174,10101110
102,01100110,75,01001011,177,10110001
33,00100001,16,00010000,49,00110001
63,00111111,126,01111110,189,10111101
43,00101011,25,00011001,68,01000100
98,01100010,92,01011100,190,10111110
95,01011111,15,00001111,110,01101110
0,00000000,51,00110011,51,00110011
72,01001000,98,01100010,170,10101010
29,00011101,97,01100001,126,01111110
31,00011111,105,01101001,136,10001000
83,01010011,70,01000110,153,10011001
32,00100000,123,01111011,155,10011011
60,00111100,2,00000010,62,00111110
13,00001101,115,01110011,128,10000000
12,00001100,29,00011101,41,00101001
28,00011100,45,00101101,73,01001001
90,01011010,108,01101100,198,11000110
11,00001011,51,00110011,62,00111110
15,00001111,126,01111110,141,10001101
91,01011011,61,00111101,152,10011000
1,00000001,20,00010100,21,00010101
29,00011101,109,01101101,138,10001010
71,01000111,26,00011010,97,01100001
21,00010101,99,01100011,120,01111000
36,00100100,6,00000110,42,00101010
1,00000001,69,01000101,70,01000110
108,01101100,83,01010011,191,10111111
117,01110101,93,01011101,210,11010010
18,00010010,77,01001101,95,01011111
101,01100101,29,00011101,130,10000010
94,01011110,53,00110101,147,10010011
38,00100110,32,00100000,70,01000110
0,00000000,125,01111101,125,01111101
94,01011110,81,01010001,175,10101111
102,01100110,92,01011100,194,11000010
9,00001001,15,00001111,24,00011000
107,01101011,120,01111000,227,11100011
110,01101110,41,00101001,151,10010111
111,01101111,75,01001011,186,10111010
20,00010100,118,01110110,138,10001010
108,01101100,63,00111111,171,10101011
63,00111111,62,00111110,125,01111101
8,00001000,66,01000010,74,01001010
110,01101110,21,00010101,131,10000011
36,00100100,15,00001111,51,00110011
121,01111001,117,01110101,238,11101110
48,00110000,105,01101001,153,10011001
56,00111000,93,01011101,149,10010101
100,01100100,122,01111010,222,11011110
22,00010110,57,00111001,79,01001111
55,00110111,62,00111110,117,01110101
76,01001100,4,00000100,80,01010000
81,01010001,9,00001001,90,01011010
86,01010110,51,00110011,137,10001001
47,00101111,97,01100001,144,10010000
1,00000001,127,01111111,128,10000000
9,00001001,95,01011111,104,01101000
104,01101000,8,00001000,112,01110000
27,00011011,47,00101111,74,01001010
98,01100010,107,01101011,205,11001101
106,01101010,4,00000100,110,01101110
80,01010000,64,01000000,144,10010000
63,00111111,91,01011011,154,10011010
1,00000001,95,01011111,96,01100000
85,01010101,126,01111110,211,11010011
127,01111111,46,00101110,173,10101101
123,01111011,40,00101000,163,10100011
75,01001011,67,01000011,142,10001110
28,00011100,108,01101100,136,10001000
89,01011001,103,01100111,192,11000000
99,01100011,86,01010110,185,10111001
81,01010001,80,01010000,161,10100001
121,01111001,76,01001100,197,11000101
30,00011110,69,01000101,99,01100011
125,01111101,108,01101100,233,11101001
60,00111100,35,00100011,95,01011111
67,01000011,14,00001110,81,01010001
93,01011101,86,01010110,179,10110011
99,01100011,1,00000001,100,01100100
7,00000111,74,01001010,81,01010001
14,00001110,46,00101110,60,00111100
19,00010011,8,00001000,27,00011011
9,00001001,51,00110011,60,00111100
37,00100101,41,00101001,78,01001110
84,01010100,120,01111000,204,11001100
46,00101110,73,01001001,119,01110111
112,01110000,1,00000001,113,01110001
7,00000111,99,01100011,106,01101010
92,01011100,20,00010100,112,01110000
79,01001111,126,01111110,205,11001101
95,01011111,61,00111101,156,10011100
80,01010000,22,00010110,102,01100110
5,00000101,37,00100101,42,00101010
36,00100100,107,01101011,143,10001111
51,00110011,36,00100100,87,01010111
119,01110111,53,00110101,172,10101100
107,01101011,111,01101111,218,11011010
80,01010000,46,00101110,126,01111110
27,00011011,76,01001100,103,01100111
32,00100000,77,01001101,109,01101101
8,00001000,67,01000011,75,01001011
41,00101001,43,00101011,84,01010100
22,00010110,113,01110001,135,10000111
110,01101110,17,00010001,127,01111111
13,00001101,57,00111001,70,01000110
103,01100111,2,00000010,105,01101001
73,01001001,122,01111010,195,11000011
55,00110111,120,01111000,175,10101111
82,01010010,26,00011010,108,01101100
126,01111110,111,01101111,237,11101101
86,01010110,60,00111100,146,10010010
96,01100000,16,00010000,112,01110000
84,01010100,7,00000111,91,01011011
78,01001110,13,00001101,91,01011011
52,00110100,116,01110100,168,10101000
122,01111010,35,00100011,157,10011101
98,01100010,27,00011011,125,01111101
114,01110010,53,00110101,167,10100111
126,01111110,47,00101111,173,10101101
75,01001011,76,01001100,151,10010111
127,01111111,72,01001000,199,11000111
24,00011000,119,01110111,143,10001111
127,01111111,47,00101111,174,10101110
95,01011111,53,00110101,148,10010100
48,00110000,23,00010111,71,01000111
122,01111010,11,00001011,133,10000101
52,00110100,56,00111000,108,01101100
23,00010111,10,00001010,33,00100001
64,01000000,75,01001011,139,10001011
28,00011100,122,01111010,150,10010110
15,00001111,6,00000110,21,00010101
46,00101110,47,00101111,93,01011101
71,01000111,96,01100000,167,10100111
117,01110101,67,01000011,184,10111000
63,00111111,23,00010111,86,01010110
50,00110010,98,01100010,148,10010100
11,00001011,72,01001000,83,01010011
90,01011010,63,00111111,153,10011001
49,00110001,57,00111001,106,01101010
104,01101000,29,00011101,133,10000101
72,01001000,111,01101111,183,10110111
9,00001001,64,01000000,73,01001001
87,01010111,25,00011001,112,01110000
89,01011001,20,00010100,109,01101101
39,00100111,103,01100111,142,10001110
86,01010110,101,01100101,187,10111011
112,01110000,87,01010111,199,11000111
7,00000111,109,01101101,116,01110100
53,00110101,106,01101010,159,10011111
107,01101011,8,00001000,115,01110011
52,00110100,14,00001110,66,01000010
40,00101000,93,01011101,133,10000101
86,01010110,82,01010010,168,10101000
118,01110110,31,00011111,149,10010101
91,01011011,114,01110010,205,11001101
11,00001011,32,00100000,43,00101011
64,01000000,108,01101100,172,10101100
21,00010101,125,01111101,146,10010010
30,00011110,58,00111010,88,01011000
105,01101001,14,00001110,119,01110111
51,00110011,15,00001111,66,01000010
87,01010111,40,00101000,127,01111111
63,00111111,121,01111001,184,10111000
74,01001010,2,00000010,76,01001100
65,01000001,87,01010111,152,10011000
33,00100001,8,00001000,41,00101001
56,00111000,54,00110110,110,01101110
126,01111110,113,01110001,239,11101111
126,01111110,75,01001011,201,11001001
91,01011011,4,00000100,95,01011111
87,01010111,33,00100001,120,01111000
97,01100001,61,00111101,158,10011110
89,01011001,45,00101101,134,10000110
117,01110101,80,01010000,197,11000101
20,00010100,33,00100001,53,00110101
34,00100010,74,01001010,108,01101100
38,00100110,69,01000101,107,01101011
65,01000001,112,01110000,177,10110001
113,01110001,0,00000000,113,01110001
51,00110011,77,01001101,128,10000000
40,00101000,63,00111111,103,01100111
96,01100000,68,01000100,164,10100100
91,01011011,11,00001011,102,01100110
30,00011110,23,00010111,53,00110101
62,00111110,55,00110111,117,01110101
99,01100011,80,01010000,179,10110011
26,00011010,13,00001101,39,00100111
43,00101011,19,00010011,62,00111110
108,01101100,9,00001001,117,01110101
107,01101011,100,01100100,207,11001111
103,01100111,8,00001000,111,01101111
64,01000000,127,01111111,191,10111111
48,00110000,87,01010111,135,10000111
36,00100100,122,01111010,158,10011110
41,00101001,13,00001101,54,00110110
91,01011011,2,00000010,93,01011101
31,00011111,1,00000001,32,00100000
124,01111100,77,01001101,201,11001001
71,01000111,101,01100101,172,10101100
8,00001000,44,00101100,52,00110100
93,01011101,84,01010100,177,10110001
24,00011000,67,01000011,91,01011011
43,00101011,49,00110001,92,01011100
60,00111100,87,01010111,147,10010011
4,00000100,40,00101000,44,00101100
106,01101010,34,00100010,140,10001100
95,01011111,0,00000000,95,01011111
24,00011000,82,01010010,106,01101010
29,00011101,100,01100100,129,10000001
79,01001111,76,01001100,155,10011011
102,01100110,86,01010110,188,10111100
116,01110100,50,00110010,166,10100110
42,00101010,67,01000011,109,01101101
47,00101111,35,00100011,82,01010010
61,00111101,38,00100110,99,01100011
32,00100000,90,01011010,122,01111010
8,00001000,72,01001000,80,01010000
51,00110011,34,00100010,85,01010101
29,00011101,124,01111100,153,10011001
54,00110110,43,00101011,97,01100001
119,01110111,64,01000000,183,10110111
116,01110100,68,01000100,184,10111000
125,01111101,88,01011000,213,11010101
30,00011110,118,01110110,148,10010100
66,01000010,20,00010100,86,01010110
45,00101101,71,01000111,116,01110100
21,00010101,50,00110010,71,01000111
39,00100111,18,00010010,57,00111001
84,01010100,73,01001001,157,10011101
56,00111000,126,01111110,182,10110110
86,01010110,91,01011011,177,10110001
38,00100110,111,01101111,149,10010101
93,01011101,9,00001001,102,01100110
42,00101010,94,01011110,136,10001000
6,00000110,60,00111100,66,01000010
4,00000100,49,00110001,53,00110101
95,01011111,33,00100001,128,10000000
2,00000010,30,00011110,32,00100000
1,00000001,69,01000101,70,01000110
32,00100000,97,01100001,129,10000001
30,00011110,113,01110001,143,10001111
96,01100000,46,00101110,142,10001110
29,00011101,73,01001001,102,01100110
43,00101011,65,01000001,108,01101100
75,01001011,32,00100000,107,01101011
43,00101011,7,00000111,50,00110010
38,00100110,70,01000110,108,01101100
121,01111001,104,01101000,225,11100001
46,00101110,3,00000011,49,00110001
14,00001110,11,00001011,25,00011001
100,01100100,6,00000110,106,01101010
121,01111001,15,00001111,136,10001000
19,00010011,123,01111011,142,10001110
81,01010001,0,00000000,81,01010001
72,01001000,123,01111011,195,11000011
79,01001111,72,01001000,151,10010111
36,00100100,59,00111011,95,01011111
38,00100110,70,01000110,108,01101100
26,00011010,98,01100010,124,01111100
1,00000001,95,01011111,96,01100000
118,01110110,55,00110111,173,10101101
31,00011111,85,01010101,116,01110100
9,00001001,98,01100010,107,01101011
6,00000110,74,01001010,80,01010000
106,01101010,6,00000110,112,01110000
123,01111011,59,00111011,182,10110110
119,01110111,13,00001101,132,10000100
61,00111101,25,00011001,86,01010110
1,00000001,125,01111101,126,01111110
27,00011011,22,00010110,49,00110001
58,00111010,121,01111001,179,10110011
104,01101000,6,00000110,110,01101110
6,00000110,63,00111111,69,01000101
38,00100110,85,01010101,123,01111011
58,00111010,126,01111110,184,10111000
96,01100000,28,00011100,124,01111100
60,00111100,75,01001011,135,10000111
25,00011001,85,01010101,110,01101110
78,01001110,94,01011110,172,10101100
80,01010000,4,00000100,84,01010100
93,01011101,115,01110011,208,11010000
48,00110000,125,01111101,173,10101101
122,01111010,6,00000110,128,10000000
102,01100110,87,01010111,189,10111101
85,01010101,44,00101100,129,10000001
28,00011100,89,01011001,117,01110101
49,00110001,6,00000110,55,00110111
42,00101010,95,01011111,137,10001001
47,00101111,98,01100010,145,10010001
95,01011111,37,00100101,132,10000100
57,00111001,40,00101000,97,01100001
121,01111001,66,01000010,187,10111011
106,01101010,121,01111001,227,11100011
90,01011010,100,01100100,190,10111110
120,01111000,46,00101110,166,10100110
81,01010001,100,01100100,181,10110101
111,01101111,90,01011010,201,11001001
12,00001100,41,00101001,53,00110101
81,01010001,104,01101000,185,10111001
19,00010011,117,01110101,136,10001000
6,00000110,12,00001100,18,00010010
112,01110000,30,00011110,142,10001110
98,01100010,60,00111100,158,10011110
100,01100100,110,01101110,210,11010010
118,01110110,60,00111100,178,10110010
64,01000000,63,00111111,127,01111111
124,01111100,110,01101110,234,11101010
95,01011111,12,00001100,107,01101011
110,01101110,112,01110000,222,11011110
56,00111000,96,01100000,152,10011000
95,01011111,97,01100001,192,11000000
8,00001000,97,01100001,105,01101001
23,00010111,3,00000011,26,00011010
60,00111100,64,01000000,124,01111100
19,00010011,123,01111011,142,10001110
4,00000100,93,01011101,97,01100001
32,00100000,72,01001000,104,01101000
62,00111110,95,01011111,157,10011101
20,00010100,87,01010111,107,01101011
63,00111111,44,00101100,107,01101011
84,01010100,105,01101001,189,10111101
26,00011010,0,00000000,26,00011010
74,01001010,10,00001010,84,01010100
94,01011110,40,00101000,134,10000110
2,00000010,119,01110111,121,01111001
127,01111111,54,00110110,181,10110101
101,01100101,114,01110010,215,11010111
79,01001111,87,01010111,166,10100110
1,00000001,88,01011000,89,01011001
125,01111101,7,00000111,132,10000100
19,00010011,57,00111001,76,01001100
59,00111011,35,00100011,94,01011110
120,01111000,84,01010100,204,11001100
110,01101110,21,00010101,131,10000011
78,01001110,80,01010000,158,10011110
99,01100011,6,00000110,105,01101001
88,01011000,115,01110011,203,11001011
53,00110101,66,01000010,119,01110111
41,00101001,111,01101111,152,10011000
111,01101111,107,01101011,218,11011010
68,01000100,30,00011110,98,01100010
6,00000110,97,01100001,103,01100111
33,00100001,79,01001111,112,01110000
48,00110000,41,00101001,89,01011001
82,01010010,68,01000100,150,10010110
54,00110110,93,01011101,147,10010011
57,00111001,49,00110001,106,01101010
23,00010111,22,00010110,45,00101101
91,01011011,30,00011110,121,01111001
68,01000100,45,00101101,113,01110001
69,01000101,91,01011011,160,10100000
87,01010111,125,01111101,212,11010100
81,01010001,54,00110110,135,10000111
44,00101100,36,00100100,80,01010000
19,00010011,122,01111010,141,10001101
23,00010111,99,01100011,122,01111010
34,00100010,23,00010111,57,00111001
90,01011010,44,00101100,134,10000110
47,00101111,125,01111101,172,10101100
91,01011011,45,00101101,136,10001000
85,01010101,26,00011010,111,01101111
21,00010101,38,00100110,59,00111011
23,00010111,38,00100110,61,00111101
2,00000010,95,01011111,97,01100001
110,01101110,73,01001001,183,10110111
96,01100000,74,01001010,170,10101010
120,01111000,117,01110101,237,11101101
82,01010010,70,01000110,152,10011000
74,01001010,27,00011011,101,01100101
14,00001110,36,00100100,50,00110010
52,00110100,65,01000001,117,01110101
6,00000110,3,00000011,9,00001001
39,00100111,21,00010101,60,00111100
110,01101110,36,00100100,146,10010010
93,01011101,38,00100110,131,10000011
41,00101001,96,01100000,137,10001001
72,01001000,55,00110111,127,01111111
47,00101111,51,00110011,98,01100010
1,00000001,110,01101110,111,01101111
40,00101000,103,01100111,143,10001111
107,01101011,68,01000100,175,10101111
100,01100100,22,00010110,122,01111010
22,00010110,111,01101111,133,10000101
17,00010001,21,00010101,38,00100110
96,01100000,76,01001100,172,10101100
110,01101110,61,00111101,171,10101011
14,00001110,35,00100011,49,00110001
41,00101001,11,00001011,52,00110100
66,01000010,33,00100001,99,01100011
10,00001010,45,00101101,55,00110111
66,01000010,88,01011000,154,10011010
70,01000110,111,01101111,181,10110101
46,00101110,75,01001011,121,01111001
5,00000101,53,00110101,58,00111010
83,01010011,107,01101011,190,10111110
95,01011111,58,00111010,153,10011001
123,01111011,118,01110110,241,11110001
115,01110011,10,00001010,125,01111101
94,01011110,16,00010000,110,01101110
16,00010000,82,01010010,98,01100010
104,01101000,8,00001000,112,01110000
2,00000010,29,00011101,31,00011111
15,00001111,105,01101001,120,01111000
107,01101011,17,00010001,124,01111100
125,01111101,80,01010000,205,11001101
90,01011010,57,00111001,147,10010011
5,00000101,12,00001100,17,00010001
22,00010110,28,00011100,50,00110010
6,00000110,21,00010101,27,00011011
51,00110011,23,00010111,74,01001010
125,01111101,16,00010000,141,10001101
107,01101011,55,00110111,162,10100010
125,01111101,76,01001100,201,11001001
9,00001001,37,00100101,46,00101110
77,01001101,67,01000011,144,10010000
32,00100000,92,01011100,124,01111100
78,01001110,55,00110111,133,10000101
52,00110100,89,01011001,141,10001101
71,01000111,41,00101001,112,01110000
38,00100110,68,01000100,106,01101010
17,00010001,122,01111010,139,10001011
93,01011101,26,00011010,119,01110111
92,01011100,22,00010110,114,01110010
76,01001100,91,01011011,167,10100111
121,01111001,70,01000110,191,10111111
69,01000101,81,01010001,150,10010110
95,01011111,80,01010000,175,10101111
74,01001010,95,01011111,169,10101001
83,01010011,15,00001111,98,01100010
20,00010100,4,00000100,24,00011000
114,01110010,22,00010110,136,10001000
120,01111000,2,00000010,122,01111010
10,00001010,61,00111101,71,01000111
65,01000001,64,01000000,129,10000001
118,01110110,26,00011010,144,10010000
23,00010111,6,00000110,29,00011101
27,00011011,11,00001011,38,00100110
88,01011000,19,00010011,107,01101011
50,00110010,79,01001111,129,10000001
89,01011001,62,00111110,151,10010111
114,01110010,97,01100001,211,11010011
126,01111110,90,01011010,216,11011000
52,00110100,120,01111000,172,10101100
110,01101110,10,00001010,120,01111000
55,00110111,49,00110001,104,01101000
43,00101011,8,00001000,51,00110011
67,01000011,90,01011010,157,10011101
17,00010001,65,01000001,82,01010010
82,01010010,110,01101110,192,11000000
86,01010110,59,00111011,145,10010001
71,01000111,59,00111011,130,10000010
15,00001111,69,01000101,84,01010100
70,01000110,102,01100110,172,10101100
75,01001011,45,00101101,120,01111000
35,00100011,24,00011000,59,00111011
112,01110000,46,00101110,158,10011110
19,00010011,9,00001001,28,00011100
49,00110001,106,01101010,155,10011011
13,00001101,29,00011101,42,00101010
40,00101000,15,00001111,55,00110111
24,00011000,118,01110110,142,10001110
120,01111000,59,00111011,179,10110011
44,00101100,60,00111100,104,01101000
75,01001011,51,00110011,126,01111110
113,01110001,56,00111000,169,10101001
116,01110100,97,01100001,213,11010101
127,01111111,46,00101110,173,10101101
103,01100111,59,00111011,162,10100010
74,01001010,113,01110001,187,10111011
69,01000101,78,01001110,147,10010011
20,00010100,88,01011000,108,01101100
114,01110010,92,01011100,206,11001110
100,01100100,30,00011110,130,10000010
60,00111100,95,01011111,155,10011011
20,00010100,41,00101001,61,00111101
91,01011011,1,00000001,92,01011100
57,00111001,67,01000011,124,01111100
66,01000010,107,01101011,173,10101101
72,01001000,108,01101100,180,10110100
15,00001111,48,00110000,63,00111111
100,01100100,1,00000001,101,01100101
44,00101100,74,01001010,118,01110110
98,01100010,100,01100100,198,11000110
85,01010101,86,01010110,171,10101011
82,01010010,123,01111011,205,11001101
48,00110000,124,01111100,172,10101100
6,00000110,18,00010010,24,00011000
32,00100000,39,00100111,71,01000111
23,00010111,26,00011010,49,00110001
75,01001011,66,01000010,141,10001101
79,01001111,5,00000101,84,01010100
39,00100111,100,01100100,139,10001011
77,01001101,119,01110111,196,11000100
122,01111010,99,01100011,221,11011101
13,00001101,49,00110001,62,00111110
17,00010001,57,00111001,74,01001010
0,00000000,106,01101010,106,01101010
38,00100110,75,01001011,113,01110001
28,00011100,110,01101110,138,10001010
54,00110110,30,00011110,84,01010100
58,00111010,64,01000000,122,01111010
81,01010001,52,00110100,133,10000101
103,01100111,36,00100100,139,10001011
56,00111000,96,01100000,152,10011000
98,01100010,119,01110111,217,11011001
122,01111010,89,01011001,211,11010011
2,00000010,90,01011010,92,01011100
6,00000110,27,00011011,33,00100001
9,00001001,99,01100011,108,01101100
118,01110110,81,01010001,199,11000111
119,01110111,96,01100000,215,11010111
62,00111110,111,01101111,173,10101101
87,01010111,37,00100101,124,01111100
76,01001100,17,00010001,93,01011101
53,00110101,86,01010110,139,10001011
33,00100001,60,00111100,93,01011101
42,00101010,44,00101100,86,01010110
90,01011010,22,00010110,112,01110000
36,00100100,6,00000110,42,00101010
113,01110001,126,01111110,239,11101111
29,00011101,72,01001000,101,01100101
126,01111110,32,00100000,158,10011110
7,00000111,117,01110101,124,01111100
16,00010000,10,00001010,26,00011010
19,00010011,100,01100100,119,01110111
36,00100100,81,01010001,117,01110101
60,00111100,79,01001111,139,10001011
111,01101111,103,01100111,214,11010110
38,00100110,60,00111100,98,01100010
24,00011000,122,01111010,146,10010010
24,00011000,44,00101100,68,01000100
21,00010101,29,00011101,50,00110010
41,00101001,100,01100100,141,10001101
109,01101101,98,01100010,207,11001111
20,00010100,127,01111111,147,10010011
49,00110001,35,00100011,84,01010100
27,00011011,96,01100000,123,01111011
41,00101001,66,01000010,107,01101011
30,00011110,16,00010000,46,00101110
14,00001110,26,00011010,40,00101000
92,01011100,92,01011100,184,10111000
12,00001100,59,00111011,71,01000111
115,01110011,41,00101001,156,10011100
14,00001110,23,00010111,37,00100101
99,01100011,36,00100100,135,10000111
79,01001111,125,01111101,204,11001100
82,01010010,118,01110110,200,11001000
56,00111000,109,01101101,165,10100101
32,00100000,63,00111111,95,01011111
5,00000101,60,00111100,65,01000001
104,01101000,101,01100101,205,11001101
80,01010000,81,01010001,161,10100001
35,00100011,38,00100110,73,01001001
59,00111011,94,01011110,153,10011001
25,00011001,43,00101011,68,01000100
107,01101011,24,00011000,131,10000011
88,01011000,111,01101111,199,11000111
115,01110011,26,00011010,141,10001101
120,01111000,73,01001001,193,11000001
90,01011010,9,00001001,99,01100011
62,00111110,47,00101111,109,01101101
56,00111000,73,01001001,129,10000001
14,00001110,104,01101000,118,01110110
59,00111011,54,00110110,113,01110001
95,01011111,81,01010001,176,10110000
70,01000110,34,00100010,104,01101000
61,00111101,38,00100110,99,01100011
76,01001100,72,01001000,148,10010100
13,00001101,95,01011111,108,01101100
113,01110001,12,00001100,125,01111101
69,01000101,82,01010010,151,10010111
22,00010110,92,01011100,114,01110010
40,00101000,1,00000001,41,00101001
69,01000101,42,00101010,111,01101111
127,01111111,39,00100111,166,10100110
87,01010111,34,00100010,121,01111001
96,01100000,22,00010110,118,01110110
103,01100111,124,01111100,227,11100011
71,01000111,14,00001110,85,01010101
71,01000111,36,00100100,107,01101011
45,00101101,18,00010010,63,00111111
86,01010110,30,00011110,116,01110100
19,00010011,64,01000000,83,01010011
110,01101110,30,00011110,140,10001100
76,01001100,39,00100111,115,01110011
39,00100111,89,01011001,128,10000000
45,00101101,98,01100010,143,10001111
21,00010101,1,00000001,22,00010110
123,01111011,50,00110010,173,10101101
25,00011001,127,01111111,152,10011000
96,01100000,6,00000110,102,01100110
18,00010010,91,01011011,109,01101101
48,00110000,49,00110001,97,01100001
122,01111010,25,00011001,147,10010011
33,00100001,95,01011111,128,10000000
11,00001011,113,01110001,124,01111100
66,01000010,89,01011001,155,10011011
124,01111100,12,00001100,136,10001000
30,00011110,78,01001110,108,01101100
20,00010100,45,00101101,65,01000001
90,01011010,30,00011110,120,01111000
91,01011011,96,01100000,187,10111011
37,00100101,44,00101100,81,01010001
54,00110110,94,01011110,148,10010100
127,01111111,9,00001001,136,10001000
88,01011000,85,01010101,173,10101101
10,00001010,95,01011111,105,01101001
46,00101110,97,01100001,143,10001111
2,00000010,124,01111100,126,01111110
111,01101111,7,00000111,118,01110110
125,01111101,89,01011001,214,11010110
7,00000111,9,00001001,16,00010000
31,00011111,47,00101111,78,01001110
34,00100010,115,01110011,149,10010101
72,01001000,55,00110111,127,01111111
62,00111110,32,00100000,94,01011110
44,00101100,101,01100101,145,10010001
30,00011110,93,01011101,123,01111011
94,01011110,93,01011101,187,10111011
68,01000100,13,00001101,81,01010001
70,01000110,80,01010000,150,10010110
86,01010110,104,01101000,190,10111110
59,00111011,88,01011000,147,10010011
108,01101100,9,00001001,117,01110101
113,01110001,15,00001111,128,10000000
95,01011111,64,01000000,159,10011111
81,01010001,5,00000101,86,01010110
33,00100001,42,00101010,75,01001011
124,01111100,121,01111001,245,11110101
127,01111111,114,01110010,241,11110001
20,00010100,127,01111111,147,10010011
50,00110010,84,01010100,134,10000110
19,00010011,54,00110110,73,01001001
11,00001011,24,00011000,35,00100011
103,01100111,21,00010101,124,01111100
72,01001000,20,00010100,92,01011100
5,00000101,59,00111011,64,01000000
126,01111110,31,00011111,157,10011101
121,01111001,57,00111001,178,10110010
77,01001101,20,00010100,97,01100001
80,01010000,87,01010111,167,10100111
50,00110010,71,01000111,121,01111001
90,01011010,12,00001100,102,01100110
7,00000111,121,01111001,128,10000000
73,01001001,114,01110010,187,10111011
126,01111110,55,00110111,181,10110101
46,00101110,10,00001010,56,00111000
53,00110101,115,01110011,168,10101000
107,01101011,41,00101001,148,10010100
82,01010010,89,01011001,171,10101011
13,00001101,113,01110001,126,01111110
113,01110001,116,01110100,229,11100101
126,01111110,97,01100001,223,11011111
53,00110101,114,01110010,167,10100111
4,00000100,95,01011111,99,01100011
101,01100101,116,01110100,217,11011001
9,00001001,78,01001110,87,01010111
16,00010000,125,01111101,141,10001101
64,01000000,95,01011111,159,10011111
75,01001011,98,01100010,173,10101101
60,00111100,8,00001000,68,01000100
43,00101011,61,00111101,104,01101000
89,01011001,49,00110001,138,10001010
118,01110110,82,01010010,200,11001000
42,00101010,39,00100111,81,01010001
70,01000110,122,01111010,192,11000000
18,00010010,100,01100100,118,01110110
106,01101010,61,00111101,167,10100111
43,00101011,35,00100011,78,01001110
34,00100010,13,00001101,47,00101111
85,01010101,65,01000001,150,10010110
58,00111010,99,01100011,157,10011101
70,01000110,97,01100001,167,10100111
59,00111011,10,00001010,69,01000101
32,00100000,75,01001011,107,01101011
33,00100001,14,00001110,47,00101111
88,01011000,51,00110011,139,10001011
121,01111001,115,01110011,236,11101100
35,00100011,108,01101100,143,10001111
80,01010000,116,01110100,196,11000100
67,01000011,101,01100101,168,10101000
99,01100011,110,01101110,209,11010001
30,00011110,2,00000010,32,00100000
34,00100010,115,01110011,149,10010101
19,00010011,116,01110100,135,10000111
14,00001110,48,00110000,62,00111110
34,00100010,81,01010001,115,01110011
29,00011101,112,01110000,141,10001101
83,01010011,125,01111101,208,11010000
27,00011011,107,01101011,134,10000110
68,01000100,38,00100110,106,01101010
107,01101011,31,00011111,138,10001010
1,00000001,11,00001011,12,00001100
8,00001000,37,00100101,45,00101101
37,00100101,15,00001111,52,00110100
110,01101110,11,00001011,121,01111001
10,00001010,99,01100011,109,01101101
62,00111110,117,01110101,179,10110011
31,00011111,2,00000010,33,00100001
44,00101100,55,00110111,99,01100011
70,01000110,66,01000010,136,10001000
52,00110100,25,00011001,77,01001101
17,00010001,95,01011111,112,01110000
57,00111001,77,01001101,134,10000110
13,00001101,68,01000100,81,01010001
61,00111101,88,01011000,149,10010101
115,01110011,125,01111101,240,11110000
4,00000100,62,00111110,66,01000010
118,01110110,110,01101110,228,11100100
45,00101101,111,01101111,156,10011100
105,01101001,26,00011010,131,10000011
110,01101110,18,00010010,128,10000000
115,01110011,34,00100010,149,10010101
89,01011001,106,01101010,195,11000011
125,01111101,5,00000101,130,10000010
49,00110001,13,00001101,62,00111110
87,01010111,64,01000000,151,10010111
46,00101110,75,01001011,121,01111001
2,00000010,47,00101111,49,00110001
86,01010110,66,01000010,152,10011000
34,00100010,102,01100110,136,10001000
75,01001011,126,01111110,201,11001001
108,01101100,55,00110111,163,10100011
89,01011001,89,01011001,178,10110010
4,00000100,92,01011100,96,01100000
33,00100001,87,01010111,120,01111000
85,01010101,77,01001101,162,10100010
50,00110010,49,00110001,99,01100011
23,00010111,102,01100110,125,01111101
20,00010100,45,00101101,65,01000001
119,01110111,49,00110001,168,10101000
9,00001001,49,00110001,58,00111010
37,00100101,124,01111100,161,10100001
123,01111011,82,01010010,205,11001101
31,00011111,38,00100110,69,01000101
117,01110101,2,00000010,119,01110111
91,01011011,35,00100011,126,01111110
31,00011111,104,01101000,135,10000111
55,00110111,2,00000010,57,00111001
122,01111010,114,01110010,236,11101100
103,01100111,34,00100010,137,10001001
79,01001111,13,00001101,92,01011100
119,01110111,20,00010100,139,10001011
80,01010000,125,01111101,205,11001101
41,00101001,116,01110100,157,10011101
12,00001100,70,01000110,82,01010010
32,00100000,10,00001010,42,00101010
57,00111001,43,00101011,100,01100100
33,00100001,55,00110111,88,01011000
70,01000110,36,00100100,106,01101010
20,00010100,71,01000111,91,01011011
18,00010010,102,01100110,120,01111000
83,01010011,59,00111011,142,10001110
4,00000100,92,01011100,96,01100000
40,00101000,31,00011111,71,01000111
81,01010001,127,01111111,208,11010000
64,01000000,84,01010100,148,10010100
107,01101011,8,00001000,115,01110011
90,01011010,56,00111000,146,10010010
124,01111100,63,00111111,187,10111011
2,00000010,36,00100100,38,00100110
21,00010101,22,00010110,43,00101011
66,01000010,3,00000011,69,01000101
77,01001101,91,01011011,168,10101000
86,01010110,127,01111111,213,11010101
119,01110111,69,01000101,188,10111100
46,00101110,11,00001011,57,00111001
107,01101011,114,01110010,221,11011101
122,01111010,122,01111010,244,11110100
85,01010101,29,00011101,114,01110010
106,01101010,78,01001110,184,10111000
12,00001100,105,01101001,117,01110101
39,00100111,80,01010000,119,01110111
44,00101100,47,00101111,91,01011011
61,00111101,11,00001011,72,01001000
116,01110100,80,01010000,196,11000100
42,00101010,17,00010001,59,00111011
0,00000000,111,01101111,111,01101111
124,01111100,52,00110100,176,10110000
34,00100010,61,00111101,95,01011111
63,00111111,123,01111011,186,10111010
112,01110000,58,00111010,170,10101010
53,00110101,91,01011011,144,10010000
44,00101100,96,01100000,140,10001100
30,00011110,16,00010000,46,00101110
25,00011001,29,00011101,54,00110110
24,00011000,18,00010010,42,00101010
8,00001000,96,01100000,104,01101000
13,00001101,8,00001000,21,00010101
15,00001111,102,01100110,117,01110101
106,01101010,85,01010101,191,10111111
36,00100100,77,01001101,113,01110001
76,01001100,115,01110011,191,10111111
50,00110010,5,00000101,55,00110111
16,00010000,101,01100101,117,01110101
25,00011001,94,01011110,119,01110111
88,01011000,117,01110101,205,11001101
113,01110001,118,01110110,231,11100111
111,01101111,112,01110000,223,11011111
123,01111011,80,01010000,203,11001011
9,00001001,4,00000100,13,00001101
12,00001100,102,01100110,114,01110010
64,01000000,30,00011110,94,01011110
48,00110000,89,01011001,137,10001001
71,01000111,126,01111110,197,11000101
91,01011011,90,01011010,181,10110101
91,01011011,20,00010100,111,01101111
50,00110010,72,01001000,122,01111010
46,00101110,113,01110001,159,10011111
23,00010111,84,01010100,107,01101011
70,01000110,121,01111001,191,10111111
33,00100001,73,01001001,106,01101010
20,00010100,110,01101110,130,10000010
3,00000011,82,01010010,85,01010101
125,01111101,101,01100101,226,11100010
21,00010101,126,01111110,147,10010011
54,00110110,115,01110011,169,10101001
37,00100101,5,00000101,42,00101010
31,00011111,104,01101000,135,10000111
36,00100100,112,01110000,148,10010100
113,01110001,115,01110011,228,11100100
67,01000011,104,01101000,171,10101011
121,01111001,119,01110111,240,11110000
19,00010011,8,00001000,27,00011011
118,01110110,38,00100110,156,10011100
6,00000110,47,00101111,53,00110101
21,00010101,19,00010011,40,00101000
35,00100011,93,01011101,128,10000000
24,00011000,26,00011010,50,00110010
39,00100111,25,00011001,64,01000000
31,00011111,62,00111110,93,01011101
59,00111011,68,01000100,127,01111111
14,00001110,127,01111111,141,10001101
15,00001111,75,01001011,90,01011010
14,00001110,24,00011000,38,00100110
82,01010010,103,01100111,185,10111001
95,01011111,54,00110110,149,10010101
115,01110011,48,00110000,163,10100011
13,00001101,80,01010000,93,01011101
41,00101001,57,00111001,98,01100010
12,00001100,119,01110111,131,10000011
25,00011001,59,00111011,84,01010100
11,00001011,93,01011101,104,01101000
98,01100010,25,00011001,123,01111011
51,00110011,50,00110010,101,01100101
43,00101011,33,00100001,76,01001100
53,00110101,21,00010101,74,01001010
67,01000011,117,01110101,184,10111000
90,01011010,56,00111000,146,10010010
0,00000000,30,00011110,30,00011110
127,01111111,1,00000001,128,10000000
6,00000110,117,01110101,123,01111011
65,01000001,120,01111000,185,10111001
108,01101100,114,01110010,222,11011110
74,01001010,79,01001111,153,10011001
34,00100010,91,01011011,125,01111101
13,00001101,23,00010111,36,00100100
127,01111111,24,00011000,151,10010111
46,00101110,57,00111001,103,01100111
104,01101000,34,00100010,138,10001010
19,00010011,20,00010100,39,00100111
32,00100000,111,01101111,143,10001111
120,01111000,5,00000101,125,01111101
21,00010101,81,01010001,102,01100110
56,00111000,127,01111111,183,10110111
8,00001000,58,00111010,66,01000010
114,01110010,24,00011000,138,10001010
64,01000000,102,01100110,166,10100110
11,00001011,103,01100111,114,01110010
109,01101101,120,01111000,229,11100101
70,01000110,115,01110011,185,10111001
96,01100000,28,00011100,124,01111100
26,00011010,123,01111011,149,10010101
40,00101000,87,01010111,127,01111111
5,00000101,48,00110000,53,00110101
23,00010111,50,00110010,73,01001001
101,01100101,81,01010001,182,10110110
112,01110000,120,01111000,232,11101000
74,01001010,49,00110001,123,01111011
60,00111100,51,00110011,111,01101111
107,01101011,36,00100100,143,10001111
7,00000111,66,01000010,73,01001001
107,01101011,74,01001010,181,10110101
86,01010110,122,01111010,208,11010000
85,01010101,88,01011000,173,10101101
62,00111110,28,00011100,90,01011010
22,00010110,101,01100101,123,01111011
33,00100001,21,00010101,54,00110110
62,00111110,16,00010000,78,01001110
86,01010110,123,01111011,209,11010001
82,01010010,1,00000001,83,01010011
61,00111101,12,00001100,73,01001001
11,00001011,109,01101101,120,01111000
101,01100101,34,00100010,135,10000111
54,00110110,65,01000001,119,01110111
25,00011001,120,01111000,145,10010001
10,00001010,116,01110100,126,01111110
103,01100111,81,01010001,184,10111000
126,01111110,92,01011100,218,11011010
6,00000110,29,00011101,35,00100011
46,00101110,115,01110011,161,10100001
110,01101110,106,01101010,216,11011000
23,00010111,56,00111000,79,01001111
42,00101010,20,00010100,62,00111110
30,00011110,97,01100001,127,01111111
48,00110000,11,00001011,59,00111011
14,00001110,41,00101001,55,00110111
40,00101000,13,00001101,53,00110101
62,00111110,102,01100110,164,10100100
56,00111000,103,01100111,159,10011111
87,01010111,21,00010101,108,01101100
98,01100010,120,01111000,218,11011010
35,00100011,8,00001000,43,00101011
111,01101111,23,00010111,134,10000110
119,01110111,100,01100100,219,11011011
46,00101110,94,01011110,140,10001100
63,00111111,56,00111000,119,01110111
75,01001011,15,00001111,90,01011010
43,00101011,19,00010011,62,00111110
125,01111101,119,01110111,244,11110100
67,01000011,27,00011011,94,01011110
69,01000101,79,01001111,148,10010100
92,01011100,72,01001000,164,10100100
118,01110110,5,00000101,123,01111011
127,01111111,96,01100000,223,11011111
110,01101110,16,00010000,126,01111110
25,00011001,50,00110010,75,01001011
27,00011011,57,00111001,84,01010100
27,00011011,67,01000011,94,01011110
28,00011100,72,01001000,100,01100100
84,01010100,4,00000100,88,01011000
32,00100000,4,00000100,36,00100100
123,01111011,109,01101101,232,11101000
104,01101000,92,01011100,196,11000100
109,01101101,64,01000000,173,10101101
59,00111011,74,01001010,133,10000101
96,01100000,19,00010011,115,01110011
44,00101100,77,01001101,121,01111001
10,00001010,28,00011100,38,00100110
67,01000011,29,00011101,96,01100000
74,01001010,53,00110101,127,01111111
19,00010011,118,01110110,137,10001001
77,01001101,56,00111000,133,10000101
67,01000011,31,00011111,98,01100010
14,00001110,30,00011110,44,00101100
38,00100110,20,00010100,58,00111010
58,00111010,103,01100111,161,10100001
49,00110001,106,01101010,155,10011011
17,00010001,121,01111001,138,10001010
126,01111110,0,00000000,126,01111110
14,00001110,28,00011100,42,00101010
114,01110010,33,00100001,147,10010011
89,01011001,118,01110110,207,11001111
103,01100111,121,01111001,224,11100000
97,01100001,80,01010000,177,10110001
43,00101011,31,00011111,74,01001010
21,00010101,95,01011111,116,01110100
73,01001001,63,00111111,136,10001000
37,00100101,109,01101101,146,10010010
114,01110010,118,01110110,232,11101000
102,01100110,18,00010010,120,01111000
91,01011011,118,01110110,209,11010001
70,01000110,97,01100001,167,10100111
126,01111110,7,00000111,133,10000101
54,00110110,49,00110001,103,01100111
95,01011111,33,00100001,128,10000000
6,00000110,32,00100000,38,00100110
26,00011010,118,01110110,144,10010000
52,00110100,89,01011001,141,10001101
23,00010111,20,00010100,43,00101011
25,00011001,13,00001101,38,00100110
10,00001010,13,00001101,23,00010111
123,01111011,101,01100101,224,11100000
10,00001010,98,01100010,108,01101100
57,00111001,45,00101101,102,01100110
30,00011110,85,01010101,115,01110011
125,01111101,123,01111011,248,11111000
45,00101101,35,00100011,80,01010000
68,01000100,13,00001101,81,01010001
109,01101101,104,01101000,213,11010101
51,00110011,3,00000011,54,00110110
60,00111100,119,01110111,179,10110011
18,00010010,53,00110101,71,01000111
111,01101111,38,00100110,149,10010101
5,00000101,60,00111100,65,01000001
60,00111100,124,01111100,184,10111000
126,01111110,54,00110110,180,10110100
3,00000011,48,00110000,51,00110011
120,01111000,64,01000000,184,10111000
0,00000000,55,00110111,55,00110111
37,00100101,35,00100011,72,01001000
39,00100111,97,01100001,136,10001000
58,00111010,22,00010110,80,01010000
29,00011101,32,00100000,61,00111101
15,00001111,109,01101101,124,01111100
125,01111101,61,00111101,186,10111010
114,01110010,108,01101100,222,11011110
25,00011001,86,01010110,111,01101111
111,01101111,37,00100101,148,10010100
5,00000101,89,01011001,94,01011110
52,00110100,82,01010010,134,10000110
38,00100110,24,00011000,62,00111110
34,00100010,46,00101110,80,01010000
118,01110110,105,01101001,223,11011111
97,01100001,114,01110010,211,11010011
45,00101101,12,00001100,57,00111001
38,00100110,45,00101101,83,01010011
7,00000111,107,01101011,114,01110010
37,00100101,127,01111111,164,10100100
19,00010011,74,01001010,93,01011101
103,01100111,91,01011011,194,11000010
48,00110000,54,00110110,102,01100110
112,01110000,62,00111110,174,10101110
55,00110111,57,00111001,112,01110000
20,00010100,20,00010100,40,00101000
9,00001001,97,01100001,106,01101010
23,00010111,11,00001011,34,00100010
66,01000010,86,01010110,152,10011000
104,01101000,26,00011010,130,10000010
0,00000000,95,01011111,95,01011111
70,01000110,43,00101011,113,01110001
78,01001110,111,01101111,189,10111101
120,01111000,2,00000010,122,01111010
48,00110000,32,00100000,80,01010000
0,00000000,92,01011100,92,01011100
58,00111010,21,00010101,79,01001111
47,00101111,57,00111001,104,01101000
127,01111111,78,01001110,205,11001101
31,00011111,20,00010100,51,00110011
58,00111010,36,00100100,94,01011110
112,01110000,77,01001101,189,10111101
63,00111111,61,00111101,124,01111100
65,01000001,104,01101000,169,10101001
123,01111011,99,01100011,222,11011110
21,00010101,26,00011010,47,00101111
50,00110010,115,01110011,165,10100101
4,00000100,114,01110010,118,01110110
74,01001010,107,01101011,181,10110101
114,01110010,34,00100010,148,10010100
81,01010001,102,01100110,183,10110111
55,00110111,107,01101011,162,10100010
120,01111000,82,01010010,202,11001010
43,00101011,31,00011111,74,01001010
59,00111011,45,00101101,104,01101000
68,01000100,63,00111111,131,10000011
123,01111011,48,00110000,171,10101011
52,00110100,28,00011100,80,01010000
124,01111100,97,01100001,221,11011101
115,01110011,89,01011001,204,11001100
43,00101011,73,01001001,116,01110100
109,01101101,0,00000000,109,01101101
71,01000111,121,01111001,192,11000000
122,01111010,89,01011001,211,11010011
124,01111100,87,01010111,211,11010011
5,00000101,72,01001000,77,01001101
98,01100010,48,00110000,146,10010010
85,01010101,15,00001111,100,01100100
62,00111110,24,00011000,86,01010110
41,00101001,31,00011111,72,01001000
105,01101001,14,00001110,119,01110111
27,00011011,25,00011001,52,00110100
92,01011100,50,00110010,142,10001110
101,01100101,89,01011001,190,10111110
123,01111011,98,01100010,221,11011101
127,01111111,96,01100000,223,11011111
31,00011111,110,01101110,141,10001101
91,01011011,41,00101001,132,10000100
126,01111110,15,00001111,141,10001101
37,00100101,124,01111100,161,10100001
124,01111100,87,01010111,211,11010011
65,01000001,23,00010111,88,01011000
66,01000010,102,01100110,168,10101000
110,01101110,97,01100001,207,11001111
27,00011011,51,00110011,78,01001110
24,00011000,1,00000001,25,00011001
36,00100100,84,01010100,120,01111000
35,00100011,54,00110110,89,01011001
121,01111001,66,01000010,187,10111011
2,00000010,24,00011000,26,00011010
84,01010100,35,00100011,119,01110111
81,01010001,121,01111001,202,11001010
16,00010000,95,01011111,111,01101111
51,00110011,10,00001010,61,00111101
115,01110011,45,00101101,160,10100000
11,00001011,48,00110000,59,00111011
97,01100001,27,00011011,124,01111100
34,00100010,127,01111111,161,10100001
68,01000100,45,00101101,113,01110001
17,00010001,104,01101000,121,01111001
92,01011100,19,00010011,111,01101111
9,00001001,34,00100010,43,00101011
83,01010011,124,01111100,207,11001111
118,01110110,113,01110001,231,11100111
88,01011000,102,01100110,190,10111110
12,00001100,48,00110000,60,00111100
31,00011111,12,00001100,43,00101011
127,01111111,10,00001010,137,10001001
54,00110110,54,00110110,108,01101100
55,00110111,80,01010000,135,10000111
24,00011000,26,00011010,50,00110010
97,01100001,101,01100101,198,11000110
118,01110110,29,00011101,147,10010011
68,01000100,58,00111010,126,01111110
9,00001001,15,00001111,24,00011000
75,01001011,63,00111111,138,10001010
40,00101000,106,01101010,146,10010010
100,01100100,4,00000100,104,01101000
109,01101101,5,00000101,114,01110010
26,00011010,2,00000010,28,00011100
114,01110010,117,01110101,231,11100111
91,01011011,27,00011011,118,01110110
118,01110110,110,01101110,228,11100100
44,00101100,6,00000110,50,00110010
57,00111001,79,01001111,136,10001000
35,00100011,3,00000011,38,00100110
70,01000110,6,00000110,76,01001100
62,00111110,92,01011100,154,10011010
110,01101110,19,00010011,129,10000001
112,01110000,87,01010111,199,11000111
103,01100111,11,00001011,114,01110010
64,01000000,0,00000000,64,01000000
42,00101010,19,00010011,61,00111101
12,00001100,127,01111111,139,10001011
11,00001011,24,00011000,35,00100011
10,00001010,89,01011001,99,01100011
18,00010010,100,01100100,118,01110110
32,00100000,117,01110101,149,10010101
0,00000000,37,00100101,37,00100101
62,00111110,53,00110101,115,01110011
4,00000100,112,01110000,116,01110100
64,01000000,122,01111010,186,10111010
111,01101111,35,00100011,146,10010010
56,00111000,80,01010000,136,10001000
117,01110101,75,01001011,192,11000000
54,00110110,56,00111000,110,01101110
12,00001100,61,00111101,73,01001001
110,01101110,99,01100011,209,11010001
83,01010011,30,00011110,113,01110001
111,01101111,109,01101101,220,11011100
59,00111011,85,01010101,144,10010000
9,00001001,123,01111011,132,10000100
16,00010000,106,01101010,122,01111010
94,01011110,45,00101101,139,10001011
19,00010011,58,00111010,77,01001101
6,00000110,121,01111001,127,01111111
94,01011110,103,01100111,197,11000101
4,00000100,75,01001011,79,01001111
52,00110100,20,00010100,72,01001000
53,00110101,73,01001001,126,01111110
74,01001010,96,01100000,170,10101010
95,01011111,14,00001110,109,01101101
5,00000101,20,00010100,25,00011001
8,00001000,42,00101010,50,00110010
39,00100111,13,00001101,52,00110100
75,01001011,21,00010101,96,01100000
58,00111010,29,00011101,87,01010111
69,01000101,92,01011100,161,10100001
8,00001000,73,01001001,81,01010001
66,01000010,59,00111011,125,01111101
30,00011110,123,01111011,153,10011001
19,00010011,32,00100000,51,00110011
109,01101101,95,01011111,204,11001100
120,01111000,19,00010011,139,10001011
39,00100111,37,00100101,76,01001100
123,01111011,25,00011001,148,10010100
32,00100000,91,01011011,123,01111011
123,01111011,4,00000100,127,01111111
60,00111100,64,01000000,124,01111100
82,01010010,121,01111001,203,11001011
13,00001101,100,01100100,113,01110001
74,01001010,62,00111110,136,10001000
86,01010110,73,01001001,159,10011111
31,00011111,36,00100100,67,01000011
125,01111101,15,00001111,140,10001100
85,01010101,62,00111110,147,10010011
90,01011010,96,01100000,186,10111010
14,00001110,13,00001101,27,00011011
15,00001111,89,01011001,104,01101000
119,01110111,112,01110000,231,11100111
127,01111111,23,00010111,150,10010110
0,00000000,15,00001111,15,00001111
36,00100100,124,01111100,160,10100000
107,01101011,90,01011010,197,11000101
40,00101000,33,00100001,73,01001001
27,00011011,30,00011110,57,00111001
24,00011000,37,00100101,61,00111101
50,00110010,13,00001101,63,00111111
114,01110010,46,00101110,160,10100000
119,01110111,13,00001101,132,10000100
67,01000011,48,00110000,115,01110011
93,01011101,101,01100101,194,11000010
127,01111111,114,01110010,241,11110001
101,01100101,10,00001010,111,01101111
81,01010001,108,01101100,189,10111101
89,01011001,0,00000000,89,01011001
126,01111110,80,01010000,206,11001110
119,01110111,44,00101100,163,10100011
99,01100011,100,01100100,199,11000111
70,01000110,70,01000110,140,10001100
32,00100000,29,00011101,61,00111101
121,01111001,88,01011000,209,11010001
67,01000011,116,01110100,183,10110111
88,01011000,77,01001101,165,10100101
21,00010101,117,01110101,138,10001010
119,01110111,70,01000110,189,10111101
125,01111101,117,01110101,242,11110010
53,00110101,43,00101011,96,01100000
88,01011000,60,00111100,148,10010100
61,00111101,46,00101110,107,01101011
52,00110100,63,00111111,115,01110011
103,01100111,36,00100100,139,10001011
74,01001010,9,00001001,83,01010011
93,01011101,11,00001011,104,01101000
39,00100111,14,00001110,53,00110101
125,01111101,82,01010010,207,11001111
84,01010100,18,00010010,102,01100110
9,00001001,91,01011011,100,01100100
47,00101111,114,01110010,161,10100001
100,01100100,106,01101010,206,11001110
103,01100111,111,01101111,214,11010110
74,01001010,120,01111000,194,11000010
102,01100110,29,00011101,131,10000011
29,00011101,78,01001110,107,01101011
0,00000000,24,00011000,24,00011000
85,01010101,77,01001101,162,10100010
53,00110101,61,00111101,114,01110010
104,01101000,47,00101111,151,10010111
23,00010111,91,01011011,114,01110010
32,00100000,83,01010011,115,01110011
10,00001010,63,00111111,73,01001001
25,00011001,112,01110000,137,10001001
13,00001101,3,00000011,16,00010000
80,01010000,102,01100110,182,10110110
32,00100000,70,01000110,102,01100110
29,00011101,64,01000000,93,01011101
83,01010011,25,00011001,108,01101100
82,01010010,65,01000001,147,10010011
111,01101111,38,00100110,149,10010101
27,00011011,24,00011000,51,00110011
43,00101011,85,01010101,128,10000000
2,00000010,11,00001011,13,00001101
60,00111100,85,01010101,145,10010001
92,01011100,82,01010010,174,10101110
68,01000100,71,01000111,139,10001011
90,01011010,51,00110011,141,10001101
27,00011011,73,01001001,100,01100100
19,00010011,6,00000110,25,00011001
13,00001101,52,00110100,65,01000001
85,01010101,87,01010111,172,10101100
30,00011110,47,00101111,77,01001101
11,00001011,75,01001011,86,01010110
32,00100000,40,00101000,72,01001000
126,01111110,50,00110010,176,10110000
75,01001011,48,00110000,123,01111011
67,01000011,107,01101011,174,10101110
117,01110101,54,00110110,171,10101011
0,00000000,95,01011111,95,01011111
5,00000101,33,00100001,38,00100110
122,01111010,0,00000000,122,01111010
114,01110010,37,00100101,151,10010111
92,01011100,80,01010000,172,10101100
107,01101011,38,00100110,145,10010001
106,01101010,28,00011100,134,10000110
39,00100111,45,00101101,84,01010100
50,00110010,34,00100010,84,01010100
103,01100111,124,01111100,227,11100011
54,00110110,1,00000001,55,00110111
43,00101011,127,01111111,170,10101010
84,01010100,87,01010111,171,10101011
17,00010001,125,01111101,142,10001110
53,00110101,14,00001110,67,01000011
57,00111001,120,01111000,177,10110001
78,01001110,57,00111001,135,10000111
97,01100001,109,01101101,206,11001110
47,00101111,94,01011110,141,10001101
95,01011111,117,01110101,212,11010100
26,00011010,39,00100111,65,01000001
107,01101011,95,01011111,202,11001010
22,00010110,101,01100101,123,01111011
20,00010100,32,00100000,52,00110100
100,01100100,108,01101100,208,11010000
127,01111111,31,00011111,158,10011110
78,01001110,50,00110010,128,10000000
81,01010001,124,01111100,205,11001101
40,00101000,98,01100010,138,10001010
78,01001110,57,00111001,135,10000111
121,01111001,110,01101110,231,11100111
104,01101000,98,01100010,202,11001010
65,01000001,43,00101011,108,01101100
69,01000101,43,00101011,112,01110000
76,01001100,89,01011001,165,10100101
1,00000001,68,01000100,69,01000101
108,01101100,92,01011100,200,11001000
109,01101101,97,01100001,206,11001110
43,00101011,48,00110000,91,01011011
23,00010111,19,00010011,42,00101010
11,00001011,63,00111111,74,01001010
101,01100101,22,00010110,123,01111011
117,01110101,102,01100110,219,11011011
13,00001101,48,00110000,61,00111101
74,01001010,0,00000000,74,01001010
51,00110011,26,00011010,77,01001101
23,00010111,90,01011010,113,01110001
96,01100000,108,01101100,204,11001100
13,00001101,104,01101000,117,01110101
76,01001100,101,01100101,177,10110001
117,01110101,52,00110100,169,10101001
25,00011001,74,01001010,99,01100011
28,00011100,102,01100110,130,10000010
89,01011001,105,01101001,194,11000010
110,01101110,18,00010010,128,10000000
60,00111100,31,00011111,91,01011011
85,01010101,96,01100000,181,10110101
78,01001110,26,00011010,104,01101000
72,01001000,3,00000011,75,01001011
2,00000010,79,01001111,81,01010001
12,00001100,102,01100110,114,01110010
77,01001101,58,00111010,135,10000111
88,01011000,55,00110111,143,10001111
22,00010110,44,00101100,66,01000010
111,01101111,70,01000110,181,10110101
123,01111011,35,00100011,158,10011110
81,01010001,107,01101011,188,10111100
14,00001110,4,00000100,18,00010010
95,01011111,122,01111010,217,11011001
54,00110110,91,01011011,145,10010001
71,01000111,67,01000011,138,10001010
108,01101100,78,01001110,186,10111010
68,01000100,8,00001000,76,01001100
8,00001000,80,01010000,88,01011000
103,01100111,17,00010001,120,01111000
104,01101000,89,01011001,193,11000001
97,01100001,72,01001000,169,10101001
76,01001100,118,01110110,194,11000010
78,01001110,1,00000001,79,01001111
107,01101011,108,01101100,215,11010111
13,00001101,81,01010001,94,01011110
12,00001100,2,00000010,14,00001110
83,01010011,48,00110000,131,10000011
23,00010111,70,01000110,93,01011101
46,00101110,64,01000000,110,01101110
67,01000011,63,00111111,130,10000010
53,00110101,67,01000011,120,01111000
3,00000011,27,00011011,30,00011110
7,00000111,61,00111101,68,01000100
96,01100000,83,01010011,179,10110011
71,01000111,8,00001000,79,01001111
70,01000110,18,00010010,88,01011000
85,01010101,37,00100101,122,01111010
109,01101101,68,01000100,177,10110001
95,01011111,71,01000111,166,10100110
79,01001111,119,01110111,198,11000110
35,00100011,123,01111011,158,10011110
24,00011000,103,01100111,127,01111111
34,00100010,127,01111111,161,10100001
76,01001100,83,01010011,159,10011111
24,00011000,97,01100001,121,01111001
77,01001101,1,00000001,78,01001110
35,00100011,53,00110101,88,01011000
59,00111011,73,01001001,132,10000100
16,00010000,107,01101011,123,01111011
104,01101000,24,00011000,128,10000000
45,00101101,117,01110101,162,10100010
116,01110100,14,00001110,130,10000010
97,01100001,103,01100111,200,11001000
10,00001010,62,00111110,72,01001000
126,01111110,113,01110001,239,11101111
93,01011101,39,00100111,132,10000100
25,00011001,65,01000001,90,01011010
125,01111101,64,01000000,189,10111101
117,01110101,57,00111001,174,10101110
39,00100111,77,01001101,116,01110100
100,01100100,71,01000111,171,10101011
79,01001111,40,00101000,119,01110111
42,00101010,43,00101011,85,01010101
47,00101111,117,01110101,164,10100100
114,01110010,37,00100101,151,10010111
43,00101011,18,00010010,61,00111101
60,00111100,32,00100000,92,01011100
2,00000010,32,00100000,34,00100010
81,01010001,10,00001010,91,01011011
107,01101011,116,01110100,223,11011111
67,01000011,127,01111111,194,11000010
66,01000010,121,01111001,187,10111011
126,01111110,117,01110101,243,11110011
37,00100101,20,00010100,57,00111001
108,01101100,90,01011010,198,11000110
91,01011011,85,01010101,176,10110000
119,01110111,89,01011001,208,11010000
0,00000000,71,01000111,71,01000111
92,01011100,34,00100010,126,01111110
81,01010001,100,01100100,181,10110101
55,00110111,48,00110000,103,01100111
102,01100110,86,01010110,188,10111100
6,00000110,23,00010111,29,00011101
58,00111010,43,00101011,101,01100101
90,01011010,5,00000101,95,01011111
40,00101000,99,01100011,139,10001011
124,01111100,103,01100111,227,11100011
109,01101101,80,01010000,189,10111101
47,00101111,127,01111111,174,10101110
22,00010110,125,01111101,147,10010011
49,00110001,93,01011101,142,10001110
9,00001001,113,01110001,122,01111010
18,00010010,64,01000000,82,01010010
28,00011100,118,01110110,146,10010010
61,00111101,42,00101010,103,01100111
16,00010000,60,00111100,76,01001100
70,01000110,23,00010111,93,01011101
29,00011101,28,00011100,57,00111001
124,01111100,28,00011100,152,10011000
94,01011110,91,01011011,185,10111001
80,01010000,46,00101110,126,01111110
17,00010001,40,00101000,57,00111001
12,00001100,89,01011001,101,01100101
10,00001010,73,01001001,83,01010011
119,01110111,74,01001010,193,11000001
72,01001000,13,00001101,85,01010101
35,00100011,55,00110111,90,01011010
70,01000110,88,01011000,158,10011110
118,01110110,90,01011010,208,11010000
60,00111100,107,01101011,167,10100111
33,00100001,30,00011110,63,00111111
50,00110010,27,00011011,77,01001101
35,00100011,42,00101010,77,01001101
112,01110000,40,00101000,152,10011000
6,00000110,48,00110000,54,00110110
40,00101000,14,00001110,54,00110110
96,01100000,16,00010000,112,01110000
78,01001110,88,01011000,166,10100110
110,01101110,112,01110000,222,11011110
70,01000110,49,00110001,119,01110111
19,00010011,31,00011111,50,00110010
110,01101110,62,00111110,172,10101100
64,01000000,115,01110011,179,10110011
29,00011101,79,01001111,108,01101100
13,00001101,60,00111100,73,01001001
30,00011110,113,01110001,143,10001111
47,00101111,122,01111010,169,10101001
86,01010110,122,01111010,208,11010000
101,01100101,97,01100001,198,11000110
48,00110000,10,00001010,58,00111010
97,01100001,54,00110110,151,10010111
39,00100111,76,01001100,115,01110011
12,00001100,52,00110100,64,01000000
125,01111101,3,00000011,128,10000000
62,00111110,94,01011110,156,10011100
0,00000000,46,00101110,46,00101110
124,01111100,73,01001001,197,11000101
126,01111110,94,01011110,220,11011100
103,01100111,110,01101110,213,11010101
64,01000000,115,01110011,179,10110011
71,01000111,41,00101001,112,01110000
5,00000101,56,00111000,61,00111101
71,01000111,44,00101100,115,01110011
16,00010000,62,00111110,78,01001110
117,01110101,67,01000011,184,10111000
110,01101110,116,01110100,226,11100010
113,01110001,13,00001101,126,01111110
93,01011101,94,01011110,187,10111011
3,00000011,77,01001101,80,01010000
1,00000001,83,01010011,84,01010100
75,01001011,75,01001011,150,10010110
57,00111001,108,01101100,165,10100101
40,00101000,17,00010001,57,00111001
89,01011001,47,00101111,136,10001000
116,01110100,90,01011010,206,11001110
60,00111100,47,00101111,107,01101011
50,00110010,2,00000010,52,00110100
74,01001010,72,01001000,146,10010010
126,01111110,19,00010011,145,10010001
4,00000100,61,00111101,65,01000001
90,01011010,117,01110101,207,11001111
23,00010111,56,00111000,79,01001111
28,00011100,26,00011010,54,00110110
120,01111000,5,00000101,125,01111101
20,00010100,60,00111100,80,01010000
123,01111011,30,00011110,153,10011001
111,01101111,93,01011101,204,11001100
89,01011001,0,00000000,89,01011001
55,00110111,93,01011101,148,10010100
27,00011011,44,00101100,71,01000111
22,00010110,32,00100000,54,00110110
87,01010111,47,00101111,134,10000110
18,00010010,100,01100100,118,01110110
119,01110111,66,01000010,185,10111001
50,00110010,5,00000101,55,00110111
76,01001100,117,01110101,193,11000001
108,01101100,21,00010101,129,10000001
114,01110010,48,00110000,162,10100010
56,00111000,42,00101010,98,01100010
70,01000110,72,01001000,142,10001110
85,01010101,35,00100011,120,01111000
91,01011011,27,00011011,118,01110110
72,01001000,118,01110110,190,10111110
95,01011111,0,00000000,95,01011111
29,00011101,33,00100001,62,00111110
49,00110001,83,01010011,132,10000100
7,00000111,69,01000101,76,01001100
96,01100000,119,01110111,215,11010111
43,00101011,108,01101100,151,10010111
127,01111111,79,01001111,206,11001110
30,00011110,77,01001101,107,01101011
120,01111000,7,00000111,127,01111111
84,01010100,37,00100101,121,01111001
42,00101010,117,01110101,159,10011111
78,01001110,101,01100101,179,10110011
94,01011110,70,01000110,164,10100100
127,01111111,11,00001011,138,10001010
106,01101010,40,00101000,146,10010010
77,01001101,62,00111110,139,10001011
87,01010111,98,01100010,185,10111001
19,00010011,50,00110010,69,01000101
94,01011110,24,00011000,118,01110110
25,00011001,106,01101010,131,10000011
46,00101110,46,00101110,92,01011100
17,00010001,81,01010001,98,01100010
2,00000010,43,00101011,45,00101101
60,00111100,92,01011100,152,10011000
98,01100010,81,01010001,179,10110011
73,01001001,70,01000110,143,10001111
122,01111010,34,00100010,156,10011100
95,01011111,18,00010010,113,01110001
56,00111000,66,01000010,122,01111010
88,01011000,25,00011001,113,01110001
99,01100011,18,00010010,117,01110101
78,01001110,79,01001111,157,10011101
85,01010101,114,01110010,199,11000111
69,01000101,34,00100010,103,01100111
27,00011011,70,01000110,97,01100001
123,01111011,96,01100000,219,11011011
16,00010000,111,01101111,127,01111111
73,01001001,96,01100000,169,10101001
23,00010111,113,01110001,136,10001000
103,01100111,62,00111110,165,10100101
93,01011101,29,00011101,122,01111010
122,01111010,100,01100100,222,11011110
104,01101000,54,00110110,158,10011110
44,00101100,6,00000110,50,00110010
71,01000111,28,00011100,99,01100011
42,00101010,42,00101010,84,01010100
96,01100000,111,01101111,207,11001111
69,01000101,51,00110011,120,01111000
113,01110001,97,01100001,210,11010010
73,01001001,19,00010011,92,01011100
7,00000111,6,00000110,13,00001101
46,00101110,31,00011111,77,01001101
35,00100011,19,00010011,54,00110110
40,00101000,67,01000011,107,01101011
109,01101101,13,00001101,122,01111010
60,00111100,96,01100000,156,10011100
47,00101111,60,00111100,107,01101011
46,00101110,23,00010111,69,01000101
74,01001010,57,00111001,131,10000011
91,01011011,45,00101101,136,10001000
73,01001001,27,00011011,100,01100100
44,00101100,57,00111001,101,01100101
127,01111111,22,00010110,149,10010101
44,00101100,52,00110100,96,01100000
21,00010101,84,01010100,105,01101001
9,00001001,14,00001110,23,00010111
98,01100010,88,01011000,186,10111010
16,00010000,84,01010100,100,01100100
91,01011011,4,00000100,95,01011111
87,01010111,8,00001000,95,01011111
19,00010011,103,01100111,122,01111010
40,00101000,84,01010100,124,01111100
23,00010111,64,01000000,87,01010111
35,00100011,101,01100101,136,10001000
105,01101001,5,00000101,110,01101110
63,00111111,73,01001001,136,10001000
70,01000110,18,00010010,88,01011000
71,01000111,6,00000110,77,01001101
99,01100011,38,00100110,137,10001001
32,00100000,74,01001010,106,01101010
24,00011000,90,01011010,114,01110010
3,00000011,77,01001101,80,01010000
65,01000001,33,00100001,98,01100010
21,00010101,76,01001100,97,01100001
0,00000000,85,01010101,85,01010101
26,00011010,103,01100111,129,10000001
19,00010011,44,00101100,63,00111111
43,00101011,21,00010101,64,01000000
83,01010011,71,01000111,154,10011010
72,01001000,113,01110001,185,10111001
30,00011110,116,01110100,146,10010010
21,00010101,60,00111100,81,01010001
96,01100000,68,01000100,164,10100100
14,00001110,29,00011101,43,00101011
86,01010110,48,00110000,134,10000110
59,00111011,11,00001011,70,01000110
16,00010000,94,01011110,110,01101110
77,01001101,75,01001011,152,10011000
2,00000010,28,00011100,30,00011110
14,00001110,92,01011100,106,01101010
108,01101100,69,01000101,177,10110001
35,00100011,65,01000001,100,01100100
107,01101011,22,00010110,129,10000001
74,01001010,60,00111100,134,10000110
94,01011110,123,01111011,217,11011001
52,00110100,80,01010000,132,10000100
71,01000111,78,01001110,149,10010101
102,01100110,47,00101111,149,10010101
9,00001001,65,01000001,74,01001010
32,00100000,72,01001000,104,01101000
98,01100010,49,00110001,147,10010011
71,01000111,123,01111011,194,11000010
79,01001111,62,00111110,141,10001101
84,01010100,104,01101000,188,10111100
68,01000100,112,01110000,180,10110100
27,00011011,15,00001111,42,00101010
96,01100000,63,00111111,159,10011111
112,01110000,81,01010001,193,11000001
113,01110001,58,00111010,171,10101011
112,01110000,52,00110100,164,10100100
2,00000010,81,01010001,83,01010011
10,00001010,75,01001011,85,01010101
53,00110101,38,00100110,91,01011011
91,01011011,8,00001000,99,01100011
13,00001101,108,01101100,121,01111001
75,01001011,116,01110100,191,10111111
30,00011110,47,00101111,77,01001101
0,00000000,121,01111001,121,01111001
107,01101011,70,01000110,177,10110001
37,00100101,107,01101011,144,10010000
28,00011100,65,01000001,93,01011101
47,00101111,95,01011111,142,10001110
45,00101101,123,01111011,168,10101000
120,01111000,56,00111000,176,10110000
6,00000110,29,00011101,35,00100011
3,00000011,84,01010100,87,01010111
122,01111010,69,01000101,191,10111111
21,00010101,37,00100101,58,00111010
43,00101011,98,01100010,141,10001101
44,00101100,37,00100101,81,01010001
38,00100110,71,01000111,109,01101101
126,01111110,112,01110000,238,11101110
120,01111000,55,00110111,175,10101111
109,01101101,37,00100101,146,10010010
120,01111000,72,01001000,192,11000000
124,01111100,1,00000001,125,01111101
3,00000011,80,01010000,83,01010011
60,00111100,50,00110010,110,01101110
20,00010100,71,01000111,91,01011011
95,01011111,108,01101100,203,11001011
13,00001101,38,00100110,51,00110011
96,01100000,121,01111001,217,11011001
66,01000010,24,00011000,90,01011010
114,01110010,127,01111111,241,11110001
35,00100011,84,01010100,119,01110111
79,01001111,67,01000011,146,10010010
75,01001011,109,01101101,184,10111000
26,00011010,44,00101100,70,01000110
13,00001101,89,01011001,102,01100110
9,00001001,67,01000011,76,01001100
25,00011001,38,00100110,63,00111111
101,01100101,54,00110110,155,10011011
14,00001110,24,00011000,38,00100110
80,01010000,64,01000000,144,10010000
20,00010100,75,01001011,95,01011111
6,00000110,14,00001110,20,00010100
56,00111000,18,00010010,74,01001010
92,01011100,96,01100000,188,10111100
102,01100110,22,00010110,124,01111100
13,00001101,59,00111011,72,01001000
27,00011011,33,00100001,60,00111100
126,01111110,18,00010010,144,10010000
23,00010111,22,00010110,45,00101101
17,00010001,111,01101111,128,10000000
120,01111000,53,00110101,173,10101101
20,00010100,63,00111111,83,01010011
54,00110110,34,00100010,88,01011000
98,01100010,77,01001101,175,10101111
66,01000010,16,00010000,82,01010010
112,01110000,55,00110111,167,10100111
72,01001000,106,01101010,178,10110010
56,00111000,29,00011101,85,01010101
23,00010111,90,01011010,113,01110001
91,01011011,21,00010101,112,01110000
91,01011011,40,00101000,131,10000011
100,01100100,74,01001010,174,10101110
74,01001010,61,00111101,135,10000111
114,01110010,25,00011001,139,10001011
93,01011101,57,00111001,150,10010110
19,00010011,122,01111010,141,10001101
23,00010111,87,01010111,110,01101110
86,01010110,1,00000001,87,01010111
62,00111110,71,01000111,133,10000101
68,01000100,15,00001111,83,01010011
120,01111000,74,01001010,194,11000010
101,01100101,26,00011010,127,01111111
87,01010111,92,01011100,179,10110011
127,01111111,101,01100101,228,11100100
124,01111100,20,00010100,144,10010000
23,00010111,109,01101101,132,10000100
17,00010001,61,00111101,78,01001110
88,01011000,111,01101111,199,11000111
32,00100000,42,00101010,74,01001010
16,00010000,97,01100001,113,01110001
40,00101000,49,00110001,89,01011001
7,00000111,82,01010010,89,01011001
8,00001000,80,01010000,88,01011000
1,00000001,18,00010010,19,00010011
22,00010110,34,00100010,56,00111000
124,01111100,7,00000111,131,10000011
117,01110101,6,00000110,123,01111011
109,01101101,96,01100000,205,11001101
62,00111110,105,01101001,167,10100111
77,01001101,52,00110100,129,10000001
9,00001001,7,00000111,16,00010000
98,01100010,107,01101011,205,11001101
48,00110000,1,00000001,49,00110001
60,00111100,49,00110001,109,01101101
100,01100100,68,01000100,168,10101000
34,00100010,14,00001110,48,00110000
127,01111111,45,00101101,172,10101100
45,00101101,114,01110010,159,10011111
31,00011111,70,01000110,101,01100101
69,01000101,47,00101111,116,01110100
31,00011111,106,01101010,137,10001001
82,01010010,25,00011001,107,01101011
58,00111010,43,00101011,101,01100101
118,01110110,96,01100000,214,11010110
15,00001111,87,01010111,102,01100110
115,01110011,100,01100100,215,11010111
50,00110010,13,00001101,63,00111111
16,00010000,6,00000110,22,00010110
71,01000111,85,01010101,156,10011100
28,00011100,11,00001011,39,00100111
14,00001110,28,00011100,42,00101010
54,00110110,118,01110110,172,10101100
16,00010000,43,00101011,59,00111011
48,00110000,78,01001110,126,01111110
7,00000111,98,01100010,105,01101001
68,01000100,14,00001110,82,01010010
83,01010011,26,00011010,109,01101101
0,00000000,114,01110010,114,01110010
1,00000001,48,00110000,49,00110001
7,00000111,3,00000011,10,00001010
121,01111001,118,01110110,239,11101111
3,00000011,24,00011000,27,00011011
110,01101110,52,00110100,162,10100010
48,00110000,120,01111000,168,10101000
112,01110000,95,01011111,207,11001111
66,01000010,127,01111111,193,11000001
123,01111011,121,01111001,244,11110100
37,00100101,5,00000101,42,00101010
25,00011001,47,00101111,72,01001000
104,01101000,56,00111000,160,10100000
90,01011010,125,01111101,215,11010111
2,00000010,34,00100010,36,00100100
36,00100100,105,01101001,141,10001101
78,01001110,65,01000001,143,10001111
17,00010001,72,01001000,89,01011001
19,00010011,124,01111100,143,10001111
120,01111000,12,00001100,132,10000100
44,00101100,88,01011000,132,10000100
28,00011100,26,00011010,54,00110110
63,00111111,89,01011001,152,10011000
114,01110010,75,01001011,189,10111101
89,01011001,28,00011100,117,01110101
26,00011010,108,01101100,134,10000110
96,01100000,82,01010010,178,10110010
59,00111011,121,01111001,180,10110100
106,01101010,41,00101001,147,10010011
23,00010111,112,01110000,135,10000111
63,00111111,32,00100000,95,01011111
22,00010110,25,00011001,47,00101111
70,01000110,62,00111110,132,10000100
24,00011000,35,00100011,59,00111011
83,01010011,11,00001011,94,01011110
3,00000011,97,01100001,100,01100100
7,00000111,98,01100010,105,01101001
54,00110110,81,01010001,135,10000111
53,00110101,62,00111110,115,01110011
30,00011110,115,01110011,145,10010001
36,00100100,36,00100100,72,01001000
106,01101010,106,01101010,212,11010100
29,00011101,16,00010000,45,00101101
65,01000001,109,01101101,174,10101110
15,00001111,66,01000010,81,01010001
81,01010001,110,01101110,191,10111111
33,00100001,126,01111110,159,10011111
94,01011110,114,01110010,208,11010000
33,00100001,119,01110111,152,10011000
75,01001011,53,00110101,128,10000000
24,00011000,60,00111100,84,01010100
9,00001001,84,01010100,93,01011101
100,01100100,23,00010111,123,01111011
33,00100001,74,01001010,107,01101011
51,00110011,43,00101011,94,01011110
19,00010011,1,00000001,20,00010100
13,00001101,83,01010011,96,01100000
22,00010110,106,01101010,128,10000000
56,00111000,93,01011101,149,10010101
70,01000110,103,01100111,173,10101101
40,00101000,13,00001101,53,00110101
10,00001010,105,01101001,115,01110011
80,01010000,80,01010000,160,10100000
74,01001010,32,00100000,106,01101010
51,00110011,33,00100001,84,01010100
106,01101010,49,00110001,155,10011011
55,00110111,20,00010100,75,01001011
18,00010010,12,00001100,30,00011110
101,01100101,100,01100100,201,11001001
124,01111100,31,00011111,155,10011011
75,01001011,123,01111011,198,11000110
105,01101001,58,00111010,163,10100011
27,00011011,72,01001000,99,01100011
111,01101111,65,01000001,176,10110000
9,00001001,1,00000001,10,00001010
122,01111010,3,00000011,125,01111101
14,00001110,103,01100111,117,01110101
119,01110111,13,00001101,132,10000100
14,00001110,57,00111001,71,01000111
94,01011110,40,00101000,134,10000110
2,00000010,32,00100000,34,00100010
87,01010111,11,00001011,98,01100010
104,01101000,5,00000101,109,01101101
116,01110100,81,01010001,197,11000101
109,01101101,95,01011111,204,11001100
99,01100011,52,00110100,151,10010111
7,00000111,45,00101101,52,00110100
120,01111000,44,00101100,164,10100100
49,00110001,75,01001011,124,01111100
122,01111010,115,01110011,237,11101101
57,00111001,71,01000111,128,10000000
106,01101010,40,00101000,146,10010010
55,00110111,52,00110100,107,01101011
118,01110110,36,00100100,154,10011010
41,00101001,46,00101110,87,01010111
71,01000111,6,00000110,77,01001101
78,01001110,104,01101000,182,10110110
92,01011100,45,00101101,137,10001001
65,01000001,122,01111010,187,10111011
11,00001011,47,00101111,58,00111010
48,00110000,66,01000010,114,01110010
85,01010101,101,01100101,186,10111010
78,01001110,100,01100100,178,10110010
61,00111101,85,01010101,146,10010010
72,01001000,88,01011000,160,10100000
115,01110011,113,01110001,228,11100100
105,01101001,28,00011100,133,10000101
101,01100101,92,01011100,193,11000001
125,01111101,103,01100111,228,11100100
110,01101110,78,01001110,188,10111100
11,00001011,17,00010001,28,00011100
75,01001011,72,01001000,147,10010011
63,00111111,82,01010010,145,10010001
28,00011100,22,00010110,50,00110010
38,00100110,96,01100000,134,10000110
25,00011001,19,00010011,44,00101100
109,01101101,122,01111010,231,11100111
120,01111000,93,01011101,213,11010101
86,01010110,6,00000110,92,01011100
63,00111111,52,00110100,115,01110011
96,01100000,105,01101001,201,11001001
66,01000010,89,01011001,155,10011011
103,01100111,53,00110101,156,10011100
10,00001010,45,00101101,55,00110111
114,01110010,101,01100101,215,11010111
67,01000011,87,01010111,154,10011010
26,00011010,57,00111001,83,01010011
86,01010110,116,01110100,202,11001010
83,01010011,117,01110101,200,11001000
49,00110001,16,00010000,65,01000001
39,00100111,88,01011000,127,01111111
87,01010111,7,00000111,94,01011110
103,01100111,55,00110111,158,10011110
93,01011101,96,01100000,189,10111101
120,01111000,37,00100101,157,10011101
80,01010000,42,00101010,122,01111010
44,00101100,81,01010001,125,01111101
36,00100100,37,00100101,73,01001001
77,01001101,81,01010001,158,10011110
6,00000110,72,01001000,78,01001110
28,00011100,79,01001111,107,01101011
9,00001001,51,00110011,60,00111100
83,01010011,67,01000011,150,10010110
123,01111011,7,00000111,130,10000010
41,00101001,71,01000111,112,01110000
82,01010010,63,00111111,145,10010001
42,00101010,21,00010101,63,00111111
3,00000011,11,00001011,14,00001110
110,01101110,75,01001011,185,10111001
107,01101011,53,00110101,160,10100000
4,00000100,88,01011000,92,01011100
57,00111001,99,01100011,156,10011100
113,01110001,50,00110010,163,10100011
100,01100100,103,01100111,203,11001011
88,01011000,50,00110010,138,10001010
2,00000010,102,01100110,104,01101000
107,01101011,42,00101010,149,10010101
8,00001000,91,01011011,99,01100011
9,00001001,56,00111000,65,01000001
96,01100000,123,01111011,219,11011011
61,00111101,26,00011010,87,01010111
102,01100110,18,00010010,120,01111000
69,01000101,70,01000110,139,10001011
108,01101100,103,01100111,211,11010011
78,01001110,125,01111101,203,11001011
9,00001001,71,01000111,80,01010000
27,00011011,60,00111100,87,01010111
58,00111010,60,00111100,118,01110110
83,01010011,74,01001010,157,10011101
8,00001000,41,00101001,49,00110001
4,00000100,127,01111111,131,10000011
30,00011110,112,01110000,142,10001110
102,01100110,76,01001100,178,10110010
39,00100111,43,00101011,82,01010010
127,01111111,38,00100110,165,10100101
22,00010110,33,00100001,55,00110111
112,01110000,123,01111011,235,11101011
97,01100001,50,00110010,147,10010011
54,00110110,25,00011001,79,01001111
55,00110111,7,00000111,62,00111110
114,01110010,117,01110101,231,11100111
5,00000101,59,00111011,64,01000000
122,01111010,16,00010000,138,10001010
117,01110101,73,01001001,190,10111110
1,00000001,4,00000100,5,00000101
10,00001010,29,00011101,39,00100111
59,00111011,1,00000001,60,00111100
124,01111100,125,01111101,249,11111001
55,00110111,101,01100101,156,10011100
16,00010000,44,00101100,60,00111100
53,00110101,80,01010000,133,10000101
2,00000010,60,00111100,62,00111110
74,01001010,127,01111111,201,11001001
66,01000010,50,00110010,116,01110100
92,01011100,59,00111011,151,10010111
34,00100010,0,00000000,34,00100010
55,00110111,99,01100011,154,10011010
102,01100110,124,01111100,226,11100010
38,00100110,9,00001001,47,00101111
122,01111010,33,00100001,155,10011011
35,00100011,52,00110100,87,01010111
87,01010111,49,00110001,136,10001000
63,00111111,85,01010101,148,10010100
115,01110011,33,00100001,148,10010100
72,01001000,92,01011100,164,10100100
30,00011110,50,00110010,80,01010000
120,01111000,13,00001101,133,10000101
88,01011000,2,00000010,90,01011010
57,00111001,78,01001110,135,10000111
15,00001111,76,01001100,91,01011011
112,01110000,0,00000000,112,01110000
102,01100110,35,00100011,137,10001001
113,01110001,72,01001000,185,10111001
100,01100100,24,00011000,124,01111100
117,01110101,92,01011100,209,11010001
110,01101110,92,01011100,202,11001010
0,00000000,52,00110100,52,00110100
18,00010010,12,00001100,30,00011110
30,00011110,77,01001101,107,01101011
8,00001000,49,00110001,57,00111001
88,01011000,9,00001001,97,01100001
107,01101011,126,01111110,233,11101001
33,00100001,61,00111101,94,01011110
111,01101111,119,01110111,230,11100110
42,00101010,79,01001111,121,01111001
3,00000011,44,00101100,47,00101111
87,01010111,62,00111110,149,10010101
16,00010000,101,01100101,117,01110101
119,01110111,34,00100010,153,10011001
40,00101000,80,01010000,120,01111000
111,01101111,61,00111101,172,10101100
45,00101101,30,00011110,75,01001011
80,01010000,24,00011000,104,01101000
101,01100101,125,01111101,226,11100010
115,01110011,48,00110000,163,10100011
12,00001100,98,01100010,110,01101110
3,00000011,99,01100011,102,01100110
52,00110100,61,00111101,113,01110001
59,00111011,34,00100010,93,01011101
63,00111111,5,00000101,68,01000100
89,01011001,97,01100001,186,10111010
122,01111010,55,00110111,177,10110001
17,00010001,103,01100111,120,01111000
74,01001010,14,00001110,88,01011000
47,00101111,38,00100110,85,01010101
57,00111001,8,00001000,65,01000001
43,00101011,13,00001101,56,00111000
22,00010110,49,00110001,71,01000111
66,01000010,93,01011101,159,10011111
71,01000111,10,00001010,81,01010001
23,00010111,96,01100000,119,01110111
92,01011100,82,01010010,174,10101110
112,01110000,104,01101000,216,11011000
37,00100101,4,00000100,41,00101001
117,01110101,109,01101101,226,11100010
35,00100011,63,00111111,98,01100010
60,00111100,77,01001101,137,10001001
47,00101111,97,01100001,144,10010000
63,00111111,59,00111011,122,01111010
49,00110001,71,01000111,120,01111000
79,01001111,59,00111011,138,10001010
23,00010111,24,00011000,47,00101111
94,01011110,120,01111000,214,11010110
13,00001101,53,00110101,66,01000010
36,00100100,59,00111011,95,01011111
15,00001111,0,00000000,15,00001111
102,01100110,91,01011011,193,11000001
65,01000001,65,01000001,130,10000010
69,01000101,102,01100110,171,10101011
13,00001101,86,01010110,99,01100011
117,01110101,46,00101110,163,10100011
81,01010001,107,01101011,188,10111100
28,00011100,111,01101111,139,10001011
107,01101011,55,00110111,162,10100010
83,01010011,72,01001000,155,10011011
98,01100010,48,00110000,146,10010010
45,00101101,105,01101001,150,10010110
91,01011011,75,01001011,166,10100110
106,01101010,82,01010010,188,10111100
118,01110110,4,00000100,122,01111010
13,00001101,27,00011011,40,00101000
42,00101010,113,01110001,155,10011011
93,01011101,52,00110100,145,10010001
115,01110011,108,01101100,223,11011111
13,00001101,72,01001000,85,01010101
110,01101110,23,00010111,133,10000101
63,00111111,31,00011111,94,01011110
49,00110001,51,00110011,100,01100100
103,01100111,72,01001000,175,10101111
78,01001110,61,00111101,139,10001011
64,01000000,58,00111010,122,01111010
14,00001110,75,01001011,89,01011001
67,01000011,111,01101111,178,10110010
46,00101110,10,00001010,56,00111000
93,01011101,40,00101000,133,10000101
112,01110000,6,00000110,118,01110110
91,01011011,113,01110001,204,11001100
20,00010100,31,00011111,51,00110011
18,00010010,13,00001101,31,00011111
6,00000110,7,00000111,13,00001101
85,01010101,22,00010110,107,01101011
26,00011010,38,00100110,64,01000000
86,01010110,34,00100010,120,01111000
63,00111111,69,01000101,132,10000100
13,00001101,79,01001111,92,01011100
8,00001000,35,00100011,43,00101011
59,00111011,84,01010100,143,10001111
114,01110010,113,01110001,227,11100011
98,01100010,120,01111000,218,11011010
14,00001110,22,00010110,36,00100100
3,00000011,76,01001100,79,01001111
49,00110001,42,00101010,91,01011011
37,00100101,39,00100111,76,01001100
38,00100110,74,01001010,112,01110000
84,01010100,121,01111001,205,11001101
1,00000001,21,00010101,22,00010110
53,00110101,118,01110110,171,10101011
11,00001011,56,00111000,67,01000011
119,01110111,102,01100110,221,11011101
54,00110110,20,00010100,74,01001010
94,01011110,61,00111101,155,10011011
54,00110110,90,01011010,144,10010000
97,01100001,78,01001110,175,10101111
93,01011101,51,00110011,144,10010000
22,00010110,26,00011010,48,00110000
107,01101011,5,00000101,112,01110000
98,01100010,47,00101111,145,10010001
93,01011101,48,00110000,141,10001101
112,01110000,9,00001001,121,01111001
84,01010100,111,01101111,195,11000011
51,00110011,4,00000100,55,00110111
75,01001011,0,00000000,75,01001011
93,01011101,12,00001100,105,01101001
114,01110010,116,01110100,230,11100110
20,00010100,123,01111011,143,10001111
6,00000110,101,01100101,107,01101011
30,00011110,106,01101010,136,10001000
13,00001101,13,00001101,26,00011010
108,01101100,93,01011101,201,11001001
4,00000100,18,00010010,22,00010110
84,01010100,72,01001000,156,10011100
30,00011110,122,01111010,152,10011000
62,00111110,6,00000110,68,01000100
29,00011101,126,01111110,155,10011011
59,00111011,104,01101000,163,10100011
87,01010111,36,00100100,123,01111011
28,00011100,25,00011001,53,00110101
9,00001001,34,00100010,43,00101011
69,01000101,26,00011010,95,01011111
12,00001100,49,00110001,61,00111101
85,01010101,50,00110010,135,10000111
99,01100011,54,00110110,153,10011001
21,00010101,46,00101110,67,01000011
10,00001010,79,01001111,89,01011001
15,00001111,24,00011000,39,00100111
109,01101101,45,00101101,154,10011010
39,00100111,58,00111010,97,01100001
30,00011110,33,00100001,63,00111111
10,00001010,79,01001111,89,01011001
3,00000011,47,00101111,50,00110010
94,01011110,122,01111010,216,11011000
59,00111011,70,01000110,129,10000001
91,01011011,93,01011101,184,10111000
33,00100001,93,01011101,126,01111110
40,00101000,84,01010100,124,01111100
107,01101011,68,01000100,175,10101111
85,01010101,11,00001011,96,01100000
125,01111101,36,00100100,161,10100001
91,01011011,73,01001001,164,10100100
113,01110001,78,01001110,191,10111111
43,00101011,66,01000010,109,01101101
54,00110110,84,01010100,138,10001010
12,00001100,15,00001111,27,00011011
93,01011101,81,01010001,174,10101110
124,01111100,115,01110011,239,11101111
123,01111011,62,00111110,185,10111001
40,00101000,0,00000000,40,00101000
65,01000001,1,00000001,66,01000010
95,01011111,100,01100100,195,11000011
32,00100000,100,01100100,132,10000100
60,00111100,43,00101011,103,01100111
73,01001001,77,01001101,150,10010110
66,01000010,72,01001000,138,10001010
0,00000000,25,00011001,25,00011001
75,01001011,96,01100000,171,10101011
100,01100100,30,00011110,130,10000010
69,01000101,112,01110000,181,10110101
101,01100101,82,01010010,183,10110111
44,00101100,32,00100000,76,01001100
74,01001010,13,00001101,87,01010111
106,01101010,2,00000010,108,01101100
71,01000111,59,00111011,130,10000010
98,01100010,7,00000111,105,01101001
103,01100111,106,01101010,209,11010001
65,01000001,66,01000010,131,10000011
61,00111101,113,01110001,174,10101110
78,01001110,50,00110010,128,10000000
46,00101110,32,00100000,78,01001110
89,01011001,119,01110111,208,11010000
50,00110010,52,00110100,102,01100110
90,01011010,102,01100110,192,11000000
87,01010111,116,01110100,203,11001011
43,00101011,102,01100110,145,10010001
17,00010001,107,01101011,124,01111100
49,00110001,106,01101010,155,10011011
24,00011000,84,01010100,108,01101100
53,00110101,27,00011011,80,01010000
67,01000011,117,01110101,184,10111000
93,01011101,105,01101001,198,11000110
27,00011011,82,01010010,109,01101101
27,00011011,22,00010110,49,00110001
14,00001110,105,01101001,119,01110111
122,01111010,54,00110110,176,10110000
69,01000101,104,01101000,173,10101101
66,01000010,96,01100000,162,10100010
7,00000111,4,00000100,11,00001011
8,00001000,10,00001010,18,00010010
8,00001000,32,00100000,40,00101000
119,01110111,34,00100010,153,10011001
62,00111110,63,00111111,125,01111101
65,01000001,34,00100010,99,01100011
23,00010111,2,00000010,25,00011001
13,00001101,45,00101101,58,00111010
8,00001000,41,00101001,49,00110001
71,01000111,112,01110000,183,10110111
125,01111101,88,01011000,213,11010101
55,00110111,36,00100100,91,01011011
8,00001000,67,01000011,75,01001011
74,01001010,38,00100110,112,01110000
113,01110001,67,01000011,180,10110100
91,01011011,114,01110010,205,11001101
35,00100011,61,00111101,96,01100000
117,01110101,50,00110010,167,10100111
51,00110011,127,01111111,178,10110010
23,00010111,27,00011011,50,00110010
14,00001110,70,01000110,84,01010100
28,00011100,54,00110110,82,01010010
108,01101100,48,00110000,156,10011100
58,00111010,38,00100110,96,01100000
66,01000010,18,00010010,84,01010100
107,01101011,87,01010111,194,11000010
48,00110000,106,01101010,154,10011010
61,00111101,108,01101100,169,10101001
103,01100111,46,00101110,149,10010101
88,01011000,65,01000001,153,10011001
40,00101000,63,00111111,103,01100111
55,00110111,100,01100100,155,10011011
87,01010111,81,01010001,168,10101000
96,01100000,20,00010100,116,01110100
83,01010011,48,00110000,131,10000011
79,01001111,60,00111100,139,10001011
125,01111101,114,01110010,239,11101111
61,00111101,91,01011011,152,10011000
98,01100010,102,01100110,200,11001000
107,01101011,124,01111100,231,11100111
40,00101000,85,01010101,125,01111101
39,00100111,56,00111000,95,01011111
92,01011100,4,00000100,96,01100000
40,00101000,16,00010000,56,00111000
57,00111001,116,01110100,173,10101101
82,01010010,18,00010010,100,01100100
56,00111000,98,01100010,154,10011010
26,00011010,41,00101001,67,01000011
31,00011111,64,01000000,95,01011111
121,01111001,109,01101101,230,11100110
47,00101111,13,00001101,60,00111100
84,01010100,16,00010000,100,01100100
72,01001000,74,01001010,146,10010010
48,00110000,65,01000001,113,01110001
3,00000011,120,01111000,123,01111011
122,01111010,68,01000100,190,10111110
13,00001101,35,00100011,48,00110000
67,01000011,30,00011110,97,01100001
5,00000101,23,00010111,28,00011100
87,01010111,107,01101011,194,11000010
49,00110001,54,00110110,103,01100111
25,00011001,28,00011100,53,00110101
3,00000011,15,00001111,18,00010010
68,01000100,74,01001010,142,10001110
34,00100010,27,00011011,61,00111101
9,00001001,96,01100000,105,01101001
32,00100000,14,00001110,46,00101110
98,01100010,7,00000111,105,01101001
103,01100111,35,00100011,138,10001010
80,01010000,97,01100001,177,10110001
68,01000100,55,00110111,123,01111011
54,00110110,33,00100001,87,01010111
34,00100010,126,01111110,160,10100000
68,01000100,12,00001100,80,01010000
87,01010111,62,00111110,149,10010101
67,01000011,53,00110101,120,01111000
102,01100110,121,01111001,223,11011111
104,01101000,30,00011110,134,10000110
92,01011100,61,00111101,153,10011001
47,00101111,20,00010100,67,01000011
23,00010111,5,00000101,28,00011100
85,01010101,91,01011011,176,10110000
121,01111001,79,01001111,200,11001000
11,00001011,111,01101111,122,01111010
88,01011000,71,01000111,159,10011111
99,01100011,65,01000001,164,10100100
26,00011010,37,00100101,63,00111111
76,01001100,89,01011001,165,10100101
57,00111001,58,00111010,115,01110011
14,00001110,113,01110001,127,01111111
115,01110011,52,00110100,167,10100111
70,01000110,65,01000001,135,10000111
75,01001011,82,01010010,157,10011101
8,00001000,80,01010000,88,01011000
121,01111001,72,01001000,193,11000001
102,01100110,120,01111000,222,11011110
107,01101011,52,00110100,159,10011111
44,00101100,120,01111000,164,10100100
95,01011111,123,01111011,218,11011010
13,00001101,105,01101001,118,01110110
81,01010001,123,01111011,204,11001100
38,00100110,79,01001111,117,01110101
76,01001100,118,01110110,194,11000010
36,00100100,2,00000010,38,00100110
123,01111011,40,00101000,163,10100011
46,00101110,60,00111100,106,01101010
14,00001110,121,01111001,135,10000111
50,00110010,75,01001011,125,01111101
42,00101010,6,00000110,48,00110000
33,00100001,30,00011110,63,00111111
53,00110101,19,00010011,72,01001000
50,00110010,7,00000111,57,00111001
17,00010001,33,00100001,50,00110010
83,01010011,72,01001000,155,10011011
4,00000100,113,01110001,117,01110101
18,00010010,101,01100101,119,01110111
37,00100101,76,01001100,113,01110001
125,01111101,126,01111110,251,11111011
45,00101101,83,01010011,128,10000000
76,01001100,124,01111100,200,11001000
15,00001111,10,00001010,25,00011001
31,00011111,79,01001111,110,01101110
100,01100100,38,00100110,138,10001010
19,00010011,54,00110110,73,01001001
39,00100111,74,01001010,113,01110001
51,00110011,95,01011111,146,10010010
88,01011000,122,01111010,210,11010010
80,01010000,11,00001011,91,01011011
46,00101110,122,01111010,168,10101000
7,00000111,125,01111101,132,10000100
65,01000001,29,00011101,94,01011110
121,01111001,74,01001010,195,11000011
113,01110001,114,01110010,227,11100011
17,00010001,63,00111111,80,01010000
7,00000111,110,01101110,117,01110101
45,00101101,119,01110111,164,10100100
39,00100111,3,00000011,42,00101010
59,00111011,95,01011111,154,10011010
67,01000011,57,00111001,124,01111100
111,01101111,84,01010100,195,11000011
16,00010000,61,00111101,77,01001101
22,00010110,59,00111011,81,01010001
6,00000110,94,01011110,100,01100100
99,01100011,39,00100111,138,10001010
97,01100001,93,01011101,190,10111110
76,01001100,76,01001100,152,10011000
46,00101110,84,01010100,130,10000010
110,01101110,10,00001010,120,01111000
6,00000110,70,01000110,76,01001100
5,00000101,89,01011001,94,01011110
22,00010110,23,00010111,45,00101101
68,01000100,47,00101111,115,01110011
9,00001001,123,01111011,132,10000100
124,01111100,12,00001100,136,10001000
41,00101001,102,01100110,143,10001111
48,00110000,70,01000110,118,01110110
83,01010011,65,01000001,148,10010100
37,00100101,115,01110011,152,10011000
38,00100110,98,01100010,136,10001000
12,00001100,37,00100101,49,00110001
103,01100111,77,01001101,180,10110100
47,00101111,36,00100100,83,01010011
91,01011011,12,00001100,103,01100111
66,01000010,49,00110001,115,01110011
13,00001101,45,00101101,58,00111010
110,01101110,89,01011001,199,11000111
1,00000001,99,01100011,100,01100100
1,00000001,125,01111101,126,01111110
70,01000110,37,00100101,107,01101011
52,00110100,111,01101111,163,10100011
75,01001011,71,01000111,146,10010010
30,00011110,49,00110001,79,01001111
112,01110000,79,01001111,191,10111111
87,01010111,69,01000101,156,10011100
111,01101111,1,00000001,112,01110000
50,00110010,55,00110111,105,01101001
92,01011100,126,01111110,218,11011010
127,01111111,122,01111010,249,11111001
12,00001100,37,00100101,49,00110001
97,01100001,18,00010010,115,01110011
69,01000101,27,00011011,96,01100000
85,01010101,47,00101111,132,10000100
8,00001000,116,01110100,124,01111100
87,01010111,39,00100111,126,01111110
82,01010010,19,00010011,101,01100101
48,00110000,59,00111011,107,01101011
114,01110010,1,00000001,115,01110011
54,00110110,114,01110010,168,10101000
59,00111011,31,00011111,90,01011010
20,00010100,8,00001000,28,00011100
26,00011010,68,01000100,94,01011110
77,01001101,61,00111101,138,10001010
102,01100110,61,00111101,163,10100011
66,01000010,9,00001001,75,01001011
105,01101001,53,00110101,158,10011110
42,00101010,68,01000100,110,01101110
50,00110010,98,01100010,148,10010100
10,00001010,85,01010101,95,01011111
67,01000011,44,00101100,111,01101111
111,01101111,47,00101111,158,10011110
39,00100111,9,00001001,48,00110000
35,00100011,70,01000110,105,01101001
50,00110010,68,01000100,118,01110110
69,01000101,28,00011100,97,01100001
24,00011000,1,00000001,25,00011001
110,01101110,60,00111100,170,10101010
100,01100100,38,00100110,138,10001010
68,01000100,104,01101000,172,10101100
121,01111001,115,01110011,236,11101100
101,01100101,119,01110111,220,11011100
64,01000000,47,00101111,111,01101111
114,01110010,23,00010111,137,10001001
51,00110011,90,01011010,141,10001101
14,00001110,80,01010000,94,01011110
55,00110111,89,01011001,144,10010000
75,01001011,127,01111111,202,11001010
23,00010111,72,01001000,95,01011111
41,00101001,25,00011001,66,01000010
80,01010000,72,01001000,152,10011000
80,01010000,89,01011001,169,10101001
81,01010001,41,00101001,122,01111010
109,01101101,92,01011100,201,11001001
36,00100100,111,01101111,147,10010011
14,00001110,39,00100111,53,00110101
96,01100000,88,01011000,184,10111000
34,00100010,60,00111100,94,01011110
33,00100001,16,00010000,49,00110001
84,01010100,7,00000111,91,01011011
63,00111111,49,00110001,112,01110000
21,00010101,104,01101000,125,01111101
23,00010111,102,01100110,125,01111101
61,00111101,18,00010010,79,01001111
117,01110101,101,01100101,218,11011010
77,01001101,121,01111001,198,11000110
81,01010001,80,01010000,161,10100001
43,00101011,18,00010010,61,00111101
37,00100101,43,00101011,80,01010000
88,01011000,46,00101110,134,10000110
57,00111001,25,00011001,82,01010010
116,01110100,71,01000111,187,10111011
42,00101010,86,01010110,128,10000000
90,01011010,53,00110101,143,10001111
23,00010111,52,00110100,75,01001011
13,00001101,39,00100111,52,00110100
48,00110000,45,00101101,93,01011101
71,01000111,53,00110101,124,01111100
99,01100011,31,00011111,130,10000010
49,00110001,80,01010000,129,10000001
81,01010001,110,01101110,191,10111111
69,01000101,33,00100001,102,01100110
120,01111000,4,00000100,124,01111100
35,00100011,95,01011111,130,10000010
95,01011111,26,00011010,121,01111001
30,00011110,24,00011000,54,00110110
4,00000100,114,01110010,118,01110110
85,01010101,96,01100000,181,10110101
3,00000011,87,01010111,90,01011010
100,01100100,83,01010011,183,10110111
70,01000110,41,00101001,111,01101111
107,01101011,103,01100111,210,11010010
123,01111011,122,01111010,245,11110101
12,00001100,31,00011111,43,00101011
90,01011010,104,01101000,194,11000010
9,00001001,82,01010010,91,01011011
86,01010110,99,01100011,185,10111001
104,01101000,116,01110100,220,11011100
17,00010001,62,00111110,79,01001111
117,01110101,33,00100001,150,10010110
29,00011101,89,01011001,118,01110110
28,00011100,124,01111100,152,10011000
1,00000001,114,01110010,115,01110011
109,01101101,31,00011111,140,10001100
69,01000101,94,01011110,163,10100011
77,01001101,70,01000110,147,10010011
87,01010111,112,01110000,199,11000111
108,01101100,114,01110010,222,11011110
66,01000010,4,00000100,70,01000110
62,00111110,12,00001100,74,01001010
50,00110010,26,00011010,76,01001100
87,01010111,60,00111100,147,10010011
3,00000011,114,01110010,117,01110101
62,00111110,83,01010011,145,10010001
71,01000111,127,01111111,198,11000110
103,01100111,56,00111000,159,10011111
39,00100111,18,00010010,57,00111001
121,01111001,59,00111011,180,10110100
64,01000000,52,00110100,116,01110100
84,01010100,90,01011010,174,10101110
12,00001100,41,00101001,53,00110101
94,01011110,3,00000011,97,01100001
120,01111000,2,00000010,122,01111010
22,00010110,77,01001101,99,01100011
32,00100000,34,00100010,66,01000010
27,00011011,40,00101000,67,01000011
80,01010000,73,01001001,153,10011001
74,01001010,119,01110111,193,11000001
1,00000001,94,01011110,95,01011111
11,00001011,46,00101110,57,00111001
67,01000011,72,01001000,139,10001011
98,01100010,123,01111011,221,11011101
39,00100111,12,00001100,51,00110011
57,00111001,87,01010111,144,10010000
62,00111110,122,01111010,184,10111000
12,00001100,109,01101101,121,01111001
126,01111110,124,01111100,250,11111010
41,00101001,24,00011000,65,01000001
47,00101111,75,01001011,122,01111010
111,01101111,5,00000101,116,01110100
11,00001011,73,01001001,84,01010100
19,00010011,95,01011111,114,01110010
44,00101100,110,01101110,154,10011010
100,01100100,110,01101110,210,11010010
7,00000111,101,01100101,108,01101100
91,01011011,91,01011011,182,10110110
44,00101100,13,00001101,57,00111001
127,01111111,84,01010100,211,11010011
107,01101011,23,00010111,130,10000010
47,00101111,100,01100100,147,10010011
104,01101000,99,01100011,203,11001011
53,00110101,43,00101011,96,01100000
69,01000101,78,01001110,147,10010011
33,00100001,92,01011100,125,01111101
111,01101111,67,01000011,178,10110010
123,01111011,43,00101011,166,10100110
19,00010011,103,01100111,122,01111010
6,00000110,3,00000011,9,00001001
34,00100010,112,01110000,146,10010010
7,00000111,48,00110000,55,00110111
4,00000100,69,01000101,73,01001001
60,00111100,28,00011100,88,01011000
50,00110010,11,00001011,61,00111101
46,00101110,108,01101100,154,10011010
120,01111000,22,00010110,142,10001110
88,01011000,115,01110011,203,11001011
36,00100100,81,01010001,117,01110101
117,01110101,71,01000111,188,10111100
109,01101101,102,01100110,211,11010011
43,00101011,90,01011010,133,10000101
55,00110111,51,00110011,106,01101010
69,01000101,111,01101111,180,10110100
40,00101000,28,00011100,68,01000100
30,00011110,83,01010011,113,01110001
126,01111110,58,00111010,184,10111000
18,00010010,99,01100011,117,01110101
42,00101010,25,00011001,67,01000011
125,01111101,91,01011011,216,11011000
113,01110001,123,01111011,236,11101100
52,00110100,58,00111010,110,01101110
108,01101100,30,00011110,138,10001010
9,00001001,49,00110001,58,00111010
18,00010010,122,01111010,140,10001100
68,01000100,75,01001011,143,10001111
106,01101010,20,00010100,126,01111110
98,01100010,50,00110010,148,10010100
99,01100011,5,00000101,104,01101000
72,01001000,77,01001101,149,10010101
94,01011110,114,01110010,208,11010000
44,00101100,87,01010111,131,10000011
95,01011111,30,00011110,125,01111101
72,01001000,77,01001101,149,10010101
1,00000001,11,00001011,12,00001100
125,01111101,97,01100001,222,11011110
18,00010010,79,01001111,97,01100001
101,01100101,24,00011000,125,01111101
12,00001100,105,01101001,117,01110101
30,00011110,12,00001100,42,00101010
69,01000101,114,01110010,183,10110111
31,00011111,87,01010111,118,01110110
67,01000011,42,00101010,109,01101101
76,01001100,103,01100111,179,10110011
34,00100010,109,01101101,143,10001111
122,01111010,47,00101111,169,10101001
25,00011001,107,01101011,132,10000100
76,01001100,114,01110010,190,10111110
2,00000010,79,01001111,81,01010001
15,00001111,120,01111000,135,10000111
55,00110111,74,01001010,129,10000001
99,01100011,91,01011011,190,10111110
33,00100001,45,00101101,78,01001110
84,01010100,49,00110001,133,10000101
99,01100011,86,01010110,185,10111001
28,00011100,5,00000101,33,00100001
120,01111000,57,00111001,177,10110001
67,01000011,108,01101100,175,10101111
127,01111111,108,01101100,235,11101011
62,00111110,16,00010000,78,01001110
69,01000101,13,00001101,82,01010010
39,00100111,127,01111111,166,10100110
108,01101100,123,01111011,231,11100111
79,01001111,70,01000110,149,10010101
105,01101001,90,01011010,195,11000011
23,00010111,0,00000000,23,00010111
3,00000011,99,01100011,102,01100110
71,01000111,21,00010101,92,01011100
18,00010010,117,01110101,135,10000111
87,01010111,109,01101101,196,11000100
112,01110000,21,00010101,133,10000101
4,00000100,50,00110010,54,00110110
49,00110001,76,01001100,125,01111101
18,00010010,43,00101011,61,00111101
16,00010000,1,00000001,17,00010001
100,01100100,127,01111111,227,11100011
84,01010100,82,01010010,166,10100110
73,01001001,103,01100111,176,10110000
96,01100000,15,00001111,111,01101111
11,00001011,87,01010111,98,01100010
66,01000010,53,00110101,119,01110111
87,01010111,15,00001111,102,01100110
80,01010000,69,01000101,149,10010101
107,01101011,84,01010100,191,10111111
97,01100001,72,01001000,169,10101001
80,01010000,114,01110010,194,11000010
37,00100101,13,00001101,50,00110010
30,00011110,125,01111101,155,10011011
80,01010000,105,01101001,185,10111001
25,00011001,89,01011001,114,01110010
45,00101101,101,01100101,146,10010010
33,00100001,56,00111000,89,01011001
81,01010001,27,00011011,108,01101100
119,01110111,92,01011100,211,11010011
62,00111110,59,00111011,121,01111001
68,01000100,95,01011111,163,10100011
23,00010111,13,00001101,36,00100100
8,00001000,66,01000010,74,01001010
45,00101101,17,00010001,62,00111110
127,01111111,53,00110101,180,10110100
101,01100101,127,01111111,228,11100100
110,01101110,56,00111000,166,10100110
54,00110110,20,00010100,74,01001010
58,00111010,85,01010101,143,10001111
114,01110010,121,01111001,235,11101011
51,00110011,83,01010011,134,10000110
47,00101111,31,00011111,78,01001110
83,01010011,69,01000101,152,10011000
90,01011010,49,00110001,139,10001011
26,00011010,32,00100000,58,00111010
83,01010011,83,01010011,166,10100110
71,01000111,80,01010000,151,10010111
18,00010010,126,01111110,144,10010000
23,00010111,61,00111101,84,01010100
80,01010000,30,00011110,110,01101110
0,00000000,98,01100010,98,01100010
97,01100001,110,01101110,207,11001111
68,01000100,37,00100101,105,01101001
115,01110011,105,01101001,220,11011100
67,01000011,5,00000101,72,01001000
126,01111110,78,01001110,204,11001100
84,01010100,0,00000000,84,01010100
20,00010100,22,00010110,42,00101010
58,00111010,120,01111000,178,10110010
48,00110000,58,00111010,106,01101010
104,01101000,94,01011110,198,11000110
14,00001110,53,00110101,67,01000011
118,01110110,104,01101000,222,11011110
73,01001001,67,01000011,140,10001100
30,00011110,31,00011111,61,00111101
60,00111100,96,01100000,156,10011100
97,01100001,23,00010111,120,01111000
113,01110001,64,01000000,177,10110001
20,00010100,123,01111011,143,10001111
24,00011000,30,00011110,54,00110110
83,01010011,50,00110010,133,10000101
51,00110011,55,00110111,106,01101010
85,01010101,87,01010111,172,10101100
79,01001111,15,00001111,94,01011110
87,01010111,44,00101100,131,10000011
67,01000011,16,00010000,83,01010011
108,01101100,87,01010111,195,11000011
77,01001101,124,01111100,201,11001001
113,01110001,89,01011001,202,11001010
92,01011100,31,00011111,123,01111011
1,00000001,74,01001010,75,01001011
6,00000110,59,00111011,65,01000001
63,00111111,42,00101010,105,01101001
27,00011011,19,00010011,46,00101110
91,01011011,44,00101100,135,10000111
118,01110110,29,00011101,147,10010011
10,00001010,71,01000111,81,01010001
12,00001100,75,01001011,87,01010111
117,01110101,30,00011110,147,10010011
47,00101111,44,00101100,91,01011011
113,01110001,48,00110000,161,10100001
11,00001011,61,00111101,72,01001000
53,00110101,81,01010001,134,10000110
93,01011101,84,01010100,177,10110001
88,01011000,46,00101110,134,10000110
79,01001111,1,00000001,80,01010000
108,01101100,47,00101111,155,10011011
65,01000001,85,01010101,150,10010110
103,01100111,52,00110100,155,10011011
112,01110000,90,01011010,202,11001010
25,00011001,55,00110111,80,01010000
53,00110101,54,00110110,107,01101011
73,01001001,107,01101011,180,10110100
42,00101010,120,01111000,162,10100010
32,00100000,75,01001011,107,01101011
0,00000000,111,01101111,111,01101111
17,00010001,28,00011100,45,00101101
99,01100011,3,00000011,102,01100110
110,01101110,42,00101010,152,10011000
114,01110010,102,01100110,216,11011000
17,00010001,84,01010100,101,01100101
93,01011101,89,01011001,182,10110110
25,00011001,120,01111000,145,10010001
119,01110111,68,01000100,187,10111011
114,01110010,60,00111100,174,10101110
96,01100000,19,00010011,115,01110011
88,01011000,7,00000111,95,01011111
39,00100111,25,00011001,64,01000000
70,01000110,19,00010011,89,01011001
61,00111101,10,00001010,71,01000111
124,01111100,52,00110100,176,10110000
117,01110101,48,00110000,165,10100101
80,01010000,13,00001101,93,01011101
37,00100101,11,00001011,48,00110000
1,00000001,29,00011101,30,00011110
9,00001001,117,01110101,126,01111110
92,01011100,112,01110000,204,11001100
102,01100110,109,01101101,211,11010011
83,01010011,31,00011111,114,01110010
26,00011010,124,01111100,150,10010110
68,01000100,71,01000111,139,10001011
9,00001001,14,00001110,23,00010111
17,00010001,71,01000111,88,01011000
127,01111111,77,01001101,204,11001100
48,00110000,26,00011010,74,01001010
12,00001100,63,00111111,75,01001011
43,00101011,127,01111111,170,10101010
96,01100000,12,00001100,108,01101100
27,00011011,88,01011000,115,01110011
118,01110110,40,00101000,158,10011110
11,00001011,111,01101111,122,01111010
92,01011100,54,00110110,146,10010010
83,01010011,45,00101101,128,10000000
52,00110100,2,00000010,54,00110110
19,00010011,6,00000110,25,00011001
53,00110101,106,01101010,159,10011111
52,00110100,79,01001111,131,10000011
126,01111110,118,01110110,244,11110100
33,00100001,82,01010010,115,01110011
87,01010111,55,00110111,142,10001110
102,01100110,111,01101111,213,11010101
9,00001001,0,00000000,9,00001001
33,00100001,30,00011110,63,00111111
39,00100111,95,01011111,134,10000110
72,01001000,35,00100011,107,01101011
77,01001101,82,01010010,159,10011111
10,00001010,39,00100111,49,00110001
2,00000010,61,00111101,63,00111111
33,00100001,103,01100111,136,10001000
54,00110110,46,00101110,100,01100100
7,00000111,71,01000111,78,01001110
10,00001010,15,00001111,25,00011001
20,00010100,30,00011110,50,00110010
20,00010100,104,01101000,124,01111100
114,01110010,113,01110001,227,11100011
80,01010000,74,01001010,154,10011010
10,00001010,122,01111010,132,10000100
5,00000101,93,01011101,98,01100010
80,01010000,12,00001100,92,01011100
12,00001100,89,01011001,101,01100101
115,01110011,106,01101010,221,11011101
17,00010001,19,00010011,36,00100100
86,01010110,96,01100000,182,10110110
64,01000000,115,01110011,179,10110011
123,01111011,86,01010110,209,11010001
99,01100011,121,01111001,220,11011100
117,01110101,123,01111011,240,11110000
93,01011101,50,00110010,143,10001111
8,00001000,119,01110111,127,01111111
99,01100011,91,01011011,190,10111110
45,00101101,75,01001011,120,01111000
114,01110010,37,00100101,151,10010111
26,00011010,34,00100010,60,00111100
84,01010100,68,01000100,152,10011000
13,00001101,92,01011100,105,01101001
67,01000011,1,00000001,68,01000100
11,00001011,90,01011010,101,01100101
8,00001000,2,00000010,10,00001010
21,00010101,31,00011111,52,00110100
13,00001101,89,01011001,102,01100110
5,00000101,36,00100100,41,00101001
81,01010001,24,00011000,105,01101001
47,00101111,113,01110001,160,10100000
47,00101111,37,00100101,84,01010100
83,01010011,100,01100100,183,10110111
122,01111010,79,01001111,201,11001001
2,00000010,44,00101100,46,00101110
121,01111001,75,01001011,196,11000100
16,00010000,5,00000101,21,00010101
64,01000000,115,01110011,179,10110011
107,01101011,32,00100000,139,10001011
64,01000000,123,01111011,187,10111011
121,01111001,6,00000110,127,01111111
127,01111111,99,01100011,226,11100010
70,01000110,91,01011011,161,10100001
32,00100000,63,00111111,95,01011111
19,00010011,114,01110010,133,10000101
46,00101110,127,01111111,173,10101101
109,01101101,34,00100010,143,10001111
11,00001011,9,00001001,20,00010100
41,00101001,31,00011111,72,01001000
69,01000101,122,01111010,191,10111111
81,01010001,124,01111100,205,11001101
80,01010000,62,00111110,142,10001110
46,00101110,76,01001100,122,01111010
25,00011001,52,00110100,77,01001101
84,01010100,117,01110101,201,11001001
116,01110100,115,01110011,231,11100111
66,01000010,52,00110100,118,01110110
113,01110001,100,01100100,213,11010101
105,01101001,36,00100100,141,10001101
27,00011011,21,00010101,48,00110000
19,00010011,125,01111101,144,10010000
110,01101110,48,00110000,158,10011110
18,00010010,70,01000110,88,01011000
99,01100011,113,01110001,212,11010100
41,00101001,5,00000101,46,00101110
61,00111101,105,01101001,166,10100110
18,00010010,65,01000001,83,01010011
36,00100100,8,00001000,44,00101100
31,00011111,43,00101011,74,01001010
23,00010111,5,00000101,28,00011100
24,00011000,89,01011001,113,01110001
47,00101111,58,00111010,105,01101001
78,01001110,87,01010111,165,10100101
41,00101001,49,00110001,90,01011010
106,01101010,88,01011000,194,11000010
122,01111010,24,00011000,146,10010010
4,00000100,64,01000000,68,01000100
92,01011100,118,01110110,210,11010010
91,01011011,14,00001110,105,01101001
41,00101001,113,01110001,154,10011010
57,00111001,0,00000000,57,00111001
103,01100111,8,00001000,111,01101111
40,00101000,38,00100110,78,01001110
86,01010110,1,00000001,87,01010111
102,01100110,117,01110101,219,11011011
69,01000101,122,01111010,191,10111111
55,00110111,28,00011100,83,01010011
121,01111001,26,00011010,147,10010011
31,00011111,102,01100110,133,10000101
80,01010000,22,00010110,102,01100110
79,01001111,96,01100000,175,10101111
111,01101111,68,01000100,179,10110011
86,01010110,69,01000101,155,10011011
32,00100000,73,01001001,105,01101001
116,01110100,88,01011000,204,11001100
83,01010011,34,00100010,117,01110101
123,01111011,126,01111110,249,11111001
115,01110011,106,01101010,221,11011101
86,01010110,110,01101110,196,11000100
35,00100011,76,01001100,111,01101111
25,00011001,23,00010111,48,00110000
60,00111100,94,01011110,154,10011010
64,01000000,94,01011110,158,10011110
103,01100111,95,01011111,198,11000110
26,00011010,42,00101010,68,01000100
68,01000100,48,00110000,116,01110100
18,00010010,41,00101001,59,00111011
127,01111111,3,00000011,130,10000010
7,00000111,61,00111101,68,01000100
22,00010110,61,00111101,83,01010011
105,01101001,119,01110111,224,11100000
12,00001100,68,01000100,80,01010000
85,01010101,121,01111001,206,11001110
92,01011100,104,01101000,196,11000100
97,01100001,9,00001001,106,01101010
32,00100000,43,00101011,75,01001011
71,01000111,82,01010010,153,10011001
15,00001111,69,01000101,84,01010100
80,01010000,11,00001011,91,01011011
59,00111011,39,00100111,98,01100010
98,01100010,126,01111110,224,11100000
87,01010111,116,01110100,203,11001011
29,00011101,107,01101011,136,10001000
36,00100100,80,01010000,116,01110100
104,01101000,105,01101001,209,11010001
18,00010010,20,00010100,38,00100110
14,00001110,111,01101111,125,01111101
81,01010001,3,00000011,84,01010100
113,01110001,12,00001100,125,01111101
53,00110101,113,01110001,166,10100110
18,00010010,123,01111011,141,10001101
116,01110100,76,01001100,192,11000000
14,00001110,109,01101101,123,01111011
126,01111110,11,00001011,137,10001001
104,01101000,48,00110000,152,10011000
84,01010100,118,01110110,202,11001010
71,01000111,82,01010010,153,10011001
61,00111101,114,01110010,175,10101111
102,01100110,121,01111001,223,11011111
74,01001010,1,00000001,75,01001011
10,00001010,56,00111000,66,01000010
44,00101100,34,00100010,78,01001110
1,00000001,90,01011010,91,01011011
109,01101101,3,00000011,112,01110000
123,01111011,69,01000101,192,11000000
36,00100100,76,01001100,112,01110000
58,00111010,107,01101011,165,10100101
106,01101010,101,01100101,207,11001111
22,00010110,15,00001111,37,00100101
104,01101000,0,00000000,104,01101000
45,00101101,29,00011101,74,01001010
94,01011110,40,00101000,134,10000110
38,00100110,92,01011100,130,10000010
23,00010111,2,00000010,25,00011001
11,00001011,37,00100101,48,00110000
19,00010011,20,00010100,39,00100111
123,01111011,75,01001011,198,11000110
106,01101010,127,01111111,233,11101001
6,00000110,17,00010001,23,00010111
122,01111010,51,00110011,173,10101101
111,01101111,118,01110110,229,11100101
80,01010000,1,00000001,81,01010001
2,00000010,23,00010111,25,00011001
5,00000101,108,01101100,113,01110001
4,00000100,7,00000111,11,00001011
69,01000101,81,01010001,150,10010110
110,01101110,75,01001011,185,10111001
105,01101001,37,00100101,142,10001110
2,00000010,104,01101000,106,01101010
29,00011101,103,01100111,132,10000100
52,00110100,21,00010101,73,01001001
47,00101111,105,01101001,152,10011000
73,01001001,66,01000010,139,10001011
95,01011111,27,00011011,122,01111010
18,00010010,126,01111110,144,10010000
111,01101111,1,00000001,112,01110000
94,01011110,63,00111111,157,10011101
52,00110100,77,01001101,129,10000001
37,00100101,23,00010111,60,00111100
97,01100001,110,01101110,207,11001111
90,01011010,9,00001001,99,01100011
115,01110011,75,01001011,190,10111110
72,01001000,4,00000100,76,01001100
107,01101011,12,00001100,119,01110111
77,01001101,21,00010101,98,01100010
101,01100101,26,00011010,127,01111111
101,01100101,69,01000101,170,10101010
97,01100001,55,00110111,152,10011000
20,00010100,110,01101110,130,10000010
103,01100111,65,01000001,168,10101000
48,00110000,127,01111111,175,10101111
107,01101011,58,00111010,165,10100101
112,01110000,79,01001111,191,10111111
70,01000110,80,01010000,150,10010110
105,01101001,13,00001101,118,01110110
108,01101100,3,00000011,111,01101111
3,00000011,112,01110000,115,01110011
90,01011010,22,00010110,112,01110000
73,01001001,78,01001110,151,10010111
123,01111011,30,00011110,153,10011001
45,00101101,54,00110110,99,01100011
59,00111011,100,01100100,159,10011111
77,01001101,108,01101100,185,10111001
80,01010000,124,01111100,204,11001100
56,00111000,40,00101000,96,01100000
85,01010101,118,01110110,203,11001011
31,00011111,67,01000011,98,01100010
124,01111100,118,01110110,242,11110010
72,01001000,75,01001011,147,10010011
120,01111000,95,01011111,215,11010111
57,00111001,54,00110110,111,01101111
54,00110110,9,00001001,63,00111111
94,01011110,82,01010010,176,10110000
2,00000010,60,00111100,62,00111110
10,00001010,44,00101100,54,00110110
30,00011110,44,00101100,74,01001010
23,00010111,98,01100010,121,01111001
11,00001011,122,01111010,133,10000101
117,01110101,57,00111001,174,10101110
98,01100010,93,01011101,191,10111111
87,01010111,115,01110011,202,11001010
98,01100010,62,00111110,160,10100000
126,01111110,49,00110001,175,10101111
82,01010010,75,01001011,157,10011101
8,00001000,39,00100111,47,00101111
44,00101100,7,00000111,51,00110011
34,00100010,72,01001000,106,01101010
95,01011111,61,00111101,156,10011100
54,00110110,50,00110010,104,01101000
118,01110110,28,00011100,146,10010010
44,00101100,7,00000111,51,00110011
52,00110100,87,01010111,139,10001011
101,01100101,126,01111110,227,11100011
7,00000111,43,00101011,50,00110010
61,00111101,50,00110010,111,01101111
42,00101010,4,00000100,46,00101110
35,00100011,90,01011010,125,01111101
55,00110111,91,01011011,146,10010010
21,00010101,90,01011010,111,01101111
115,01110011,71,01000111,186,10111010
109,01101101,78,01001110,187,10111011
121,01111001,74,01001010,195,11000011
19,00010011,58,00111010,77,01001101
25,00011001,10,00001010,35,00100011
111,01101111,119,01110111,230,11100110
115,01110011,126,01111110,241,11110001
36,00100100,50,00110010,86,01010110
125,01111101,19,00010011,144,10010000
52,00110100,77,01001101,129,10000001
14,00001110,16,00010000,30,00011110
32,00100000,10,00001010,42,00101010
62,00111110,57,00111001,119,01110111
35,00100011,105,01101001,140,10001100
5,00000101,116,01110100,121,01111001
108,01101100,114,01110010,222,11011110
53,00110101,80,01010000,133,10000101
61,00111101,63,00111111,124,01111100
106,01101010,55,00110111,161,10100001
62,00111110,94,01011110,156,10011100
85,01010101,8,00001000,93,01011101
43,00101011,125,01111101,168,10101000
110,01101110,53,00110101,163,10100011
67,01000011,7,00000111,74,01001010
119,01110111,105,01101001,224,11100000
82,01010010,23,00010111,105,01101001
60,00111100,22,00010110,82,01010010
1,00000001,18,00010010,19,00010011
52,00110100,61,00111101,113,01110001
48,00110000,50,00110010,98,01100010
105,01101001,76,01001100,181,10110101
60,00111100,104,01101000,164,10100100
121,01111001,61,00111101,182,10110110
82,01010010,91,01011011,173,10101101
81,01010001,122,01111010,203,11001011
54,00110110,97,01100001,151,10010111
91,01011011,37,00100101,128,10000000
116,01110100,32,00100000,148,10010100
74,01001010,120,01111000,194,11000010
100,01100100,72,01001000,172,10101100
69,01000101,119,01110111,188,10111100
22,00010110,10,00001010,32,00100000
115,01110011,55,00110111,170,10101010
5,00000101,54,00110110,59,00111011
42,00101010,26,00011010,68,01000100
107,01101011,72,01001000,179,10110011
54,00110110,51,00110011,105,01101001
71,01000111,7,00000111,78,01001110
78,01001110,93,01011101,171,10101011
76,01001100,65,01000001,141,10001101
119,01110111,6,00000110,125,01111101
71,01000111,44,00101100,115,01110011
11,00001011,106,01101010,117,01110101
11,00001011,5,00000101,16,00010000
75,01001011,109,01101101,184,10111000
102,01100110,16,00010000,118,01110110
59,00111011,53,00110101,112,01110000
99,01100011,80,01010000,179,10110011
35,00100011,48,00110000,83,01010011
87,01010111,106,01101010,193,11000001
17,00010001,65,01000001,82,01010010
109,01101101,51,00110011,160,10100000
24,00011000,72,01001000,96,01100000
94,01011110,53,00110101,147,10010011
22,00010110,98,01100010,120,01111000
114,01110010,40,00101000,154,10011010
116,01110100,85,01010101,201,11001001
119,01110111,75,01001011,194,11000010
103,01100111,35,00100011,138,10001010
87,01010111,27,00011011,114,01110010
31,00011111,67,01000011,98,01100010
57,00111001,58,00111010,115,01110011
83,01010011,103,01100111,186,10111010
29,00011101,81,01010001,110,01101110
27,00011011,65,01000001,92,01011100
102,01100110,38,00100110,140,10001100
84,01010100,46,00101110,130,10000010
112,01110000,4,00000100,116,01110100
48,00110000,70,01000110,118,01110110
14,00001110,60,00111100,74,01001010
21,00010101,96,01100000,117,01110101
37,00100101,41,00101001,78,01001110
13,00001101,91,01011011,104,01101000
41,00101001,104,01101000,145,10010001
73,01001001,127,01111111,200,11001000
108,01101100,14,00001110,122,01111010
34,00100010,30,00011110,64,01000000
50,00110010,69,01000101,119,01110111
17,00010001,38,00100110,55,00110111
108,01101100,54,00110110,162,10100010
36,00100100,103,01100111,139,10001011
35,00100011,82,01010010,117,01110101
121,01111001,4,00000100,125,01111101
30,00011110,117,01110101,147,10010011
45,00101101,105,01101001,150,10010110
47,00101111,57,00111001,104,01101000
108,01101100,92,01011100,200,11001000
103,01100111,113,01110001,216,11011000
99,01100011,16,00010000,115,01110011
58,00111010,46,00101110,104,01101000
8,00001000,6,00000110,14,00001110
51,00110011,51,00110011,102,01100110
46,00101110,58,00111010,104,01101000
17,00010001,78,01001110,95,01011111
47,00101111,50,00110010,97,01100001
93,01011101,34,00100010,127,01111111
23,00010111,66,01000010,89,01011001
5,00000101,99,01100011,104,01101000
21,00010101,90,01011010,111,01101111
118,01110110,118,01110110,236,11101100
74,01001010,118,01110110,192,11000000
51,00110011,30,00011110,81,01010001
73,01001001,105,01101001,178,10110010
126,01111110,21,00010101,147,10010011
51,00110011,24,00011000,75,01001011
99,01100011,15,00001111,114,01110010
116,01110100,31,00011111,147,10010011
82,01010010,51,00110011,133,10000101
41,00101001,61,00111101,102,01100110
114,01110010,68,01000100,182,10110110
123,01111011,111,01101111,234,11101010
97,01100001,55,00110111,152,10011000
19,00010011,49,00110001,68,01000100
126,01111110,108,01101100,234,11101010
59,00111011,11,00001011,70,01000110
111,01101111,49,00110001,160,10100000
109,01101101,2,00000010,111,01101111
23,00010111,54,00110110,77,01001101
67,01000011,99,01100011,166,10100110
21,00010101,58,00111010,79,01001111
65,01000001,82,01010010,147,10010011
84,01010100,79,01001111,163,10100011
123,01111011,99,01100011,222,11011110
89,01011001,22,00010110,111,01101111
15,00001111,119,01110111,134,10000110
79,01001111,66,01000010,145,10010001
13,00001101,16,00010000,29,00011101
1,00000001,19,00010011,20,00010100
98,01100010,80,01010000,178,10110010
101,01100101,119,01110111,220,11011100
69,01000101,122,01111010,191,10111111
125,01111101,47,00101111,172,10101100
124,01111100,79,01001111,203,11001011
40,00101000,120,01111000,160,10100000
80,01010000,84,01010100,164,10100100
56,00111000,117,01110101,173,10101101
21,00010101,85,01010101,106,01101010
22,00010110,31,00011111,53,00110101
112,01110000,34,00100010,146,10010010
102,01100110,68,01000100,170,10101010
106,01101010,36,00100100,142,10001110
17,00010001,68,01000100,85,01010101
10,00001010,113,01110001,123,01111011
119,01110111,22,00010110,141,10001101
108,01101100,118,01110110,226,11100010
72,01001000,80,01010000,152,10011000
44,00101100,67,01000011,111,01101111
113,01110001,84,01010100,197,11000101
78,01001110,76,01001100,154,10011010
104,01101000,31,00011111,135,10000111
75,01001011,82,01010010,157,10011101
45,00101101,124,01111100,169,10101001
95,01011111,58,00111010,153,10011001
60,00111100,37,00100101,97,01100001
103,01100111,60,00111100,163,10100011
94,01011110,112,01110000,206,11001110
71,01000111,111,01101111,182,10110110
88,01011000,105,01101001,193,11000001
117,01110101,33,00100001,150,10010110
23,00010111,43,00101011,66,01000010
93,01011101,17,00010001,110,01101110
88,01011000,37,00100101,125,01111101
101,01100101,57,00111001,158,10011110
51,00110011,2,00000010,53,00110101
44,00101100,123,01111011,167,10100111
76,01001100,119,01110111,195,11000011
12,00001100,13,00001101,25,00011001
93,01011101,120,01111000,213,11010101
92,01011100,111,01101111,203,11001011
45,00101101,16,00010000,61,00111101
44,00101100,109,01101101,153,10011001
118,01110110,1,00000001,119,01110111
0,00000000,81,01010001,81,01010001
29,00011101,58,00111010,87,01010111
16,00010000,67,01000011,83,01010011
99,01100011,28,00011100,127,01111111
45,00101101,82,01010010,127,01111111
72,01001000,121,01111001,193,11000001
103,01100111,79,01001111,182,10110110
46,00101110,100,01100100,146,10010010
36,00100100,48,00110000,84,01010100
64,01000000,105,01101001,169,10101001
79,01001111,42,00101010,121,01111001
56,00111000,120,01111000,176,10110000
0,00000000,15,00001111,15,00001111
117,01110101,6,00000110,123,01111011
109,01101101,126,01111110,235,11101011
125,01111101,49,00110001,174,10101110
116,01110100,89,01011001,205,11001101
1,00000001,126,01111110,127,01111111
14,00001110,33,00100001,47,00101111
65,01000001,61,00111101,126,01111110
44,00101100,84,01010100,128,10000000
54,00110110,90,01011010,144,10010000
103,01100111,124,01111100,227,11100011
111,01101111,109,01101101,220,11011100
76,01001100,90,01011010,166,10100110
122,01111010,16,00010000,138,10001010
90,01011010,107,01101011,197,11000101
68,01000100,49,00110001,117,01110101
55,00110111,49,00110001,104,01101000
96,01100000,12,00001100,108,01101100
49,00110001,1,00000001,50,00110010
54,00110110,87,01010111,141,10001101
93,01011101,93,01011101,186,10111010
37,00100101,127,01111111,164,10100100
69,01000101,87,01010111,156,10011100
58,00111010,68,01000100,126,01111110
28,00011100,92,01011100,120,01111000
89,01011001,91,01011011,180,10110100
66,01000010,59,00111011,125,01111101
33,00100001,61,00111101,94,01011110
95,01011111,49,00110001,144,10010000
67,01000011,3,00000011,70,01000110
50,00110010,7,00000111,57,00111001
7,00000111,46,00101110,53,00110101
116,01110100,22,00010110,138,10001010
9,00001001,126,01111110,135,10000111
75,01001011,36,00100100,111,01101111
40,00101000,75,01001011,115,01110011
110,01101110,88,01011000,198,11000110
9,00001001,108,01101100,117,01110101
63,00111111,54,00110110,117,01110101
102,01100110,0,00000000,102,01100110
68,01000100,67,01000011,135,10000111
25,00011001,115,01110011,140,10001100
108,01101100,87,01010111,195,11000011
104,01101000,110,01101110,214,11010110
79,01001111,41,00101001,120,01111000
77,01001101,72,01001000,149,10010101
69,01000101,53,00110101,122,01111010
59,00111011,112,01110000,171,10101011
48,00110000,46,00101110,94,01011110
64,01000000,99,01100011,163,10100011
23,00010111,109,01101101,132,10000100
76,01001100,96,01100000,172,10101100
7,00000111,61,00111101,68,01000100
90,01011010,24,00011000,114,01110010
117,01110101,97,01100001,214,11010110
92,01011100,89,01011001,181,10110101
63,00111111,19,00010011,82,01010010
55,00110111,13,00001101,68,01000100
39,00100111,22,00010110,61,00111101
118,01110110,83,01010011,201,11001001
103,01100111,4,00000100,107,01101011
11,00001011,20,00010100,31,00011111
113,01110001,30,00011110,143,10001111
98,01100010,65,01000001,163,10100011
16,00010000,63,00111111,79,01001111
106,01101010,101,01100101,207,11001111
43,00101011,39,00100111,82,01010010
0,00000000,74,01001010,74,01001010
118,01110110,64,01000000,182,10110110
36,00100100,100,01100100,136,10001000
50,00110010,19,00010011,69,01000101
111,01101111,52,00110100,163,10100011
97,01100001,93,01011101,190,10111110
110,01101110,54,00110110,164,10100100
104,01101000,5,00000101,109,01101101
55,00110111,108,01101100,163,10100011
86,01010110,11,00001011,97,01100001
61,00111101,88,01011000,149,10010101
18,00010010,12,00001100,30,00011110
44,00101100,7,00000111,51,00110011
66,01000010,76,01001100,142,10001110
43,00101011,30,00011110,73,01001001
100,01100100,41,00101001,141,10001101
94,01011110,45,00101101,139,10001011
108,01101100,63,00111111,171,10101011
89,01011001,11,00001011,100,01100100
38,00100110,29,00011101,67,01000011
55,00110111,42,00101010,97,01100001
42,00101010,93,01011101,135,10000111
117,01110101,65,01000001,182,10110110
58,00111010,53,00110101,111,01101111
104,01101000,86,01010110,190,10111110
94,01011110,108,01101100,202,11001010
79,01001111,35,00100011,114,01110010
108,01101100,22,00010110,130,10000010
120,01111000,86,01010110,206,11001110
62,00111110,10,00001010,72,01001000
117,01110101,11,00001011,128,10000000
73,01001001,2,00000010,75,01001011
67,01000011,45,00101101,112,01110000
17,00010001,3,00000011,20,00010100
5,00000101,52,00110100,57,00111001
120,01111000,45,00101101,165,10100101
67,01000011,51,00110011,118,01110110
54,00110110,62,00111110,116,01110100
114,01110010,37,00100101,151,10010111
110,01101110,80,01010000,190,10111110
8,00001000,3,00000011,11,00001011
126,01111110,2,00000010,128,10000000
13,00001101,98,01100010,111,01101111
25,00011001,118,01110110,143,10001111
37,00100101,108,01101100,145,10010001
42,00101010,82,01010010,124,01111100
120,01111000,97,01100001,217,11011001
86,01010110,114,01110010,200,11001000
84,01010100,123,01111011,207,11001111
59,00111011,11,00001011,70,01000110
56,00111000,25,00011001,81,01010001
84,01010100,71,01000111,155,10011011
85,01010101,79,01001111,164,10100100
107,01101011,73,01001001,180,10110100
1,00000001,7,00000111,8,00001000
110,01101110,41,00101001,151,10010111
114,01110010,126,01111110,240,11110000
84,01010100,102,01100110,186,10111010
5,00000101,80,01010000,85,01010101
57,00111001,85,01010101,142,10001110
26,00011010,64,01000000,90,01011010
99,01100011,65,01000001,164,10100100
73,01001001,8,00001000,81,01010001
11,00001011,81,01010001,92,01011100
80,01010000,84,01010100,164,10100100
56,00111000,106,01101010,162,10100010
104,01101000,88,01011000,192,11000000
11,00001011,60,00111100,71,01000111
117,01110101,112,01110000,229,11100101
99,01100011,26,00011010,125,01111101
98,01100010,113,01110001,211,11010011
0,00000000,55,00110111,55,00110111
40,00101000,17,00010001,57,00111001
78,01001110,45,00101101,123,01111011
33,00100001,22,00010110,55,00110111
5,00000101,86,01010110,91,01011011
16,00010000,122,01111010,138,10001010
46,00101110,20,00010100,66,01000010
68,01000100,26,00011010,94,01011110
50,00110010,112,01110000,162,10100010
67,01000011,93,01011101,160,10100000
121,01111001,41,00101001,162,10100010
101,01100101,37,00100101,138,10001010
37,00100101,39,00100111,76,01001100
4,00000100,11,00001011,15,00001111
13,00001101,90,01011010,103,01100111
47,00101111,41,00101001,88,01011000
56,00111000,77,01001101,133,10000101
49,00110001,72,01001000,121,01111001
6,00000110,14,00001110,20,00010100
70,01000110,25,00011001,95,01011111
59,00111011,105,01101001,164,10100100
110,01101110,34,00100010,144,10010000
29,00011101,123,01111011,152,10011000
23,00010111,28,00011100,51,00110011
78,01001110,100,01100100,178,10110010
9,00001001,53,00110101,62,00111110
110,01101110,0,00000000,110,01101110
94,01011110,111,01101111,205,11001101
84,01010100,55,00110111,139,10001011
1,00000001,124,01111100,125,01111101
71,01000111,83,01010011,154,10011010
36,00100100,78,01001110,114,01110010
22,00010110,70,01000110,92,01011100
98,01100010,95,01011111,193,11000001
70,01000110,67,01000011,137,10001001
75,01001011,17,00010001,92,01011100
71,01000111,90,01011010,161,10100001
118,01110110,118,01110110,236,11101100
102,01100110,124,01111100,226,11100010
86,01010110,36,00100100,122,01111010
52,00110100,78,01001110,130,10000010
85,01010101,40,00101000,125,01111101
36,00100100,35,00100011,71,01000111
39,00100111,101,01100101,140,10001100
106,01101010,60,00111100,166,10100110
56,00111000,50,00110010,106,01101010
33,00100001,71,01000111,104,01101000
15,00001111,0,00000000,15,00001111
120,01111000,65,01000001,185,10111001
33,00100001,9,00001001,42,00101010
18,00010010,35,00100011,53,00110101
124,01111100,17,00010001,141,10001101
16,00010000,53,00110101,69,01000101
79,01001111,74,01001010,153,10011001
61,00111101,40,00101000,101,01100101
31,00011111,88,01011000,119,01110111
68,01000100,55,00110111,123,01111011
61,00111101,6,00000110,67,01000011
5,00000101,83,01010011,88,01011000
84,01010100,68,01000100,152,10011000
118,01110110,45,00101101,163,10100011
29,00011101,65,01000001,94,01011110
20,00010100,47,00101111,67,01000011
28,00011100,27,00011011,55,00110111
11,00001011,119,01110111,130,10000010
11,00001011,77,01001101,88,01011000
122,01111010,112,01110000,234,11101010
90,01011010,3,00000011,93,01011101
10,00001010,104,01101000,114,01110010
120,01111000,114,01110010,234,11101010
46,00101110,90,01011010,136,10001000
53,00110101,40,00101000,93,01011101
50,00110010,22,00010110,72,01001000
125,01111101,51,00110011,176,10110000
127,01111111,17,00010001,144,10010000
39,00100111,100,01100100,139,10001011
77,01001101,72,01001000,149,10010101
67,01000011,98,01100010,165,10100101
40,00101000,38,00100110,78,01001110
51,00110011,44,00101100,95,01011111
78,01001110,51,00110011,129,10000001
112,01110000,18,00010010,130,10000010
120,01111000,107,01101011,227,11100011
13,00001101,25,00011001,38,00100110
85,01010101,67,01000011,152,10011000
60,00111100,1,00000001,61,00111101
109,01101101,111,01101111,220,11011100
127,01111111,34,00100010,161,10100001
36,00100100,43,00101011,79,01001111
65,01000001,1,00000001,66,01000010
43,00101011,48,00110000,91,01011011
32,00100000,60,00111100,92,01011100
27,00011011,77,01001101,104,01101000
69,01000101,76,01001100,145,10010001
117,01110101,15,00001111,132,10000100
62,00111110,62,00111110,124,01111100
10,00001010,32,00100000,42,00101010
8,00001000,69,01000101,77,01001101
39,00100111,99,01100011,138,10001010
75,01001011,116,01110100,191,10111111
48,00110000,118,01110110,166,10100110
92,01011100,5,00000101,97,01100001
122,01111010,58,00111010,180,10110100
23,00010111,77,01001101,100,01100100
55,00110111,52,00110100,107,01101011
75,01001011,124,01111100,199,11000111
69,01000101,90,01011010,159,10011111
7,00000111,126,01111110,133,10000101
41,00101001,68,01000100,109,01101101
0,00000000,98,01100010,98,01100010
64,01000000,4,00000100,68,01000100
32,00100000,85,01010101,117,01110101
14,00001110,70,01000110,84,01010100
78,01001110,2,00000010,80,01010000
56,00111000,76,01001100,132,10000100
87,01010111,5,00000101,92,01011100
21,00010101,10,00001010,31,00011111
103,01100111,1,00000001,104,01101000
81,01010001,77,01001101,158,10011110
77,01001101,81,01010001,158,10011110
50,00110010,116,01110100,166,10100110
28,00011100,46,00101110,74,01001010
14,00001110,34,00100010,48,00110000
16,00010000,0,00000000,16,00010000
45,00101101,105,01101001,150,10010110
69,01000101,92,01011100,161,10100001
79,01001111,125,01111101,204,11001100
56,00111000,114,01110010,170,10101010
13,00001101,15,00001111,28,00011100
123,01111011,4,00000100,127,01111111
62,00111110,30,00011110,92,01011100
71,01000111,22,00010110,93,01011101
46,00101110,24,00011000,70,01000110
112,01110000,78,01001110,190,10111110
13,00001101,90,01011010,103,01100111
8,00001000,6,00000110,14,00001110
5,00000101,1,00000001,6,00000110
117,01110101,107,01101011,224,11100000
2,00000010,70,01000110,72,01001000
92,01011100,79,01001111,171,10101011
36,00100100,57,00111001,93,01011101
61,00111101,35,00100011,96,01100000
112,01110000,13,00001101,125,01111101
69,01000101,77,01001101,146,10010010
32,00100000,55,00110111,87,01010111
119,01110111,120,01111000,239,11101111
100,01100100,60,00111100,160,10100000
1,00000001,75,01001011,76,01001100
73,01001001,9,00001001,82,01010010
98,01100010,121,01111001,219,11011011
87,01010111,96,01100000,183,10110111
59,00111011,56,00111000,115,01110011
120,01111000,113,01110001,233,11101001
9,00001001,59,00111011,68,01000100
67,01000011,100,01100100,167,10100111
48,00110000,4,00000100,52,00110100
127,01111111,127,01111111,254,11111110
82,01010010,3,00000011,85,01010101
36,00100100,11,00001011,47,00101111
5,00000101,64,01000000,69,01000101
107,01101011,96,01100000,203,11001011
110,01101110,9,00001001,119,01110111
126,01111110,105,01101001,231,11100111
57,00111001,7,00000111,64,01000000
6,00000110,44,00101100,50,00110010
106,01101010,1,00000001,107,01101011
82,01010010,93,01011101,175,10101111
100,01100100,101,01100101,201,11001001
83,01010011,117,01110101,200,11001000
89,01011001,77,01001101,166,10100110
28,00011100,102,01100110,130,10000010
55,00110111,73,01001001,128,10000000
14,00001110,20,00010100,34,00100010
105,01101001,96,01100000,201,11001001
123,01111011,49,00110001,172,10101100
79,01001111,101,01100101,180,10110100
79,01001111,87,01010111,166,10100110
110,01101110,18,00010010,128,10000000
43,00101011,97,01100001,140,10001100
2,00000010,95,01011111,97,01100001
35,00100011,97,01100001,132,10000100
118,01110110,29,00011101,147,10010011
70,01000110,46,00101110,116,01110100
67,01000011,119,01110111,186,10111010
65,01000001,24,00011000,89,01011001
42,00101010,109,01101101,151,10010111
84,01010100,110,01101110,194,11000010
55,00110111,48,00110000,103,01100111
124,01111100,11,00001011,135,10000111
64,01000000,33,00100001,97,01100001
88,01011000,88,01011000,176,10110000
67,01000011,100,01100100,167,10100111
116,01110100,93,01011101,209,11010001
89,01011001,103,01100111,192,11000000
37,00100101,93,01011101,130,10000010
13,00001101,81,01010001,94,01011110
22,00010110,22,00010110,44,00101100
28,00011100,95,01011111,123,01111011
93,01011101,93,01011101,186,10111010
14,00001110,101,01100101,115,01110011
22,00010110,66,01000010,88,01011000
103,01100111,24,00011000,127,01111111
121,01111001,5,00000101,126,01111110
33,00100001,107,01101011,140,10001100
39,00100111,20,00010100,59,00111011
29,00011101,30,00011110,59,00111011
125,01111101,53,00110101,178,10110010
18,00010010,84,01010100,102,01100110
95,01011111,4,00000100,99,01100011
111,01101111,33,00100001,144,10010000
90,01011010,56,00111000,146,10010010
103,01100111,115,01110011,218,11011010
21,00010101,112,01110000,133,10000101
37,00100101,12,00001100,49,00110001
95,01011111,55,00110111,150,10010110
96,01100000,98,01100010,194,11000010
87,01010111,116,01110100,203,11001011
118,01110110,121,01111001,239,11101111
60,00111100,46,00101110,106,01101010
98,01100010,111,01101111,209,11010001
83,01010011,8,00001000,91,01011011
83,01010011,96,01100000,179,10110011
104,01101000,35,00100011,139,10001011
126,01111110,34,00100010,160,10100000
55,00110111,60,00111100,115,01110011
27,00011011,8,00001000,35,00100011
93,01011101,15,00001111,108,01101100
18,00010010,0,00000000,18,00010010
92,01011100,93,01011101,185,10111001
29,00011101,112,01110000,141,10001101
62,00111110,70,01000110,132,10000100
1,00000001,52,00110100,53,00110101
78,01001110,92,01011100,170,10101010
86,01010110,1,00000001,87,01010111
123,01111011,55,00110111,178,10110010
121,01111001,84,01010100,205,11001101
76,01001100,8,00001000,84,01010100
24,00011000,101,01100101,125,01111101
99,01100011,83,01010011,182,10110110
37,00100101,35,00100011,72,01001000
72,01001000,96,01100000,168,10101000
95,01011111,111,01101111,206,11001110
90,01011010,99,01100011,189,10111101
77,01001101,35,00100011,112,01110000
87,01010111,111,01101111,198,11000110
29,00011101,17,00010001,46,00101110
51,00110011,77,01001101,128,10000000
14,00001110,2,00000010,16,00010000
12,00001100,105,01101001,117,01110101
126,01111110,49,00110001,175,10101111
105,01101001,91,01011011,196,11000100
20,00010100,71,01000111,91,01011011
80,01010000,84,01010100,164,10100100
15,00001111,93,01011101,108,01101100
118,01110110,13,00001101,131,10000011
23,00010111,80,01010000,103,01100111
40,00101000,47,00101111,87,01010111
39,00100111,41,00101001,80,01010000
105,01101001,101,01100101,206,11001110
96,01100000,93,01011101,189,10111101
79,01001111,96,01100000,175,10101111
19,00010011,70,01000110,89,01011001
56,00111000,42,00101010,98,01100010
48,00110000,66,01000010,114,01110010
112,01110000,15,00001111,127,01111111
87,01010111,68,01000100,155,10011011
75,01001011,7,00000111,82,01010010
41,00101001,66,01000010,107,01101011
104,01101000,3,00000011,107,01101011
8,00001000,7,00000111,15,00001111
54,00110110,28,00011100,82,01010010
97,01100001,121,01111001,218,11011010
32,00100000,5,00000101,37,00100101
116,01110100,102,01100110,218,11011010
26,00011010,9,00001001,35,00100011
79,01001111,12,00001100,91,01011011
38,00100110,27,00011011,65,01000001
28,00011100,54,00110110,82,01010010
59,00111011,71,01000111,130,10000010
54,00110110,46,00101110,100,01100100
109,01101101,51,00110011,160,10100000
20,00010100,40,00101000,60,00111100
47,00101111,30,00011110,77,01001101
23,00010111,29,00011101,52,00110100
37,00100101,103,01100111,140,10001100
31,00011111,102,01100110,133,10000101
110,01101110,106,01101010,216,11011000
67,01000011,22,00010110,89,01011001
50,00110010,25,00011001,75,01001011
96,01100000,0,00000000,96,01100000
101,01100101,86,01010110,187,10111011
13,00001101,112,01110000,125,01111101
52,00110100,99,01100011,151,10010111
89,01011001,79,01001111,168,10101000
79,01001111,35,00100011,114,01110010
0,00000000,91,01011011,91,01011011
31,00011111,48,00110000,79,01001111
31,00011111,116,01110100,147,10010011
115,01110011,109,01101101,224,11100000
35,00100011,40,00101000,75,01001011
120,01111000,8,00001000,128,10000000
45,00101101,23,00010111,68,01000100
96,01100000,107,01101011,203,11001011
88,01011000,77,01001101,165,10100101
87,01010111,100,01100100,187,10111011
103,01100111,98,01100010,201,11001001
73,01001001,24,00011000,97,01100001
7,00000111,106,01101010,113,01110001
0,00000000,42,00101010,42,00101010
108,01101100,60,00111100,168,10101000
40,00101000,80,01010000,120,01111000
82,01010010,117,01110101,199,11000111
85,01010101,31,00011111,116,01110100
79,01001111,3,00000011,82,01010010
96,01100000,48,00110000,144,10010000
24,00011000,37,00100101,61,00111101
29,00011101,30,00011110,59,00111011
20,00010100,118,01110110,138,10001010
50,00110010,45,00101101,95,01011111
123,01111011,31,00011111,154,10011010
98,01100010,113,01110001,211,11010011
70,01000110,117,01110101,187,10111011
127,01111111,79,01001111,206,11001110
7,00000111,27,00011011,34,00100010
36,00100100,124,01111100,160,10100000
74,01001010,95,01011111,169,10101001
55,00110111,50,00110010,105,01101001
65,01000001,104,01101000,169,10101001
52,00110100,105,01101001,157,10011101
19,00010011,28,00011100,47,00101111
118,01110110,30,00011110,148,10010100
22,00010110,27,00011011,49,00110001
23,00010111,2,00000010,25,00011001
27,00011011,69,01000101,96,01100000
8,00001000,84,01010100,92,01011100
91,01011011,7,00000111,98,01100010
54,00110110,92,01011100,146,10010010
2,00000010,31,00011111,33,00100001
63,00111111,73,01001001,136,10001000
39,00100111,6,00000110,45,00101101
35,00100011,14,00001110,49,00110001
59,00111011,46,00101110,105,01101001
6,00000110,41,00101001,47,00101111
106,01101010,49,00110001,155,10011011
122,01111010,18,00010010,140,10001100
33,00100001,19,00010011,52,00110100
43,00101011,104,01101000,147,10010011
55,00110111,21,00010101,76,01001100
85,01010101,10,00001010,95,01011111
4,00000100,0,00000000,4,00000100
64,01000000,90,01011010,154,10011010
116,01110100,74,01001010,190,10111110
73,01001001,21,00010101,94,01011110
5,00000101,117,01110101,122,01111010
33,00100001,79,01001111,112,01110000
42,00101010,87,01010111,129,10000001
28,00011100,37,00100101,65,01000001
46,00101110,42,00101010,88,01011000
68,01000100,88,01011000,156,10011100
47,00101111,17,00010001,64,01000000
55,00110111,37,00100101,92,01011100
123,01111011,35,00100011,158,10011110
79,01001111,120,01111000,199,11000111
63,00111111,2,00000010,65,01000001
45,00101101,57,00111001,102,01100110
29,00011101,6,00000110,35,00100011
81,01010001,107,01101011,188,10111100
62,00111110,15,00001111,77,01001101
63,00111111,10,00001010,73,01001001
45,00101101,108,01101100,153,10011001
74,01001010,33,00100001,107,01101011
68,01000100,0,00000000,68,01000100
51,00110011,89,01011001,140,10001100
59,00111011,126,01111110,185,10111001
33,00100001,81,01010001,114,01110010
59,00111011,29,00011101,88,01011000
109,01101101,33,00100001,142,10001110
31,00011111,4,00000100,35,00100011
76,01001100,6,00000110,82,01010010
62,00111110,113,01110001,175,10101111
87,01010111,71,01000111,158,10011110
85,01010101,35,00100011,120,01111000
7,00000111,40,00101000,47,00101111
95,01011111,106,01101010,201,11001001
62,00111110,1,00000001,63,00111111
14,00001110,55,00110111,69,01000101
113,01110001,61,00111101,174,10101110
126,01111110,72,01001000,198,11000110
83,01010011,40,00101000,123,01111011
66,01000010,5,00000101,71,01000111
1,00000001,36,00100100,37,00100101
124,01111100,106,01101010,230,11100110
116,01110100,15,00001111,131,10000011
115,01110011,61,00111101,176,10110000
88,01011000,85,01010101,173,10101101
37,00100101,92,01011100,129,10000001
62,00111110,53,00110101,115,01110011
34,00100010,59,00111011,93,01011101
44,00101100,0,00000000,44,00101100
13,00001101,124,01111100,137,10001001
55,00110111,65,01000001,120,01111000
24,00011000,21,00010101,45,00101101
93,01011101,48,00110000,141,10001101
36,00100100,111,01101111,147,10010011
89,01011001,92,01011100,181,10110101
116,01110100,65,01000001,181,10110101
104,01101000,88,01011000,192,11000000
45,00101101,60,00111100,105,01101001
113,01110001,91,01011011,204,11001100
89,01011001,79,01001111,168,10101000
58,00111010,88,01011000,146,10010010
89,01011001,59,00111011,148,10010100
71,01000111,79,01001111,150,10010110
27,00011011,124,01111100,151,10010111
48,00110000,63,00111111,111,01101111
109,01101101,105,01101001,214,11010110
23,00010111,102,01100110,125,01111101
66,01000010,30,00011110,96,01100000
30,00011110,90,01011010,120,01111000
94,01011110,52,00110100,146,10010010
70,01000110,120,01111000,190,10111110
71,01000111,124,01111100,195,11000011
103,01100111,84,01010100,187,10111011
24,00011000,108,01101100,132,10000100
89,01011001,74,01001010,163,10100011
4,00000100,40,00101000,44,00101100
66,01000010,125,01111101,191,10111111
57,00111001,29,00011101,86,01010110
125,01111101,32,00100000,157,10011101
122,01111010,90,01011010,212,11010100
56,00111000,37,00100101,93,01011101
106,01101010,51,00110011,157,10011101
104,01101000,106,01101010,210,11010010
19,00010011,95,01011111,114,01110010
121,01111001,21,00010101,142,10001110
91,01011011,79,01001111,170,10101010
85,01010101,18,00010010,103,01100111
88,01011000,38,00100110,126,01111110
81,01010001,123,01111011,204,11001100
14,00001110,28,00011100,42,00101010
99,01100011,80,01010000,179,10110011
32,00100000,116,01110100,148,10010100
64,01000000,85,01010101,149,10010101
7,00000111,90,01011010,97,01100001
41,00101001,24,00011000,65,01000001
31,00011111,45,00101101,76,01001100
101,01100101,4,00000100,105,01101001
39,00100111,67,01000011,106,01101010
104,01101000,32,00100000,136,10001000
90,01011010,55,00110111,145,10010001
37,00100101,41,00101001,78,01001110
52,00110100,27,00011011,79,01001111
35,00100011,103,01100111,138,10001010
81,01010001,71,01000111,152,10011000
2,00000010,17,00010001,19,00010011
113,01110001,127,01111111,240,11110000
25,00011001,55,00110111,80,01010000
59,00111011,104,01101000,163,10100011
2,00000010,0,00000000,2,00000010
27,00011011,87,01010111,114,01110010
40,00101000,96,01100000,136,10001000
94,01011110,44,00101100,138,10001010
23,00010111,12,00001100,35,00100011
62,00111110,20,00010100,82,01010010
8,00001000,31,00011111,39,00100111
79,01001111,19,00010011,98,01100010
81,01010001,60,00111100,141,10001101
32,00100000,72,01001000,104,01101000
118,01110110,75,01001011,193,11000001
54,00110110,92,01011100,146,10010010
14,00001110,102,01100110,116,01110100
40,00101000,77,01001101,117,01110101
117,01110101,60,00111100,177,10110001
50,00110010,49,00110001,99,01100011
117,01110101,39,00100111,156,10011100
27,00011011,93,01011101,120,01111000
9,00001001,1,00000001,10,00001010
56,00111000,79,01001111,135,10000111
54,00110110,71,01000111,125,01111101
79,01001111,23,00010111,102,01100110
112,01110000,117,01110101,229,11100101
46,00101110,23,00010111,69,01000101
109,01101101,56,00111000,165,10100101
32,00100000,46,00101110,78,01001110
19,00010011,5,00000101,24,00011000
95,01011111,87,01010111,182,10110110
125,01111101,72,01001000,197,11000101
125,01111101,43,00101011,168,10101000
9,00001001,37,00100101,46,00101110
120,01111000,23,00010111,143,10001111
44,00101100,70,01000110,114,01110010
6,00000110,51,00110011,57,00111001
92,01011100,78,01001110,170,10101010
42,00101010,78,01001110,120,01111000
116,01110100,7,00000111,123,01111011
95,01011111,76,01001100,171,10101011
127,01111111,38,00100110,165,10100101
101,01100101,106,01101010,207,11001111
14,00001110,112,01110000,126,01111110
115,01110011,120,01111000,235,11101011
1,00000001,66,01000010,67,01000011
48,00110000,28,00011100,76,01001100
63,00111111,42,00101010,105,01101001
13,00001101,37,00100101,50,00110010
81,01010001,104,01101000,185,10111001
95,01011111,116,01110100,211,11010011
35,00100011,31,00011111,66,01000010
109,01101101,47,00101111,156,10011100
53,00110101,43,00101011,96,01100000
74,01001010,5,00000101,79,01001111
21,00010101,5,00000101,26,00011010
98,01100010,101,01100101,199,11000111
43,00101011,0,00000000,43,00101011
126,01111110,15,00001111,141,10001101
26,00011010,116,01110100,142,10001110
61,00111101,107,01101011,168,10101000
121,01111001,122,01111010,243,11110011
18,00010010,32,00100000,50,00110010
5,00000101,102,01100110,107,01101011
69,01000101,11,00001011,80,01010000
67,01000011,41,00101001,108,01101100
93,01011101,93,01011101,186,10111010
0,00000000,87,01010111,87,01010111
10,00001010,48,00110000,58,00111010
127,01111111,23,00010111,150,10010110
0,00000000,111,01101111,111,01101111
95,01011111,11,00001011,106,01101010
25,00011001,70,01000110,95,01011111
20,00010100,78,01001110,98,01100010
42,00101010,127,01111111,169,10101001
79,01001111,110,01101110,189,10111101
40,00101000,67,01000011,107,01101011
96,01100000,103,01100111,199,11000111
33,00100001,124,01111100,157,10011101
60,00111100,66,01000010,126,01111110
86,01010110,40,00101000,126,01111110
115,01110011,47,00101111,162,10100010
18,00010010,61,00111101,79,01001111
37,00100101,97,01100001,134,10000110
19,00010011,42,00101010,61,00111101
22,00010110,57,00111001,79,01001111
38,00100110,99,01100011,137,10001001
60,00111100,72,01001000,132,10000100
43,00101011,59,00111011,102,01100110
80,01010000,92,01011100,172,10101100
46,00101110,109,01101101,155,10011011
66,01000010,111,01101111,177,10110001
108,01101100,117,01110101,225,11100001
77,01001101,86,01010110,163,10100011
67,01000011,86,01010110,153,10011001
17,00010001,82,01010010,99,01100011
8,00001000,47,00101111,55,00110111
120,01111000,85,01010101,205,11001101
2,00000010,19,00010011,21,00010101
30,00011110,114,01110010,144,10010000
76,01001100,54,00110110,130,10000010
102,01100110,56,00111000,158,10011110
117,01110101,101,01100101,218,11011010
23,00010111,31,00011111,54,00110110
106,01101010,49,00110001,155,10011011
16,00010000,66,01000010,82,01010010
56,00111000,38,00100110,94,01011110
57,00111001,1,00000001,58,00111010
12,00001100,7,00000111,19,00010011
81,01010001,98,01100010,179,10110011
56,00111000,63,00111111,119,01110111
88,01011000,97,01100001,185,10111001
8,00001000,38,00100110,46,00101110
75,01001011,126,01111110,201,11001001
64,01000000,71,01000111,135,10000111
51,00110011,121,01111001,172,10101100
70,01000110,40,00101000,110,01101110
24,00011000,107,01101011,131,10000011
34,00100010,3,00000011,37,00100101
41,00101001,94,01011110,135,10000111
108,01101100,49,00110001,157,10011101
26,00011010,38,00100110,64,01000000
9,00001001,51,00110011,60,00111100
1,00000001,78,01001110,79,01001111
16,00010000,99,01100011,115,01110011
61,00111101,93,01011101,154,10011010
119,01110111,99,01100011,218,11011010
44,00101100,39,00100111,83,01010011
15,00001111,114,01110010,129,10000001
77,01001101,79,01001111,156,10011100
107,01101011,93,01011101,200,11001000
7,00000111,61,00111101,68,01000100
107,01101011,62,00111110,169,10101001
9,00001001,85,01010101,94,01011110
53,00110101,59,00111011,112,01110000
62,00111110,55,00110111,117,01110101
83,01010011,4,00000100,87,01010111
67,01000011,40,00101000,107,01101011
79,01001111,54,00110110,133,10000101
15,00001111,47,00101111,62,00111110
27,00011011,51,00110011,78,01001110
89,01011001,50,00110010,139,10001011
53,00110101,117,01110101,170,10101010
8,00001000,100,01100100,108,01101100
67,01000011,93,01011101,160,10100000
64,01000000,37,00100101,101,01100101
17,00010001,45,00101101,62,00111110
56,00111000,58,00111010,114,01110010
28,00011100,51,00110011,79,01001111
78,01001110,33,00100001,111,01101111
31,00011111,110,01101110,141,10001101
110,01101110,98,01100010,208,11010000
26,00011010,122,01111010,148,10010100
120,01111000,91,01011011,211,11010011
109,01101101,0,00000000,109,01101101
118,01110110,27,00011011,145,10010001
124,01111100,101,01100101,225,11100001
35,00100011,86,01010110,121,01111001
64,01000000,103,01100111,167,10100111
94,01011110,21,00010101,115,01110011
74,01001010,3,00000011,77,01001101
124,01111100,27,00011011,151,10010111
31,00011111,84,01010100,115,01110011
102,01100110,100,01100100,202,11001010
127,01111111,109,01101101,236,11101100
84,01010100,29,00011101,113,01110001
13,00001101,117,01110101,130,10000010
77,01001101,58,00111010,135,10000111
38,00100110,64,01000000,102,01100110
44,00101100,66,01000010,110,01101110
34,00100010,28,00011100,62,00111110
96,01100000,99,01100011,195,11000011
6,00000110,31,00011111,37,00100101
116,01110100,0,00000000,116,01110100
74,01001010,84,01010100,158,10011110
61,00111101,97,01100001,158,10011110
93,01011101,71,01000111,164,10100100
53,00110101,22,00010110,75,01001011
91,01011011,47,00101111,138,10001010
34,00100010,12,00001100,46,00101110
69,01000101,97,01100001,166,10100110
70,01000110,53,00110101,123,01111011
92,01011100,114,01110010,206,11001110
50,00110010,105,01101001,155,10011011
78,01001110,107,01101011,185,10111001
59,00111011,65,01000001,124,01111100
60,00111100,96,01100000,156,10011100
21,00010101,32,00100000,53,00110101
30,00011110,87,01010111,117,01110101
90,01011010,47,00101111,137,10001001
31,00011111,126,01111110,157,10011101
127,01111111,71,01000111,198,11000110
17,00010001,9,00001001,26,00011010
116,01110100,21,00010101,137,10001001
20,00010100,60,00111100,80,01010000
27,00011011,7,00000111,34,00100010
56,00111000,109,01101101,165,10100101
100,01100100,91,01011011,191,10111111
102,01100110,11,00001011,113,01110001
92,01011100,62,00111110,154,10011010
1,00000001,29,00011101,30,00011110
12,00001100,61,00111101,73,01001001
11,00001011,61,00111101,72,01001000
52,00110100,116,01110100,168,10101000
85,01010101,42,00101010,127,01111111
11,00001011,84,01010100,95,01011111
57,00111001,22,00010110,79,01001111
44,00101100,106,01101010,150,10010110
39,00100111,120,01111000,159,10011111
49,00110001,52,00110100,101,01100101
61,00111101,0,00000000,61,00111101
89,01011001,3,00000011,92,01011100
125,01111101,60,00111100,185,10111001
26,00011010,9,00001001,35,00100011
93,01011101,8,00001000,101,01100101
45,00101101,57,00111001,102,01100110
89,01011001,99,01100011,188,10111100
120,01111000,6,00000110,126,01111110
41,00101001,83,01010011,124,01111100
14,00001110,85,01010101,99,01100011
21,00010101,76,01001100,97,01100001
37,00100101,11,00001011,48,00110000
123,01111011,113,01110001,236,11101100
72,01001000,122,01111010,194,11000010
113,01110001,23,00010111,136,10001000
60,00111100,127,01111111,187,10111011
23,00010111,107,01101011,130,10000010
54,00110110,100,01100100,154,10011010
25,00011001,107,01101011,132,10000100
59,00111011,69,01000101,128,10000000
34,00100010,58,00111010,92,01011100
62,00111110,66,01000010,128,10000000
124,01111100,85,01010101,209,11010001
12,00001100,48,00110000,60,00111100
92,01011100,64,01000000,156,10011100
35,00100011,64,01000000,99,01100011
99,01100011,109,01101101,208,11010000
116,01110100,70,01000110,186,10111010
68,01000100,78,01001110,146,10010010
8,00001000,62,00111110,70,01000110
45,00101101,34,00100010,79,01001111
45,00101101,84,01010100,129,10000001
5,00000101,81,01010001,86,01010110
105,01101001,49,00110001,154,10011010
14,00001110,21,00010101,35,00100011
26,00011010,10,00001010,36,00100100
64,01000000,17,00010001,81,01010001
24,00011000,111,01101111,135,10000111
14,00001110,64,01000000,78,01001110
79,01001111,5,00000101,84,01010100
94,01011110,20,00010100,114,01110010
112,01110000,7,00000111,119,01110111
77,01001101,82,01010010,159,10011111
36,00100100,83,01010011,119,01110111
53,00110101,1,00000001,54,00110110
60,00111100,79,01001111,139,10001011
78,01001110,49,00110001,127,01111111
118,01110110,31,00011111,149,10010101
60,00111100,47,00101111,107,01101011
98,01100010,52,00110100,150,10010110
116,01110100,54,00110110,170,10101010
72,01001000,116,01110100,188,10111100
70,01000110,101,01100101,171,10101011
68,01000100,84,01010100,152,10011000
6,00000110,80,01010000,86,01010110
44,00101100,77,01001101,121,01111001
38,00100110,40,00101000,78,01001110
49,00110001,72,01001000,121,01111001
7,00000111,23,00010111,30,00011110
6,00000110,115,01110011,121,01111001
24,00011000,114,01110010,138,10001010
44,00101100,65,01000001,109,01101101
122,01111010,38,00100110,160,10100000
45,00101101,45,00101101,90,01011010
42,00101010,113,01110001,155,10011011
85,01010101,116,01110100,201,11001001
44,00101100,19,00010011,63,00111111
118,01110110,126,01111110,244,11110100
30,00011110,97,01100001,127,01111111
113,01110001,49,00110001,162,10100010
22,00010110,20,00010100,42,00101010
124,01111100,22,00010110,146,10010010
61,00111101,72,01001000,133,10000101
125,01111101,95,01011111,220,11011100
63,00111111,119,01110111,182,10110110
21,00010101,1,00000001,22,00010110
75,01001011,109,01101101,184,10111000
88,01011000,23,00010111,111,01101111
50,00110010,123,01111011,173,10101101
0,00000000,92,01011100,92,01011100
0,00000000,85,01010101,85,01010101
28,00011100,59,00111011,87,01010111
26,00011010,24,00011000,50,00110010
49,00110001,59,00111011,108,01101100
75,01001011,72,01001000,147,10010011
98,01100010,21,00010101,119,01110111
10,00001010,96,01100000,106,01101010
11,00001011,85,01010101,96,01100000
25,00011001,14,00001110,39,00100111
31,00011111,27,00011011,58,00111010
8,00001000,57,00111001,65,01000001
97,01100001,9,00001001,106,01101010
106,01101010,42,00101010,148,10010100
63,00111111,58,00111010,121,01111001
123,01111011,85,01010101,208,11010000
32,00100000,36,00100100,68,01000100
64,01000000,82,01010010,146,10010010
95,01011111,76,01001100,171,10101011
120,01111000,37,00100101,157,10011101
121,01111001,102,01100110,223,11011111
113,01110001,51,00110011,164,10100100
96,01100000,104,01101000,200,11001000
45,00101101,82,01010010,127,01111111
12,00001100,43,00101011,55,00110111
84,01010100,4,00000100,88,01011000
65,01000001,107,01101011,172,10101100
71,01000111,92,01011100,163,10100011
75,01001011,29,00011101,104,01101000
23,00010111,85,01010101,108,01101100
95,01011111,73,01001001,168,10101000
99,01100011,41,00101001,140,10001100
5,00000101,45,00101101,50,00110010
92,01011100,115,01110011,207,11001111
36,00100100,92,01011100,128,10000000
9,00001001,5,00000101,14,00001110
44,00101100,41,00101001,85,01010101
1,00000001,104,01101000,105,01101001
119,01110111,65,01000001,184,10111000
64,01000000,3,00000011,67,01000011
99,01100011,121,01111001,220,11011100
91,01011011,21,00010101,112,01110000
84,01010100,96,01100000,180,10110100
56,00111000,0,00000000,56,00111000
63,00111111,74,01001010,137,10001001
51,00110011,27,00011011,78,01001110
8,00001000,50,00110010,58,00111010
26,00011010,69,01000101,95,01011111
63,00111111,13,00001101,76,01001100
21,00010101,59,00111011,80,01010000
27,00011011,30,00011110,57,00111001
62,00111110,62,00111110,124,01111100
126,01111110,12,00001100,138,10001010
17,00010001,113,01110001,130,10000010
46,00101110,50,00110010,96,01100000
19,00010011,74,01001010,93,01011101
97,01100001,84,01010100,181,10110101
54,00110110,122,01111010,176,10110000
73,01001001,108,01101100,181,10110101
56,00111000,125,01111101,181,10110101
104,01101000,47,00101111,151,10010111
20,00010100,55,00110111,75,01001011
94,01011110,83,01010011,177,10110001
21,00010101,87,01010111,108,01101100
120,01111000,77,01001101,197,11000101
65,01000001,34,00100010,99,01100011
9,00001001,70,01000110,79,01001111
109,01101101,25,00011001,134,10000110
125,01111101,54,00110110,179,10110011
87,01010111,67,01000011,154,10011010
113,01110001,121,01111001,234,11101010
122,01111010,88,01011000,210,11010010
98,01100010,87,01010111,185,10111001
89,01011001,86,01010110,175,10101111
112,01110000,11,00001011,123,01111011
120,01111000,116,01110100,236,11101100
110,01101110,26,00011010,136,10001000
77,01001101,112,01110000,189,10111101
45,00101101,127,01111111,172,10101100
121,01111001,50,00110010,171,10101011
40,00101000,22,00010110,62,00111110
120,01111000,13,00001101,133,10000101
102,01100110,122,01111010,224,11100000
117,01110101,89,01011001,206,11001110
34,00100010,104,01101000,138,10001010
70,01000110,1,00000001,71,01000111
81,01010001,90,01011010,171,10101011
118,01110110,86,01010110,204,11001100
99,01100011,123,01111011,222,11011110
64,01000000,99,01100011,163,10100011
47,00101111,46,00101110,93,01011101
10,00001010,22,00010110,32,00100000
93,01011101,41,00101001,134,10000110
109,01101101,63,00111111,172,10101100
4,00000100,103,01100111,107,01101011
116,01110100,91,01011011,207,11001111
101,01100101,120,01111000,221,11011101
37,00100101,43,00101011,80,01010000
10,00001010,50,00110010,60,00111100
62,00111110,0,00000000,62,00111110
51,00110011,71,01000111,122,01111010
47,00101111,104,01101000,151,10010111
77,01001101,7,00000111,84,01010100
92,01011100,78,01001110,170,10101010
124,01111100,19,00010011,143,10001111
109,01101101,18,00010010,127,01111111
72,01001000,51,00110011,123,01111011
51,00110011,85,01010101,136,10001000
49,00110001,106,01101010,155,10011011
105,01101001,4,00000100,109,01101101
52,00110100,26,00011010,78,01001110
77,01001101,101,01100101,178,10110010
111,01101111,38,00100110,149,10010101
1,00000001,2,00000010,3,00000011
113,01110001,71,01000111,184,10111000
12,00001100,71,01000111,83,01010011
30,00011110,10,00001010,40,00101000
116,01110100,25,00011001,141,10001101
49,00110001,115,01110011,164,10100100
121,01111001,107,01101011,228,11100100
110,01101110,26,00011010,136,10001000
98,01100010,49,00110001,147,10010011
46,00101110,57,00111001,103,01100111
75,01001011,2,00000010,77,01001101
73,01001001,121,01111001,194,11000010
68,01000100,37,00100101,105,01101001
50,00110010,92,01011100,142,10001110
79,01001111,20,00010100,99,01100011
65,01000001,66,01000010,131,10000011
118,01110110,69,01000101,187,10111011
102,01100110,33,00100001,135,10000111
105,01101001,78,01001110,183,10110111
105,01101001,112,01110000,217,11011001
12,00001100,44,00101100,56,00111000
86,01010110,40,00101000,126,01111110
4,00000100,11,00001011,15,00001111
40,00101000,13,00001101,53,00110101
125,01111101,49,00110001,174,10101110
8,00001000,81,01010001,89,01011001
22,00010110,120,01111000,142,10001110
72,01001000,47,00101111,119,01110111
49,00110001,79,01001111,128,10000000
117,01110101,32,00100000,149,10010101
22,00010110,121,01111001,143,10001111
96,01100000,119,01110111,215,11010111
42,00101010,46,00101110,88,01011000
91,01011011,0,00000000,91,01011011
53,00110101,42,00101010,95,01011111
95,01011111,10,00001010,105,01101001
6,00000110,66,01000010,72,01001000
48,00110000,76,01001100,124,01111100
119,01110111,102,01100110,221,11011101
53,00110101,63,00111111,116,01110100
93,01011101,10,00001010,103,01100111
125,01111101,111,01101111,236,11101100
93,01011101,111,01101111,204,11001100
104,01101000,49,00110001,153,10011001
59,00111011,60,00111100,119,01110111
65,01000001,41,00101001,106,01101010
64,01000000,125,01111101,189,10111101
126,01111110,100,01100100,226,11100010
114,01110010,68,01000100,182,10110110
0,00000000,20,00010100,20,00010100
74,01001010,74,01001010,148,10010100
120,01111000,122,01111010,242,11110010
53,00110101,42,00101010,95,01011111
99,01100011,26,00011010,125,01111101
98,01100010,77,01001101,175,10101111
40,00101000,125,01111101,165,10100101
29,00011101,119,01110111,148,10010100
98,01100010,11,00001011,109,01101101
28,00011100,34,00100010,62,00111110
7,00000111,106,01101010,113,01110001
14,00001110,36,00100100,50,00110010
107,01101011,5,00000101,112,01110000
46,00101110,30,00011110,76,01001100
22,00010110,11,00001011,33,00100001
52,00110100,97,01100001,149,10010101
95,01011111,52,00110100,147,10010011
33,00100001,108,01101100,141,10001101
117,01110101,31,00011111,148,10010100
79,01001111,8,00001000,87,01010111
123,01111011,56,00111000,179,10110011
123,01111011,44,00101100,167,10100111
82,01010010,96,01100000,178,10110010
10,00001010,21,00010101,31,00011111
36,00100100,15,00001111,51,00110011
101,01100101,98,01100010,199,11000111
55,00110111,74,01001010,129,10000001
32,00100000,44,00101100,76,01001100
69,01000101,106,01101010,175,10101111
71,01000111,1,00000001,72,01001000
93,01011101,82,01010010,175,10101111
20,00010100,51,00110011,71,01000111
82,01010010,100,01100100,182,10110110
43,00101011,27,00011011,70,01000110
13,00001101,107,01101011,120,01111000
61,00111101,72,01001000,133,10000101
48,00110000,42,00101010,90,01011010
70,01000110,23,00010111,93,01011101
119,01110111,77,01001101,196,11000100
53,00110101,94,01011110,147,10010011
121,01111001,86,01010110,207,11001111
119,01110111,86,01010110,205,11001101
18,00010010,114,01110010,132,10000100
126,01111110,9,00001001,135,10000111
55,00110111,16,00010000,71,01000111
7,00000111,24,00011000,31,00011111
113,01110001,1,00000001,114,01110010
68,01000100,44,00101100,112,01110000
61,00111101,52,00110100,113,01110001
85,01010101,7,00000111,92,01011100
68,01000100,127,01111111,195,11000011
37,00100101,127,01111111,164,10100100
111,01101111,72,01001000,183,10110111
107,01101011,15,00001111,122,01111010
60,00111100,26,00011010,86,01010110
9,00001001,65,01000001,74,01001010
31,00011111,2,00000010,33,00100001
127,01111111,23,00010111,150,10010110
114,01110010,55,00110111,169,10101001
12,00001100,86,01010110,98,01100010
86,01010110,99,01100011,185,10111001
68,01000100,12,00001100,80,01010000
33,00100001,9,00001001,42,00101010
83,01010011,44,00101100,127,01111111
38,00100110,30,00011110,68,01000100
42,00101010,44,00101100,86,01010110
127,01111111,72,01001000,199,11000111
29,00011101,41,00101001,70,01000110
19,00010011,81,01010001,100,01100100
105,01101001,85,01010101,190,10111110
25,00011001,79,01001111,104,01101000
106,01101010,87,01010111,193,11000001
0,00000000,40,00101000,40,00101000
114,01110010,91,01011011,205,11001101
92,01011100,121,01111001,213,11010101
89,01011001,32,00100000,121,01111001
43,00101011,48,00110000,91,01011011
59,00111011,7,00000111,66,01000010
108,01101100,127,01111111,235,11101011
98,01100010,31,00011111,129,10000001
39,00100111,90,01011010,129,10000001
57,00111001,84,01010100,141,10001101
79,01001111,81,01010001,160,10100000
110,01101110,106,01101010,216,11011000
78,01001110,115,01110011,193,11000001
83,01010011,78,01001110,161,10100001
70,01000110,10,00001010,80,01010000
39,00100111,16,00010000,55,00110111
70,01000110,85,01010101,155,10011011
21,00010101,6,00000110,27,00011011
15,00001111,116,01110100,131,10000011
65,01000001,25,00011001,90,01011010
16,00010000,63,00111111,79,01001111
65,01000001,52,00110100,117,01110101
15,00001111,74,01001010,89,01011001
66,01000010,80,01010000,146,10010010
92,01011100,43,00101011,135,10000111
93,01011101,58,00111010,151,10010111
67,01000011,8,00001000,75,01001011
56,00111000,17,00010001,73,01001001
36,00100100,63,00111111,99,01100011
105,01101001,13,00001101,118,01110110
72,01001000,26,00011010,98,01100010
0,00000000,84,01010100,84,01010100
14,00001110,42,00101010,56,00111000
48,00110000,54,00110110,102,01100110
82,01010010,43,00101011,125,01111101
97,01100001,95,01011111,192,11000000
42,00101010,64,01000000,106,01101010
70,01000110,88,01011000,158,10011110
77,01001101,87,01010111,164,10100100
12,00001100,117,01110101,129,10000001
52,00110100,55,00110111,107,01101011
50,00110010,96,01100000,146,10010010
21,00010101,72,01001000,93,01011101
67,01000011,61,00111101,128,10000000
50,00110010,123,01111011,173,10101101
122,01111010,52,00110100,174,10101110
43,00101011,101,01100101,144,10010000
36,00100100,100,01100100,136,10001000
64,01000000,38,00100110,102,01100110
19,00010011,83,01010011,102,01100110
47,00101111,48,00110000,95,01011111
76,01001100,19,00010011,95,01011111
42,00101010,101,01100101,143,10001111
87,01010111,63,00111111,150,10010110
96,01100000,82,01010010,178,10110010
43,00101011,96,01100000,139,10001011
82,01010010,11,00001011,93,01011101
48,00110000,110,01101110,158,10011110
107,01101011,45,00101101,152,10011000
99,01100011,38,00100110,137,10001001
31,00011111,44,00101100,75,01001011
57,00111001,99,01100011,156,10011100
31,00011111,51,00110011,82,01010010
25,00011001,64,01000000,89,01011001
63,00111111,37,00100101,100,01100100
73,01001001,44,00101100,117,01110101
74,01001010,22,00010110,96,01100000
121,01111001,65,01000001,186,10111010
32,00100000,43,00101011,75,01001011
11,00001011,103,01100111,114,01110010
21,00010101,123,01111011,144,10010000
33,00100001,58,00111010,91,01011011
33,00100001,46,00101110,79,01001111
9,00001001,17,00010001,26,00011010
83,01010011,17,00010001,100,01100100
82,01010010,44,00101100,126,01111110
68,01000100,125,01111101,193,11000001
98,01100010,61,00111101,159,10011111
107,01101011,97,01100001,204,11001100
68,01000100,40,00101000,108,01101100
101,01100101,55,00110111,156,10011100
55,00110111,86,01010110,141,10001101
14,00001110,39,00100111,53,00110101
78,01001110,9,00001001,87,01010111
12,00001100,12,00001100,24,00011000
127,01111111,44,00101100,171,10101011
96,01100000,51,00110011,147,10010011
68,01000100,24,00011000,92,01011100
109,01101101,35,00100011,144,10010000
24,00011000,1,00000001,25,00011001
72,01001000,67,01000011,139,10001011
16,00010000,39,00100111,55,00110111
68,01000100,72,01001000,140,10001100
55,00110111,85,01010101,140,10001100
113,01110001,67,01000011,180,10110100
115,01110011,83,01010011,198,11000110
34,00100010,38,00100110,72,01001000
57,00111001,109,01101101,166,10100110
70,01000110,112,01110000,182,10110110
118,01110110,116,01110100,234,11101010
44,00101100,35,00100011,79,01001111
114,01110010,0,00000000,114,01110010
4,00000100,115,01110011,119,01110111
64,01000000,20,00010100,84,01010100
106,01101010,23,00010111,129,10000001
32,00100000,91,01011011,123,01111011
76,01001100,87,01010111,163,10100011
1,00000001,92,01011100,93,01011101
124,01111100,13,00001101,137,10001001
96,01100000,39,00100111,135,10000111
34,00100010,39,00100111,73,01001001
64,01000000,54,00110110,118,01110110
54,00110110,10,00001010,64,01000000
107,01101011,74,01001010,181,10110101
92,01011100,42,00101010,134,10000110
10,00001010,124,01111100,134,10000110
50,00110010,114,01110010,164,10100100
55,00110111,124,01111100,179,10110011
20,00010100,43,00101011,63,00111111
126,01111110,61,00111101,187,10111011
72,01001000,65,01000001,137,10001001
3,00000011,120,01111000,123,01111011
2,00000010,22,00010110,24,00011000
51,00110011,40,00101000,91,01011011
48,00110000,118,01110110,166,10100110
46,00101110,25,00011001,71,01000111
2,00000010,123,01111011,125,01111101
111,01101111,88,01011000,199,11000111
116,01110100,109,01101101,225,11100001
31,00011111,21,00010101,52,00110100
88,01011000,94,01011110,182,10110110
1,00000001,66,01000010,67,01000011
101,01100101,83,01010011,184,10111000
75,01001011,6,00000110,81,01010001
121,01111001,3,00000011,124,01111100
88,01011000,115,01110011,203,11001011
1,00000001,45,00101101,46,00101110
78,01001110,7,00000111,85,01010101
65,01000001,59,00111011,124,01111100
107,01101011,74,01001010,181,10110101
42,00101010,68,01000100,110,01101110
124,01111100,24,00011000,148,10010100
87,01010111,56,00111000,143,10001111
63,00111111,126,01111110,189,10111101
52,00110100,44,00101100,96,01100000
89,01011001,47,00101111,136,10001000
60,00111100,102,01100110,162,10100010
4,00000100,86,01010110,90,01011010
95,01011111,102,01100110,197,11000101
47,00101111,93,01011101,140,10001100
10,00001010,99,01100011,109,01101101
53,00110101,116,01110100,169,10101001
5,00000101,7,00000111,12,00001100
22,00010110,107,01101011,129,10000001
2,00000010,33,00100001,35,00100011
121,01111001,54,00110110,175,10101111
77,01001101,28,00011100,105,01101001
37,00100101,120,01111000,157,10011101
23,00010111,6,00000110,29,00011101
56,00111000,24,00011000,80,01010000
41,00101001,67,01000011,108,01101100
102,01100110,93,01011101,195,11000011
105,01101001,56,00111000,161,10100001
59,00111011,5,00000101,64,01000000
74,01001010,125,01111101,199,11000111
14,00001110,100,01100100,114,01110010
107,01101011,72,01001000,179,10110011
85,01010101,105,01101001,190,10111110
11,00001011,29,00011101,40,00101000
40,00101000,24,00011000,64,01000000
59,00111011,28,00011100,87,01010111
39,00100111,46,00101110,85,01010101
95,01011111,107,01101011,202,11001010
72,01001000,88,01011000,160,10100000
48,00110000,80,01010000,128,10000000
11,00001011,25,00011001,36,00100100
95,01011111,16,00010000,111,01101111
79,01001111,114,01110010,193,11000001
99,01100011,26,00011010,125,01111101
72,01001000,114,01110010,186,10111010
85,01010101,42,00101010,127,01111111
8,00001000,95,01011111,103,01100111
26,00011010,85,01010101,111,01101111
81,01010001,121,01111001,202,11001010
66,01000010,12,00001100,78,01001110
21,00010101,118,01110110,139,10001011
117,01110101,102,01100110,219,11011011
26,00011010,112,01110000,138,10001010
92,01011100,65,01000001,157,10011101
41,00101001,6,00000110,47,00101111
124,01111100,101,01100101,225,11100001
4,00000100,19,00010011,23,00010111
24,00011000,48,00110000,72,01001000
75,01001011,30,00011110,105,01101001
101,01100101,18,00010010,119,01110111
111,01101111,127,01111111,238,11101110
109,01101101,105,01101001,214,11010110
119,01110111,100,01100100,219,11011011
38,00100110,95,01011111,133,10000101
122,01111010,45,00101101,167,10100111
127,01111111,22,00010110,149,10010101
4,00000100,110,01101110,114,01110010
114,01110010,62,00111110,176,10110000
83,01010011,5,00000101,88,01011000
126,01111110,63,00111111,189,10111101
29,00011101,12,00001100,41,00101001
31,00011111,114,01110010,145,10010001
74,01001010,98,01100010,172,10101100
55,00110111,85,01010101,140,10001100
26,00011010,11,00001011,37,00100101
91,01011011,78,01001110,169,10101001
109,01101101,105,01101001,214,11010110
100,01100100,106,01101010,206,11001110
0,00000000,102,01100110,102,01100110
56,00111000,59,00111011,115,01110011
24,00011000,5,00000101,29,00011101
72,01001000,29,00011101,101,01100101
15,00001111,9,00001001,24,00011000
117,01110101,16,00010000,133,10000101
36,00100100,51,00110011,87,01010111
25,00011001,45,00101101,70,01000110
19,00010011,122,01111010,141,10001101
20,00010100,58,00111010,78,01001110
109,01101101,58,00111010,167,10100111
75,01001011,96,01100000,171,10101011
45,00101101,30,00011110,75,01001011
63,00111111,47,00101111,110,01101110
43,00101011,32,00100000,75,01001011
83,01010011,81,01010001,164,10100100
115,01110011,58,00111010,173,10101101
41,00101001,32,00100000,73,01001001
43,00101011,18,00010010,61,00111101
104,01101000,80,01010000,184,10111000
108,01101100,123,01111011,231,11100111
3,00000011,75,01001011,78,01001110
68,01000100,120,01111000,188,10111100
4,00000100,85,01010101,89,01011001
94,01011110,15,00001111,109,01101101
121,01111001,14,00001110,135,10000111
60,00111100,15,00001111,75,01001011
35,00100011,58,00111010,93,01011101
1,00000001,95,01011111,96,01100000
76,01001100,6,00000110,82,01010010
106,01101010,26,00011010,132,10000100
10,00001010,24,00011000,34,00100010
65,01000001,82,01010010,147,10010011
83,01010011,23,00010111,106,01101010
114,01110010,106,01101010,220,11011100
106,01101010,1,00000001,107,01101011
106,01101010,100,01100100,206,11001110
22,00010110,95,01011111,117,01110101
99,01100011,94,01011110,193,11000001
78,01001110,41,00101001,119,01110111
8,00001000,73,01001001,81,01010001
98,01100010,111,01101111,209,11010001
89,01011001,109,01101101,198,11000110
94,01011110,120,01111000,214,11010110
125,01111101,26,00011010,151,10010111
61,00111101,119,01110111,180,10110100
20,00010100,12,00001100,32,00100000
96,01100000,93,01011101,189,10111101
46,00101110,77,01001101,123,01111011
5,00000101,54,00110110,59,00111011
127,01111111,13,00001101,140,10001100
39,00100111,14,00001110,53,00110101
74,01001010,27,00011011,101,01100101
55,00110111,108,01101100,163,10100011
94,01011110,110,01101110,204,11001100
77,01001101,65,01000001,142,10001110
87,01010111,96,01100000,183,10110111
63,00111111,11,00001011,74,01001010
2,00000010,26,00011010,28,00011100
95,01011111,32,00100000,127,01111111
64,01000000,126,01111110,190,10111110
123,01111011,64,01000000,187,10111011
89,01011001,99,01100011,188,10111100
127,01111111,94,01011110,221,11011101
45,00101101,85,01010101,130,10000010
43,00101011,110,01101110,153,10011001
67,01000011,101,01100101,168,10101000
82,01010010,111,01101111,193,11000001
114,01110010,64,01000000,178,10110010
106,01101010,31,00011111,137,10001001
103,01100111,81,01010001,184,10111000
112,01110000,79,01001111,191,10111111
110,01101110,110,01101110,220,11011100
58,00111010,98,01100010,156,10011100
2,00000010,125,01111101,127,01111111
94,01011110,122,01111010,216,11011000
83,01010011,107,01101011,190,10111110
97,01100001,25,00011001,122,01111010
33,00100001,33,00100001,66,01000010
75,01001011,4,00000100,79,01001111
56,00111000,55,00110111,111,01101111
114,01110010,36,00100100,150,10010110
99,01100011,0,00000000,99,01100011
119,01110111,112,01110000,231,11100111
52,00110100,91,01011011,143,10001111
62,00111110,64,01000000,126,01111110
56,00111000,96,01100000,152,10011000
97,01100001,99,01100011,196,11000100
70,01000110,41,00101001,111,01101111
70,01000110,70,01000110,140,10001100
52,00110100,7,00000111,59,00111011
32,00100000,23,00010111,55,00110111
24,00011000,6,00000110,30,00011110
114,01110010,69,01000101,183,10110111
35,00100011,100,01100100,135,10000111
31,00011111,33,00100001,64,01000000
77,01001101,43,00101011,120,01111000
52,00110100,117,01110101,169,10101001
81,01010001,114,01110010,195,11000011
105,01101001,45,00101101,150,10010110
91,01011011,60,00111100,151,10010111
63,00111111,2,00000010,65,01000001
47,00101111,123,01111011,170,10101010
31,00011111,78,01001110,109,01101101
13,00001101,123,01111011,136,10001000
82,01010010,9,00001001,91,01011011
88,01011000,55,00110111,143,10001111
65,01000001,37,00100101,102,01100110
56,00111000,98,01100010,154,10011010
89,01011001,121,01111001,210,11010010
16,00010000,117,01110101,133,10000101
34,00100010,90,01011010,124,01111100
93,01011101,75,01001011,168,10101000
87,01010111,1,00000001,88,01011000
24,00011000,56,00111000,80,01010000
28,00011100,49,00110001,77,01001101
64,01000000,76,01001100,140,10001100
112,01110000,44,00101100,156,10011100
42,00101010,93,01011101,135,10000111
51,00110011,94,01011110,145,10010001
94,01011110,94,01011110,188,10111100
8,00001000,90,01011010,98,01100010
40,00101000,22,00010110,62,00111110
46,00101110,13,00001101,59,00111011
2,00000010,88,01011000,90,01011010
103,01100111,66,01000010,169,10101001
47,00101111,70,01000110,117,01110101
37,00100101,13,00001101,50,00110010
116,01110100,77,01001101,193,11000001
51,00110011,16,00010000,67,01000011
57,00111001,28,00011100,85,01010101
85,01010101,0,00000000,85,01010101
77,01001101,111,01101111,188,10111100
53,00110101,62,00111110,115,01110011
77,01001101,99,01100011,176,10110000
21,00010101,88,01011000,109,01101101
124,01111100,53,00110101,177,10110001
55,00110111,62,00111110,117,01110101
71,01000111,77,01001101,148,10010100
9,00001001,18,00010010,27,00011011
6,00000110,71,01000111,77,01001101
77,01001101,100,01100100,177,10110001
103,01100111,46,00101110,149,10010101
119,01110111,43,00101011,162,10100010
20,00010100,77,01001101,97,01100001
117,01110101,34,00100010,151,10010111
26,00011010,11,00001011,37,00100101
125,01111101,49,00110001,174,10101110
75,01001011,22,00010110,97,01100001
10,00001010,65,01000001,75,01001011
3,00000011,113,01110001,116,01110100
79,01001111,116,01110100,195,11000011
68,01000100,28,00011100,96,01100000
9,00001001,67,01000011,76,01001100
12,00001100,50,00110010,62,00111110
32,00100000,57,00111001,89,01011001
68,01000100,33,00100001,101,01100101
1,00000001,11,00001011,12,00001100
23,00010111,43,00101011,66,01000010
63,00111111,60,00111100,123,01111011
107,01101011,108,01101100,215,11010111
67,01000011,81,01010001,148,10010100
89,01011001,23,00010111,112,01110000
50,00110010,24,00011000,74,01001010
90,01011010,118,01110110,208,11010000
11,00001011,34,00100010,45,00101101
39,00100111,85,01010101,124,01111100
87,01010111,7,00000111,94,01011110
10,00001010,69,01000101,79,01001111
117,01110101,120,01111000,237,11101101
57,00111001,73,01001001,130,10000010
57,00111001,43,00101011,100,01100100
54,00110110,70,01000110,124,01111100
11,00001011,117,01110101,128,10000000
105,01101001,0,00000000,105,01101001
20,00010100,20,00010100,40,00101000
92,01011100,5,00000101,97,01100001
15,00001111,67,01000011,82,01010010
33,00100001,96,01100000,129,10000001
58,00111010,40,00101000,98,01100010
89,01011001,16,00010000,105,01101001
16,00010000,114,01110010,130,10000010
50,00110010,67,01000011,117,01110101
37,00100101,123,01111011,160,10100000
16,00010000,4,00000100,20,00010100
120,01111000,93,01011101,213,11010101
27,00011011,38,00100110,65,01000001
110,01101110,95,01011111,205,11001101
21,00010101,60,00111100,81,01010001
33,00100001,6,00000110,39,00100111
119,01110111,60,00111100,179,10110011
36,00100100,68,01000100,104,01101000
34,00100010,58,00111010,92,01011100
52,00110100,19,00010011,71,01000111
28,00011100,28,00011100,56,00111000
55,00110111,125,01111101,180,10110100
14,00001110,87,01010111,101,01100101
56,00111000,38,00100110,94,01011110
44,00101100,126,01111110,170,10101010
83,01010011,49,00110001,132,10000100
111,01101111,74,01001010,185,10111001
90,01011010,47,00101111,137,10001001
125,01111101,72,01001000,197,11000101
77,01001101,54,00110110,131,10000011
28,00011100,36,00100100,64,01000000
20,00010100,50,00110010,70,01000110
116,01110100,33,00100001,149,10010101
12,00001100,122,01111010,134,10000110
59,00111011,113,01110001,172,10101100
85,01010101,114,01110010,199,11000111
80,01010000,21,00010101,101,01100101
61,00111101,64,01000000,125,01111101
70,01000110,33,00100001,103,01100111
71,01000111,50,00110010,121,01111001
21,00010101,21,00010101,42,00101010
86,01010110,25,00011001,111,01101111
37,00100101,99,01100011,136,10001000
44,00101100,49,00110001,93,01011101
4,00000100,20,00010100,24,00011000
118,01110110,120,01111000,238,11101110
32,00100000,20,00010100,52,00110100
19,00010011,74,01001010,93,01011101
2,00000010,105,01101001,107,01101011
115,01110011,27,00011011,142,10001110
117,01110101,108,01101100,225,11100001
61,00111101,112,01110000,173,10101101
41,00101001,107,01101011,148,10010100
30,00011110,115,01110011,145,10010001
93,01011101,31,00011111,124,01111100
83,01010011,46,00101110,129,10000001
56,00111000,25,00011001,81,01010001
100,01100100,64,01000000,164,10100100
32,00100000,48,00110000,80,01010000
80,01010000,5,00000101,85,01010101
90,01011010,102,01100110,192,11000000
73,01001001,93,01011101,166,10100110
17,00010001,42,00101010,59,00111011
106,01101010,94,01011110,200,11001000
89,01011001,89,01011001,178,10110010
123,01111011,105,01101001,228,11100100
93,01011101,123,01111011,216,11011000
5,00000101,71,01000111,76,01001100
119,01110111,94,01011110,213,11010101
25,00011001,1,00000001,26,00011010
45,00101101,30,00011110,75,01001011
72,01001000,107,01101011,179,10110011
10,00001010,6,00000110,16,00010000
109,01101101,57,00111001,166,10100110
56,00111000,18,00010010,74,01001010
9,00001001,71,01000111,80,01010000
18,00010010,99,01100011,117,01110101
83,01010011,78,01001110,161,10100001
70,01000110,95,01011111,165,10100101
6,00000110,56,00111000,62,00111110
75,01001011,15,00001111,90,01011010
5,00000101,95,01011111,100,01100100
36,00100100,55,00110111,91,01011011
54,00110110,28,00011100,82,01010010
66,01000010,94,01011110,160,10100000
126,01111110,2,00000010,128,10000000
109,01101101,116,01110100,225,11100001
9,00001001,32,00100000,41,00101001
118,01110110,43,00101011,161,10100001
85,01010101,20,00010100,105,01101001
92,01011100,30,00011110,122,01111010
91,01011011,107,01101011,198,11000110
47,00101111,2,00000010,49,00110001
83,01010011,126,01111110,209,11010001
108,01101100,67,01000011,175,10101111
9,00001001,4,00000100,13,00001101
109,01101101,106,01101010,215,11010111
111,01101111,37,00100101,148,10010100
18,00010010,2,00000010,20,00010100
1,00000001,54,00110110,55,00110111
70,01000110,19,00010011,89,01011001
83,01010011,92,01011100,175,10101111
50,00110010,23,00010111,73,01001001
81,01010001,31,00011111,112,01110000
102,01100110,17,00010001,119,01110111
43,00101011,2,00000010,45,00101101
42,00101010,91,01011011,133,10000101
38,00100110,88,01011000,126,01111110
5,00000101,26,00011010,31,00011111
61,00111101,21,00010101,82,01010010
75,01001011,110,01101110,185,10111001
78,01001110,90,01011010,168,10101000
45,00101101,2,00000010,47,00101111
35,00100011,13,00001101,48,00110000
43,00101011,126,01111110,169,10101001
8,00001000,87,01010111,95,01011111
123,01111011,97,01100001,220,11011100
99,01100011,8,00001000,107,01101011
27,00011011,20,00010100,47,00101111
9,00001001,93,01011101,102,01100110
61,00111101,32,00100000,93,01011101
85,01010101,6,00000110,91,01011011
48,00110000,69,01000101,117,01110101
124,01111100,67,01000011,191,10111111
90,01011010,9,00001001,99,01100011
90,01011010,117,01110101,207,11001111
74,01001010,54,00110110,128,10000000
70,01000110,7,00000111,77,01001101
52,00110100,48,00110000,100,01100100
15,00001111,22,00010110,37,00100101
28,00011100,49,00110001,77,01001101
49,00110001,99,01100011,148,10010100
111,01101111,21,00010101,132,10000100
98,01100010,86,01010110,184,10111000
76,01001100,116,01110100,192,11000000
17,00010001,73,01001001,90,01011010
59,00111011,113,01110001,172,10101100
33,00100001,106,01101010,139,10001011
5,00000101,119,01110111,124,01111100
74,01001010,56,00111000,130,10000010
124,01111100,14,00001110,138,10001010
26,00011010,115,01110011,141,10001101
110,01101110,22,00010110,132,10000100
102,01100110,15,00001111,117,01110101
72,01001000,63,00111111,135,10000111
69,01000101,108,01101100,177,10110001
122,01111010,92,01011100,214,11010110
63,00111111,61,00111101,124,01111100
24,00011000,111,01101111,135,10000111
17,00010001,24,00011000,41,00101001
96,01100000,32,00100000,128,10000000
107,01101011,9,00001001,116,01110100
12,00001100,40,00101000,52,00110100
65,01000001,80,01010000,145,10010001
30,00011110,89,01011001,119,01110111
0,00000000,0,00000000,0,00000000
49,00110001,42,00101010,91,01011011
127,01111111,81,01010001,208,11010000
38,00100110,90,01011010,128,10000000
54,00110110,10,00001010,64,01000000
96,01100000,36,00100100,132,10000100
98,01100010,27,00011011,125,01111101
81,01010001,5,00000101,86,01010110
14,00001110,113,01110001,127,01111111
6,00000110,44,00101100,50,00110010
36,00100100,1,00000001,37,00100101
51,00110011,125,01111101,176,10110000
12,00001100,96,01100000,108,01101100
11,00001011,103,01100111,114,01110010
99,01100011,105,01101001,204,11001100
119,01110111,30,00011110,149,10010101
69,01000101,25,00011001,94,01011110
19,00010011,118,01110110,137,10001001
14,00001110,91,01011011,105,01101001
102,01100110,24,00011000,126,01111110
127,01111111,20,00010100,147,10010011
82,01010010,31,00011111,113,01110001
79,01001111,112,01110000,191,10111111
81,01010001,62,00111110,143,10001111
22,00010110,103,01100111,125,01111101
59,00111011,31,00011111,90,01011010
47,00101111,5,00000101,52,00110100
96,01100000,41,00101001,137,10001001
78,01001110,50,00110010,128,10000000
20,00010100,71,01000111,91,01011011
52,00110100,91,01011011,143,10001111
51,00110011,95,01011111,146,10010010
101,01100101,45,00101101,146,10010010
80,01010000,18,00010010,98,01100010
27,00011011,33,00100001,60,00111100
91,01011011,53,00110101,144,10010000
28,00011100,33,00100001,61,00111101
46,00101110,120,01111000,166,10100110
125,01111101,56,00111000,181,10110101
81,01010001,3,00000011,84,01010100
95,01011111,77,01001101,172,10101100
79,01001111,124,01111100,203,11001011
17,00010001,21,00010101,38,00100110
92,01011100,49,00110001,141,10001101
0,00000000,102,01100110,102,01100110
33,00100001,12,00001100,45,00101101
16,00010000,61,00111101,77,01001101
105,01101001,26,00011010,131,10000011
3,00000011,110,01101110,113,01110001
114,01110010,54,00110110,168,10101000
75,01001011,67,01000011,142,10001110
22,00010110,35,00100011,57,00111001
78,01001110,21,00010101,99,01100011
10,00001010,93,01011101,103,01100111
119,01110111,94,01011110,213,11010101
118,01110110,58,00111010,176,10110000
102,01100110,31,00011111,133,10000101
118,01110110,127,01111111,245,11110101
42,00101010,11,00001011,53,00110101
40,00101000,41,00101001,81,01010001
14,00001110,15,00001111,29,00011101
85,01010101,25,00011001,110,01101110
57,00111001,84,01010100,141,10001101
92,01011100,28,00011100,120,01111000
48,00110000,101,01100101,149,10010101
96,01100000,18,00010010,114,01110010
45,00101101,58,00111010,103,01100111
61,00111101,33,00100001,94,01011110
2,00000010,14,00001110,16,00010000
111,01101111,80,01010000,191,10111111
71,01000111,70,01000110,141,10001101
30,00011110,14,00001110,44,00101100
7,00000111,11,00001011,18,00010010
0,00000000,122,01111010,122,01111010
53,00110101,16,00010000,69,01000101
13,00001101,77,01001101,90,01011010
23,00010111,0,00000000,23,00010111
5,00000101,47,00101111,52,00110100
84,01010100,26,00011010,110,01101110
77,01001101,39,00100111,116,01110100
14,00001110,96,01100000,110,01101110
93,01011101,29,00011101,122,01111010
76,01001100,103,01100111,179,10110011
127,01111111,65,01000001,192,11000000
74,01001010,1,00000001,75,01001011
44,00101100,44,00101100,88,01011000
46,00101110,93,01011101,139,10001011
16,00010000,1,00000001,17,00010001
112,01110000,119,01110111,231,11100111
51,00110011,80,01010000,131,10000011
75,01001011,39,00100111,114,01110010
62,00111110,59,00111011,121,01111001
123,01111011,73,01001001,196,11000100
122,01111010,77,01001101,199,11000111
71,01000111,78,01001110,149,10010101
70,01000110,69,01000101,139,10001011
23,00010111,78,01001110,101,01100101
115,01110011,88,01011000,203,11001011
37,00100101,19,00010011,56,00111000
90,01011010,87,01010111,177,10110001
99,01100011,121,01111001,220,11011100
15,00001111,65,01000001,80,01010000
50,00110010,104,01101000,154,10011010
57,00111001,89,01011001,146,10010010
110,01101110,38,00100110,148,10010100
19,00010011,30,00011110,49,00110001
96,01100000,127,01111111,223,11011111
48,00110000,119,01110111,167,10100111
86,01010110,74,01001010,160,10100000
59,00111011,60,00111100,119,01110111
97,01100001,93,01011101,190,10111110
4,00000100,69,01000101,73,01001001
77,01001101,57,00111001,134,10000110
46,00101110,125,01111101,171,10101011
26,00011010,120,01111000,146,10010010
103,01100111,66,01000010,169,10101001
99,01100011,35,00100011,134,10000110
40,00101000,2,00000010,42,00101010
85,01010101,48,00110000,133,10000101
97,01100001,125,01111101,222,11011110
19,00010011,22,00010110,41,00101001
110,01101110,13,00001101,123,01111011
41,00101001,65,01000001,106,01101010
50,00110010,12,00001100,62,00111110
100,01100100,82,01010010,182,10110110
35,00100011,45,00101101,80,01010000
88,01011000,83,01010011,171,10101011
114,01110010,40,00101000,154,10011010
48,00110000,52,00110100,100,01100100
2,00000010,18,00010010,20,00010100
60,00111100,106,01101010,166,10100110
45,00101101,35,00100011,80,01010000
98,01100010,10,00001010,108,01101100
118,01110110,66,01000010,184,10111000
4,00000100,5,00000101,9,00001001
127,01111111,7,00000111,134,10000110
116,01110100,25,00011001,141,10001101
114,01110010,75,01001011,189,10111101
54,00110110,40,00101000,94,01011110
22,00010110,69,01000101,91,01011011
16,00010000,25,00011001,41,00101001
64,01000000,35,00100011,99,01100011
123,01111011,10,00001010,133,10000101
24,00011000,115,01110011,139,10001011
33,00100001,70,01000110,103,01100111
75,01001011,21,00010101,96,01100000
96,01100000,83,01010011,179,10110011
35,00100011,119,01110111,154,10011010
123,01111011,29,00011101,152,10011000
44,00101100,35,00100011,79,01001111
94,01011110,86,01010110,180,10110100
117,01110101,99,01100011,216,11011000
10,00001010,85,01010101,95,01011111
127,01111111,11,00001011,138,10001010
86,01010110,64,01000000,150,10010110
0,00000000,102,01100110,102,01100110
108,01101100,72,01001000,180,10110100
47,00101111,124,01111100,171,10101011
108,01101100,12,00001100,120,01111000
9,00001001,15,00001111,24,00011000
29,00011101,45,00101101,74,01001010
120,01111000,79,01001111,199,11000111
70,01000110,2,00000010,72,01001000
72,01001000,98,01100010,170,10101010
100,01100100,119,01110111,219,11011011
77,01001101,37,00100101,114,01110010
30,00011110,31,00011111,61,00111101
35,00100011,85,01010101,120,01111000
98,01100010,21,00010101,119,01110111
73,01001001,38,00100110,111,01101111
5,00000101,105,01101001,110,01101110
1,00000001,49,00110001,50,00110010
4,00000100,126,01111110,130,10000010
111,01101111,34,00100010,145,10010001
101,01100101,8,00001000,109,01101101
23,00010111,63,00111111,86,01010110
61,00111101,42,00101010,103,01100111
42,00101010,15,00001111,57,00111001
106,01101010,86,01010110,192,11000000
114,01110010,16,00010000,130,10000010
67,01000011,15,00001111,82,01010010
36,00100100,71,01000111,107,01101011
0,00000000,67,01000011,67,01000011
84,01010100,17,00010001,101,01100101
86,01010110,96,01100000,182,10110110
73,01001001,97,01100001,170,10101010
116,01110100,98,01100010,214,11010110
31,00011111,4,00000100,35,00100011
73,01001001,58,00111010,131,10000011
50,00110010,119,01110111,169,10101001
112,01110000,67,01000011,179,10110011
66,01000010,125,01111101,191,10111111
32,00100000,72,01001000,104,01101000
85,01010101,105,01101001,190,10111110
82,01010010,34,00100010,116,01110100
101,01100101,79,01001111,180,10110100
127,01111111,57,00111001,184,10111000
111,01101111,82,01010010,193,11000001
82,01010010,45,00101101,127,01111111
65,01000001,108,01101100,173,10101101
27,00011011,8,00001000,35,00100011
28,00011100,120,01111000,148,10010100
35,00100011,11,00001011,46,00101110
80,01010000,55,00110111,135,10000111
14,00001110,87,01010111,101,01100101
48,00110000,71,01000111,119,01110111
84,01010100,43,00101011,127,01111111
20,00010100,120,01111000,140,10001100
122,01111010,36,00100100,158,10011110
125,01111101,62,00111110,187,10111011
16,00010000,65,01000001,81,01010001
47,00101111,57,00111001,104,01101000
16,00010000,127,01111111,143,10001111
57,00111001,42,00101010,99,01100011
111,01101111,76,01001100,187,10111011
111,01101111,99,01100011,210,11010010
74,01001010,7,00000111,81,01010001
99,01100011,126,01111110,225,11100001
112,01110000,50,00110010,162,10100010
64,01000000,89,01011001,153,10011001
91,01011011,43,00101011,134,10000110
101,01100101,75,01001011,176,10110000
17,00010001,119,01110111,136,10001000
55,00110111,10,00001010,65,01000001
82,01010010,6,00000110,88,01011000
47,00101111,54,00110110,101,01100101
111,01101111,102,01100110,213,11010101
60,00111100,45,00101101,105,01101001
25,00011001,29,00011101,54,00110110
87,01010111,89,01011001,176,10110000
38,00100110,79,01001111,117,01110101
37,00100101,91,01011011,128,10000000
53,00110101,38,00100110,91,01011011
88,01011000,61,00111101,149,10010101
13,00001101,77,01001101,90,01011010
100,01100100,63,00111111,163,10100011
77,01001101,10,00001010,87,01010111
61,00111101,111,01101111,172,10101100
82,01010010,14,00001110,96,01100000
58,00111010,46,00101110,104,01101000
7,00000111,111,01101111,118,01110110
59,00111011,80,01010000,139,10001011
2,00000010,102,01100110,104,01101000
36,00100100,25,00011001,61,00111101
72,01001000,107,01101011,179,10110011
111,01101111,94,01011110,205,11001101
8,00001000,25,00011001,33,00100001
99,01100011,108,01101100,207,11001111
74,01001010,33,00100001,107,01101011
73,01001001,18,00010010,91,01011011
115,01110011,8,00001000,123,01111011
78,01001110,29,00011101,107,01101011
49,00110001,83,01010011,132,10000100
79,01001111,36,00100100,115,01110011
47,00101111,124,01111100,171,10101011
126,01111110,66,01000010,192,11000000
46,00101110,74,01001010,120,01111000
107,01101011,115,01110011,222,11011110
59,00111011,56,00111000,115,01110011
32,00100000,103,01100111,135,10000111
120,01111000,21,00010101,141,10001101
90,01011010,12,00001100,102,01100110
21,00010101,3,00000011,24,00011000
15,00001111,19,00010011,34,00100010
101,01100101,6,00000110,107,01101011
9,00001001,80,01010000,89,01011001
111,01101111,29,00011101,140,10001100
54,00110110,45,00101101,99,01100011
4,00000100,72,01001000,76,01001100
82,01010010,63,00111111,145,10010001
76,01001100,24,00011000,100,01100100
88,01011000,1,00000001,89,01011001
83,01010011,69,01000101,152,10011000
96,01100000,88,01011000,184,10111000
91,01011011,117,01110101,208,11010000
48,00110000,55,00110111,103,01100111
69,01000101,84,01010100,153,10011001
64,01000000,59,00111011,123,01111011
21,00010101,119,01110111,140,10001100
97,01100001,43,00101011,140,10001100
39,00100111,84,01010100,123,01111011
29,00011101,4,00000100,33,00100001
2,00000010,71,01000111,73,01001001
10,00001010,101,01100101,111,01101111
113,01110001,29,00011101,142,10001110
0,00000000,127,01111111,127,01111111
101,01100101,62,00111110,163,10100011
70,01000110,80,01010000,150,10010110
86,01010110,15,00001111,101,01100101
32,00100000,91,01011011,123,01111011
7,00000111,71,01000111,78,01001110
116,01110100,125,01111101,241,11110001
83,01010011,64,01000000,147,10010011
96,01100000,47,00101111,143,10001111
11,00001011,71,01000111,82,01010010
107,01101011,14,00001110,121,01111001
25,00011001,105,01101001,130,10000010
113,01110001,43,00101011,156,10011100
84,01010100,121,01111001,205,11001101
100,01100100,59,00111011,159,10011111
112,01110000,51,00110011,163,10100011
29,00011101,61,00111101,90,01011010
98,01100010,59,00111011,157,10011101
24,00011000,14,00001110,38,00100110
35,00100011,19,00010011,54,00110110
44,00101100,52,00110100,96,01100000
67,01000011,95,01011111,162,10100010
57,00111001,65,01000001,122,01111010
66,01000010,3,00000011,69,01000101
52,00110100,4,00000100,56,00111000
39,00100111,107,01101011,146,10010010
11,00001011,64,01000000,75,01001011
24,00011000,7,00000111,31,00011111
47,00101111,20,00010100,67,01000011
20,00010100,45,00101101,65,01000001
44,00101100,27,00011011,71,01000111
116,01110100,69,01000101,185,10111001
126,01111110,53,00110101,179,10110011
19,00010011,101,01100101,120,01111000
78,01001110,31,00011111,109,01101101
50,00110010,75,01001011,125,01111101
95,01011111,15,00001111,110,01101110
111,01101111,22,00010110,133,10000101
35,00100011,59,00111011,94,01011110
123,01111011,47,00101111,170,10101010
13,00001101,65,01000001,78,01001110
55,00110111,121,01111001,176,10110000
119,01110111,101,01100101,220,11011100
50,00110010,67,01000011,117,01110101
65,01000001,53,00110101,118,01110110
68,01000100,1,00000001,69,01000101
11,00001011,122,01111010,133,10000101
93,01011101,121,01111001,214,11010110
22,00010110,71,01000111,93,01011101
57,00111001,127,01111111,184,10111000
113,01110001,11,00001011,124,01111100
124,01111100,91,01011011,215,11010111
11,00001011,111,01101111,122,01111010
18,00010010,28,00011100,46,00101110
33,00100001,99,01100011,132,10000100
51,00110011,15,00001111,66,01000010
45,00101101,8,00001000,53,00110101
120,01111000,40,00101000,160,10100000
1,00000001,46,00101110,47,00101111
41,00101001,127,01111111,168,10101000
21,00010101,113,01110001,134,10000110
110,01101110,12,00001100,122,01111010
105,01101001,105,01101001,210,11010010
2,00000010,24,00011000,26,00011010
62,00111110,19,00010011,81,01010001
17,00010001,126,01111110,143,10001111
50,00110010,19,00010011,69,01000101
10,00001010,15,00001111,25,00011001
124,01111100,85,01010101,209,11010001
54,00110110,40,00101000,94,01011110
52,00110100,106,01101010,158,10011110
35,00100011,37,00100101,72,01001000
71,01000111,41,00101001,112,01110000
100,01100100,105,01101001,205,11001101
93,01011101,89,01011001,182,10110110
122,01111010,105,01101001,227,11100011
98,01100010,68,01000100,166,10100110
39,00100111,83,01010011,122,01111010
81,01010001,114,01110010,195,11000011
56,00111000,94,01011110,150,10010110
50,00110010,94,01011110,144,10010000
77,01001101,11,00001011,88,01011000
83,01010011,39,00100111,122,01111010
70,01000110,102,01100110,172,10101100
106,01101010,36,00100100,142,10001110
114,01110010,127,01111111,241,11110001
61,00111101,3,00000011,64,01000000
77,01001101,90,01011010,167,10100111
69,01000101,68,01000100,137,10001001
63,00111111,64,01000000,127,01111111
71,01000111,24,00011000,95,01011111
90,01011010,67,01000011,157,10011101
103,01100111,37,00100101,140,10001100
22,00010110,5,00000101,27,00011011
107,01101011,29,00011101,136,10001000
46,00101110,119,01110111,165,10100101
116,01110100,60,00111100,176,10110000
90,01011010,78,01001110,168,10101000
88,01011000,53,00110101,141,10001101
89,01011001,37,00100101,126,01111110
99,01100011,72,01001000,171,10101011
82,01010010,23,00010111,105,01101001
48,00110000,78,01001110,126,01111110
34,00100010,24,00011000,58,00111010
81,01010001,28,00011100,109,01101101
9,00001001,108,01101100,117,01110101
94,01011110,59,00111011,153,10011001
72,01001000,114,01110010,186,10111010
12,00001100,63,00111111,75,01001011
102,01100110,94,01011110,196,11000100
22,00010110,114,01110010,136,10001000
39,00100111,65,01000001,104,01101000
18,00010010,10,00001010,28,00011100
21,00010101,87,01010111,108,01101100
121,01111001,75,01001011,196,11000100
37,00100101,14,00001110,51,00110011
104,01101000,0,00000000,104,01101000
63,00111111,106,01101010,169,10101001
24,00011000,50,00110010,74,01001010
11,00001011,110,01101110,121,01111001
75,01001011,118,01110110,193,11000001
65,01000001,54,00110110,119,01110111
85,01010101,7,00000111,92,01011100
88,01011000,5,00000101,93,01011101
62,00111110,14,00001110,76,01001100
7,00000111,102,01100110,109,01101101
25,00011001,81,01010001,106,01101010
80,01010000,78,01001110,158,10011110
52,00110100,74,01001010,126,01111110
79,01001111,113,01110001,192,11000000
57,00111001,75,01001011,132,10000100
12,00001100,37,00100101,49,00110001
8,00001000,43,00101011,51,00110011
15,00001111,30,00011110,45,00101101
126,01111110,21,00010101,147,10010011
100,01100100,90,01011010,190,10111110
80,01010000,62,00111110,142,10001110
50,00110010,110,01101110,160,10100000
27,00011011,56,00111000,83,01010011
126,01111110,89,01011001,215,11010111
106,01101010,97,01100001,203,11001011
33,00100001,71,01000111,104,01101000
0,00000000,35,00100011,35,00100011
123,01111011,24,00011000,147,10010011
63,00111111,112,01110000,175,10101111
33,00100001,47,00101111,80,01010000
76,01001100,103,01100111,179,10110011
85,01010101,125,01111101,210,11010010
43,00101011,43,00101011,86,01010110
116,01110100,105,01101001,221,11011101
81,01010001,108,01101100,189,10111101
81,01010001,100,01100100,181,10110101
33,00100001,127,01111111,160,10100000
78,01001110,54,00110110,132,10000100
70,01000110,7,00000111,77,01001101
82,01010010,29,00011101,111,01101111
17,00010001,107,01101011,124,01111100
72,01001000,118,01110110,190,10111110
28,00011100,120,01111000,148,10010100
46,00101110,94,01011110,140,10001100
77,01001101,29,00011101,106,01101010
117,01110101,115,01110011,232,11101000
120,01111000,45,00101101,165,10100101
68,01000100,95,01011111,163,10100011
14,00001110,95,01011111,109,01101101
42,00101010,106,01101010,148,10010100
32,00100000,54,00110110,86,01010110
67,01000011,45,00101101,112,01110000
65,01000001,8,00001000,73,01001001
70,01000110,48,00110000,118,01110110
39,00100111,101,01100101,140,10001100
83,01010011,24,00011000,107,01101011
18,00010010,101,01100101,119,01110111
49,00110001,49,00110001,98,01100010
57,00111001,123,01111011,180,10110100
50,00110010,76,01001100,126,01111110
38,00100110,24,00011000,62,00111110
116,01110100,75,01001011,191,10111111
56,00111000,39,00100111,95,01011111
6,00000110,124,01111100,130,10000010
109,01101101,65,01000001,174,10101110
50,00110010,10,00001010,60,00111100
16,00010000,24,00011000,40,00101000
118,01110110,117,01110101,235,11101011
99,01100011,87,01010111,186,10111010
52,00110100,58,00111010,110,01101110
0,00000000,4,00000100,4,00000100
18,00010010,15,00001111,33,00100001
104,01101000,85,01010101,189,10111101
79,01001111,93,01011101,172,10101100
107,01101011,124,01111100,231,11100111
10,00001010,84,01010100,94,01011110
63,00111111,63,00111111,126,01111110
41,00101001,107,01101011,148,10010100
32,00100000,0,00000000,32,00100000
119,01110111,50,00110010,169,10101001
45,00101101,94,01011110,139,10001011
1,00000001,93,01011101,94,01011110
79,01001111,65,01000001,144,10010000
15,00001111,26,00011010,41,00101001
18,00010010,22,00010110,40,00101000
30,00011110,95,01011111,125,01111101
124,01111100,39,00100111,163,10100011
71,01000111,22,00010110,93,01011101
48,00110000,26,00011010,74,01001010
120,01111000,117,01110101,237,11101101
49,00110001,58,00111010,107,01101011
113,01110001,0,00000000,113,01110001
15,00001111,94,01011110,109,01101101
90,01011010,87,01010111,177,10110001
58,00111010,78,01001110,136,10001000
7,00000111,54,00110110,61,00111101
115,01110011,96,01100000,211,11010011
126,01111110,127,01111111,253,11111101
86,01010110,17,00010001,103,01100111
105,01101001,107,01101011,212,11010100
1,00000001,84,01010100,85,01010101
48,00110000,21,00010101,69,01000101
40,00101000,120,01111000,160,10100000
123,01111011,62,00111110,185,10111001
52,00110100,82,01010010,134,10000110
0,00000000,99,01100011,99,01100011
102,01100110,119,01110111,221,11011101
76,01001100,1,00000001,77,01001101
106,01101010,120,01111000,226,11100010
92,01011100,107,01101011,199,11000111
0,00000000,57,00111001,57,00111001
4,00000100,25,00011001,29,00011101
75,01001011,19,00010011,94,01011110
48,00110000,77,01001101,125,01111101
53,00110101,28,00011100,81,01010001
44,00101100,16,00010000,60,00111100
27,00011011,22,00010110,49,00110001
51,00110011,99,01100011,150,10010110
74,01001010,73,01001001,147,10010011
95,01011111,113,01110001,208,11010000
67,01000011,74,01001010,141,10001101
57,00111001,110,01101110,167,10100111
67,01000011,75,01001011,142,10001110
29,00011101,83,01010011,112,01110000
91,01011011,39,00100111,130,10000010
110,01101110,83,01010011,193,11000001
87,01010111,71,01000111,158,10011110
49,00110001,71,01000111,120,01111000
93,01011101,19,00010011,112,01110000
38,00100110,97,01100001,135,10000111
29,00011101,108,01101100,137,10001001
72,01001000,111,01101111,183,10110111
90,01011010,50,00110010,140,10001100
116,01110100,1,00000001,117,01110101
105,01101001,39,00100111,144,10010000
6,00000110,80,01010000,86,01010110
42,00101010,15,00001111,57,00111001
77,01001101,37,00100101,114,01110010
48,00110000,52,00110100,100,01100100
22,00010110,47,00101111,69,01000101
0,00000000,11,00001011,11,00001011
51,00110011,1,00000001,52,00110100
46,00101110,126,01111110,172,10101100
70,01000110,1,00000001,71,01000111
93,01011101,113,01110001,206,11001110
1,00000001,62,00111110,63,00111111
56,00111000,126,01111110,182,10110110
29,00011101,69,01000101,98,01100010
72,01001000,100,01100100,172,10101100
125,01111101,55,00110111,180,10110100
50,00110010,85,01010101,135,10000111
81,01010001,80,01010000,161,10100001
5,00000101,106,01101010,111,01101111
107,01101011,46,00101110,153,10011001
120,01111000,110,01101110,230,11100110
9,00001001,111,01101111,120,01111000
110,01101110,0,00000000,110,01101110
21,00010101,63,00111111,84,01010100
17,00010001,99,01100011,116,01110100
53,00110101,26,00011010,79,01001111
95,01011111,31,00011111,126,01111110
24,00011000,107,01101011,131,10000011
38,00100110,75,01001011,113,01110001
103,01100111,106,01101010,209,11010001
4,00000100,2,00000010,6,00000110
0,00000000,59,00111011,59,00111011
76,01001100,31,00011111,107,01101011
51,00110011,115,01110011,166,10100110
78,01001110,37,00100101,115,01110011
102,01100110,76,01001100,178,10110010
72,01001000,7,00000111,79,01001111
124,01111100,48,00110000,172,10101100
77,01001101,86,01010110,163,10100011
80,01010000,85,01010101,165,10100101
38,00100110,44,00101100,82,01010010
52,00110100,98,01100010,150,10010110
72,01001000,110,01101110,182,10110110
58,00111010,22,00010110,80,01010000
31,00011111,25,00011001,56,00111000
36,00100100,40,00101000,76,01001100
20,00010100,72,01001000,92,01011100
15,00001111,44,00101100,59,00111011
0,00000000,62,00111110,62,00111110
108,01101100,101,01100101,209,11010001
105,01101001,5,00000101,110,01101110
0,00000000,52,00110100,52,00110100
49,00110001,116,01110100,165,10100101
81,01010001,80,01010000,161,10100001
48,00110000,3,00000011,51,00110011
64,01000000,75,01001011,139,10001011
120,01111000,52,00110100,172,10101100
7,00000111,11,00001011,18,00010010
80,01010000,69,01000101,149,10010101
30,00011110,55,00110111,85,01010101
68,01000100,107,01101011,175,10101111
101,01100101,127,01111111,228,11100100
110,01101110,0,00000000,110,01101110
115,01110011,125,01111101,240,11110000
20,00010100,102,01100110,122,01111010
65,01000001,3,00000011,68,01000100
113,01110001,47,00101111,160,10100000
68,01000100,96,01100000,164,10100100
72,01001000,85,01010101,157,10011101
15,00001111,82,01010010,97,01100001
46,00101110,77,01001101,123,01111011
21,00010101,86,01010110,107,01101011
0,00000000,90,01011010,90,01011010
60,00111100,104,01101000,164,10100100
43,00101011,50,00110010,93,01011101
107,01101011,45,00101101,152,10011000
69,01000101,2,00000010,71,01000111
56,00111000,62,00111110,118,01110110
92,01011100,106,01101010,198,11000110
40,00101000,100,01100100,140,10001100
110,01101110,11,00001011,121,01111001
86,01010110,33,00100001,119,01110111
121,01111001,14,00001110,135,10000111
82,01010010,8,00001000,90,01011010
67,01000011,58,00111010,125,01111101
74,01001010,1,00000001,75,01001011
15,00001111,3,00000011,18,00010010
11,00001011,96,01100000,107,01101011
93,01011101,30,00011110,123,01111011
107,01101011,91,01011011,198,11000110
24,00011000,86,01010110,110,01101110
23,00010111,101,01100101,124,01111100
77,01001101,112,01110000,189,10111101
102,01100110,45,00101101,147,10010011
50,00110010,30,00011110,80,01010000
23,00010111,122,01111010,145,10010001
117,01110101,125,01111101,242,11110010
66,01000010,119,01110111,185,10111001
55,00110111,122,01111010,177,10110001
5,00000101,120,01111000,125,01111101
94,01011110,72,01001000,166,10100110
27,00011011,115,01110011,142,10001110
58,00111010,40,00101000,98,01100010
79,01001111,3,00000011,82,01010010
103,01100111,3,00000011,106,01101010
14,00001110,92,01011100,106,01101010
45,00101101,18,00010010,63,00111111
123,01111011,109,01101101,232,11101000
71,01000111,49,00110001,120,01111000
46,00101110,77,01001101,123,01111011
16,00010000,57,00111001,73,01001001
35,00100011,15,00001111,50,00110010
91,01011011,121,01111001,212,11010100
42,00101010,97,01100001,139,10001011
52,00110100,18,00010010,70,01000110
125,01111101,120,01111000,245,11110101
9,00001001,3,00000011,12,00001100
5,00000101,119,01110111,124,01111100
54,00110110,96,01100000,150,10010110
96,01100000,50,00110010,146,10010010
64,01000000,86,01010110,150,10010110
65,01000001,110,01101110,175,10101111
68,01000100,109,01101101,177,10110001
127,01111111,51,00110011,178,10110010
24,00011000,56,00111000,80,01010000
65,01000001,66,01000010,131,10000011
31,00011111,52,00110100,83,01010011
76,01001100,48,00110000,124,01111100
88,01011000,35,00100011,123,01111011
74,01001010,20,00010100,94,01011110
111,01101111,53,00110101,164,10100100
46,00101110,54,00110110,100,01100100
80,01010000,70,01000110,150,10010110
19,00010011,44,00101100,63,00111111
25,00011001,72,01001000,97,01100001
126,01111110,51,00110011,177,10110001
86,01010110,107,01101011,193,11000001
55,00110111,92,01011100,147,10010011
8,00001000,22,00010110,30,00011110
21,00010101,11,00001011,32,00100000
79,01001111,127,01111111,206,11001110
97,01100001,23,00010111,120,01111000
82,01010010,115,01110011,197,11000101
122,01111010,105,01101001,227,11100011
102,01100110,109,01101101,211,11010011
17,00010001,120,01111000,137,10001001
94,01011110,113,01110001,207,11001111
105,01101001,84,01010100,189,10111101
11,00001011,1,00000001,12,00001100
34,00100010,1,00000001,35,00100011
77,01001101,35,00100011,112,01110000
74,01001010,51,00110011,125,01111101
126,01111110,89,01011001,215,11010111
38,00100110,126,01111110,164,10100100
15,00001111,115,01110011,130,10000010
110,01101110,31,00011111,141,10001101
4,00000100,47,00101111,51,00110011
14,00001110,102,01100110,116,01110100
2,00000010,81,01010001,83,01010011
37,00100101,0,00000000,37,00100101
13,00001101,120,01111000,133,10000101
108,01101100,111,01101111,219,11011011
47,00101111,106,01101010,153,10011001
108,01101100,12,00001100,120,01111000
62,00111110,72,01001000,134,10000110
67,01000011,95,01011111,162,10100010
0,00000000,76,01001100,76,01001100
122,01111010,122,01111010,244,11110100
38,00100110,95,01011111,133,10000101
79,01001111,127,01111111,206,11001110
99,01100011,11,00001011,110,01101110
45,00101101,3,00000011,48,00110000
55,00110111,30,00011110,85,01010101
115,01110011,51,00110011,166,10100110
98,01100010,122,01111010,220,11011100
120,01111000,88,01011000,208,11010000
101,01100101,52,00110100,153,10011001
96,01100000,111,01101111,207,11001111
94,01011110,85,01010101,179,10110011
22,00010110,10,00001010,32,00100000
73,01001001,69,01000101,142,10001110
114,01110010,39,00100111,153,10011001
115,01110011,41,00101001,156,10011100
54,00110110,93,01011101,147,10010011
52,00110100,88,01011000,140,10001100
103,01100111,73,01001001,176,10110000
121,01111001,73,01001001,194,11000010
29,00011101,90,01011010,119,01110111
101,01100101,33,00100001,134,10000110
39,00100111,83,01010011,122,01111010
20,00010100,45,00101101,65,01000001
87,01010111,26,00011010,113,01110001
21,00010101,114,01110010,135,10000111
40,00101000,31,00011111,71,01000111
91,01011011,92,01011100,183,10110111
125,01111101,95,01011111,220,11011100
69,01000101,125,01111101,194,11000010
122,01111010,55,00110111,177,10110001
118,01110110,76,01001100,194,11000010
11,00001011,100,01100100,111,01101111
75,01001011,29,00011101,104,01101000
90,01011010,101,01100101,191,10111111
55,00110111,20,00010100,75,01001011
64,01000000,106,01101010,170,10101010
18,00010010,13,00001101,31,00011111
120,01111000,8,00001000,128,10000000
83,01010011,101,01100101,184,10111000
33,00100001,78,01001110,111,01101111
122,01111010,41,00101001,163,10100011
25,00011001,120,01111000,145,10010001
39,00100111,101,01100101,140,10001100
76,01001100,7,00000111,83,01010011
99,01100011,118,01110110,217,11011001
35,00100011,55,00110111,90,01011010
81,01010001,49,00110001,130,10000010
113,01110001,91,01011011,204,11001100
106,01101010,115,01110011,221,11011101
118,01110110,19,00010011,137,10001001
92,01011100,58,00111010,150,10010110
11,00001011,80,01010000,91,01011011
44,00101100,28,00011100,72,01001000
56,00111000,96,01100000,152,10011000
109,01101101,91,01011011,200,11001000
74,01001010,94,01011110,168,10101000
8,00001000,92,01011100,100,01100100
12,00001100,33,00100001,45,00101101
103,01100111,122,01111010,225,11100001
110,01101110,3,00000011,113,01110001
41,00101001,78,01001110,119,01110111
39,00100111,53,00110101,92,01011100
48,00110000,17,00010001,65,01000001
121,01111001,26,00011010,147,10010011
13,00001101,106,01101010,119,01110111
30,00011110,34,00100010,64,01000000
27,00011011,112,01110000,139,10001011
102,01100110,118,01110110,220,11011100
38,00100110,15,00001111,53,00110101
47,00101111,92,01011100,139,10001011
19,00010011,120,01111000,139,10001011
71,01000111,108,01101100,179,10110011
5,00000101,19,00010011,24,00011000
85,01010101,27,00011011,112,01110000
94,01011110,30,00011110,124,01111100
110,01101110,44,00101100,154,10011010
19,00010011,27,00011011,46,00101110
81,01010001,70,01000110,151,10010111
79,01001111,115,01110011,194,11000010
123,01111011,103,01100111,226,11100010
80,01010000,44,00101100,124,01111100
90,01011010,61,00111101,151,10010111
46,00101110,96,01100000,142,10001110
75,01001011,4,00000100,79,01001111
24,00011000,14,00001110,38,00100110
63,00111111,69,01000101,132,10000100
109,01101101,120,01111000,229,11100101
43,00101011,24,00011000,67,01000011
58,00111010,70,01000110,128,10000000
99,01100011,60,00111100,159,10011111
119,01110111,66,01000010,185,10111001
72,01001000,124,01111100,196,11000100
35,00100011,47,00101111,82,01010010
90,01011010,60,00111100,150,10010110
111,01101111,125,01111101,236,11101100
29,00011101,51,00110011,80,01010000
83,01010011,104,01101000,187,10111011
47,00101111,100,01100100,147,10010011
100,01100100,100,01100100,200,11001000
56,00111000,21,00010101,77,01001101
106,01101010,90,01011010,196,11000100
16,00010000,50,00110010,66,01000010
112,01110000,92,01011100,204,11001100
68,01000100,126,01111110,194,11000010
59,00111011,44,00101100,103,01100111
60,00111100,26,00011010,86,01010110
75,01001011,92,01011100,167,10100111
47,00101111,127,01111111,174,10101110
35,00100011,123,01111011,158,10011110
22,00010110,31,00011111,53,00110101
32,00100000,12,00001100,44,00101100
63,00111111,44,00101100,107,01101011
102,01100110,122,01111010,224,11100000
113,01110001,57,00111001,170,10101010
2,00000010,97,01100001,99,01100011
111,01101111,15,00001111,126,01111110
62,00111110,69,01000101,131,10000011
23,00010111,116,01110100,139,10001011
39,00100111,105,01101001,144,10010000
103,01100111,120,01111000,223,11011111
23,00010111,38,00100110,61,00111101
1,00000001,52,00110100,53,00110101
30,00011110,94,01011110,124,01111100
111,01101111,54,00110110,165,10100101
13,00001101,89,01011001,102,01100110
66,01000010,64,01000000,130,10000010
62,00111110,10,00001010,72,01001000
35,00100011,73,01001001,108,01101100
106,01101010,45,00101101,151,10010111
37,00100101,1,00000001,38,00100110
46,00101110,21,00010101,67,01000011
105,01101001,5,00000101,110,01101110
9,00001001,25,00011001,34,00100010
91,01011011,54,00110110,145,10010001
84,01010100,31,00011111,115,01110011
92,01011100,83,01010011,175,10101111
65,01000001,15,00001111,80,01010000
53,00110101,96,01100000,149,10010101
46,00101110,69,01000101,115,01110011
56,00111000,63,00111111,119,01110111
103,01100111,1,00000001,104,01101000
12,00001100,68,01000100,80,01010000
122,01111010,95,01011111,217,11011001
116,01110100,12,00001100,128,10000000
53,00110101,124,01111100,177,10110001
64,01000000,120,01111000,184,10111000
77,01001101,11,00001011,88,01011000
51,00110011,9,00001001,60,00111100
40,00101000,16,00010000,56,00111000
111,01101111,82,01010010,193,11000001
16,00010000,96,01100000,112,01110000
64,01000000,91,01011011,155,10011011
103,01100111,19,00010011,122,01111010
55,00110111,50,00110010,105,01101001
62,00111110,81,01010001,143,10001111
102,01100110,36,00100100,138,10001010
83,01010011,91,01011011,174,10101110
57,00111001,93,01011101,150,10010110
20,00010100,82,01010010,102,01100110
34,00100010,36,00100100,70,01000110
36,00100100,106,01101010,142,10001110
49,00110001,88,01011000,137,10001001
33,00100001,52,00110100,85,01010101
47,00101111,95,01011111,142,10001110
26,00011010,24,00011000,50,00110010
85,01010101,23,00010111,108,01101100
21,00010101,87,01010111,108,01101100
2,00000010,10,00001010,12,00001100
10,00001010,54,00110110,64,01000000
20,00010100,39,00100111,59,00111011
124,01111100,58,00111010,182,10110110
52,00110100,28,00011100,80,01010000
49,00110001,62,00111110,111,01101111
91,01011011,5,00000101,96,01100000
60,00111100,62,00111110,122,01111010
83,01010011,75,01001011,158,10011110
106,01101010,42,00101010,148,10010100
59,00111011,29,00011101,88,01011000
80,01010000,113,01110001,193,11000001
50,00110010,10,00001010,60,00111100
38,00100110,15,00001111,53,00110101
63,00111111,85,01010101,148,10010100
36,00100100,71,01000111,107,01101011
58,00111010,6,00000110,64,01000000
48,00110000,60,00111100,108,01101100
47,00101111,58,00111010,105,01101001
80,01010000,58,00111010,138,10001010
52,00110100,38,00100110,90,01011010
52,00110100,80,01010000,132,10000100
29,00011101,79,01001111,108,01101100
58,00111010,123,01111011,181,10110101
50,00110010,45,00101101,95,01011111
11,00001011,4,00000100,15,00001111
47,00101111,110,01101110,157,10011101
61,00111101,105,01101001,166,10100110
66,01000010,114,01110010,180,10110100
8,00001000,16,00010000,24,00011000
54,00110110,119,01110111,173,10101101
0,00000000,104,01101000,104,01101000
37,00100101,122,01111010,159,10011111
58,00111010,112,01110000,170,10101010
123,01111011,69,01000101,192,11000000
97,01100001,10,00001010,107,01101011
58,00111010,32,00100000,90,01011010
125,01111101,10,00001010,135,10000111
111,01101111,72,01001000,183,10110111
49,00110001,46,00101110,95,01011111
102,01100110,106,01101010,208,11010000
9,00001001,116,01110100,125,01111101
44,00101100,91,01011011,135,10000111
30,00011110,126,01111110,156,10011100
99,01100011,94,01011110,193,11000001
13,00001101,30,00011110,43,00101011
14,00001110,56,00111000,70,01000110
56,00111000,36,00100100,92,01011100
98,01100010,1,00000001,99,01100011
24,00011000,81,01010001,105,01101001
92,01011100,68,01000100,160,10100000
19,00010011,125,01111101,144,10010000
94,01011110,8,00001000,102,01100110
28,00011100,107,01101011,135,10000111
35,00100011,86,01010110,121,01111001
35,00100011,65,01000001,100,01100100
106,01101010,121,01111001,227,11100011
90,01011010,80,01010000,170,10101010
40,00101000,8,00001000,48,00110000
55,00110111,23,00010111,78,01001110
22,00010110,43,00101011,65,01000001
123,01111011,64,01000000,187,10111011
68,01000100,87,01010111,155,10011011
69,01000101,87,01010111,156,10011100
51,00110011,53,00110101,104,01101000
28,00011100,40,00101000,68,01000100
25,00011001,21,00010101,46,00101110
34,00100010,25,00011001,59,00111011
72,01001000,62,00111110,134,10000110
11,00001011,19,00010011,30,00011110
49,00110001,39,00100111,88,01011000
2,00000010,12,00001100,14,00001110
96,01100000,91,01011011,187,10111011
84,01010100,0,00000000,84,01010100
106,01101010,28,00011100,134,10000110
67,01000011,127,01111111,194,11000010
62,00111110,120,01111000,182,10110110
14,00001110,61,00111101,75,01001011
90,01011010,64,01000000,154,10011010
74,01001010,100,01100100,174,10101110
114,01110010,5,00000101,119,01110111
123,01111011,34,00100010,157,10011101
18,00010010,126,01111110,144,10010000
23,00010111,1,00000001,24,00011000
25,00011001,114,01110010,139,10001011
59,00111011,104,01101000,163,10100011
5,00000101,79,01001111,84,01010100
0,00000000,106,01101010,106,01101010
39,00100111,126,01111110,165,10100101
104,01101000,110,01101110,214,11010110
98,01100010,52,00110100,150,10010110
22,00010110,14,00001110,36,00100100
127,01111111,104,01101000,231,11100111
127,01111111,12,00001100,139,10001011
43,00101011,106,01101010,149,10010101
47,00101111,51,00110011,98,01100010
47,00101111,92,01011100,139,10001011
113,01110001,76,01001100,189,10111101
78,01001110,23,00010111,101,01100101
22,00010110,16,00010000,38,00100110
17,00010001,104,01101000,121,01111001
46,00101110,119,01110111,165,10100101
115,01110011,102,01100110,217,11011001
53,00110101,7,00000111,60,00111100
3,00000011,25,00011001,28,00011100
37,00100101,127,01111111,164,10100100
14,00001110,27,00011011,41,00101001
5,00000101,48,00110000,53,00110101
74,01001010,32,00100000,106,01101010
93,01011101,98,01100010,191,10111111
79,01001111,103,01100111,182,10110110
110,01101110,87,01010111,197,11000101
37,00100101,84,01010100,121,01111001
11,00001011,124,01111100,135,10000111
53,00110101,33,00100001,86,01010110
101,01100101,104,01101000,205,11001101
26,00011010,17,00010001,43,00101011
20,00010100,74,01001010,94,01011110
30,00011110,86,01010110,116,01110100
85,01010101,125,01111101,210,11010010
88,01011000,49,00110001,137,10001001
1,00000001,31,00011111,32,00100000
30,00011110,10,00001010,40,00101000
64,01000000,10,00001010,74,01001010
7,00000111,21,00010101,28,00011100
29,00011101,95,01011111,124,01111100
115,01110011,112,01110000,227,11100011
34,00100010,96,01100000,130,10000010
63,00111111,50,00110010,113,01110001
36,00100100,88,01011000,124,01111100
100,01100100,123,01111011,223,11011111
94,01011110,122,01111010,216,11011000
22,00010110,44,00101100,66,01000010
118,01110110,24,00011000,142,10001110
74,01001010,119,01110111,193,11000001
96,01100000,82,01010010,178,10110010
9,00001001,123,01111011,132,10000100
114,01110010,103,01100111,217,11011001
68,01000100,89,01011001,157,10011101
19,00010011,70,01000110,89,01011001
0,00000000,110,01101110,110,01101110
63,00111111,58,00111010,121,01111001
48,00110000,120,01111000,168,10101000
126,01111110,87,01010111,213,11010101
59,00111011,34,00100010,93,01011101
43,00101011,41,00101001,84,01010100
17,00010001,56,00111000,73,01001001
43,00101011,84,01010100,127,01111111
83,01010011,99,01100011,182,10110110
122,01111010,88,01011000,210,11010010
67,01000011,87,01010111,154,10011010
39,00100111,124,01111100,163,10100011
95,01011111,31,00011111,126,01111110
33,00100001,91,01011011,124,01111100
68,01000100,47,00101111,115,01110011
47,00101111,2,00000010,49,00110001
106,01101010,86,01010110,192,11000000
84,01010100,35,00100011,119,01110111
2,00000010,77,01001101,79,01001111
64,01000000,100,01100100,164,10100100
100,01100100,10,00001010,110,01101110
75,01001011,95,01011111,170,10101010
103,01100111,119,01110111,222,11011110
38,00100110,117,01110101,155,10011011
123,01111011,94,01011110,217,11011001
65,01000001,91,01011011,156,10011100
32,00100000,56,00111000,88,01011000
99,01100011,10,00001010,109,01101101
62,00111110,127,01111111,189,10111101
55,00110111,31,00011111,86,01010110
115,01110011,90,01011010,205,11001101
124,01111100,11,00001011,135,10000111
1,00000001,56,00111000,57,00111001
62,00111110,38,00100110,100,01100100
57,00111001,102,01100110,159,10011111
44,00101100,51,00110011,95,01011111
2,00000010,10,00001010,12,00001100
97,01100001,1,00000001,98,01100010
59,00111011,57,00111001,116,01110100
19,00010011,90,01011010,109,01101101
91,01011011,34,00100010,125,01111101
46,00101110,90,01011010,136,10001000
98,01100010,22,00010110,120,01111000
13,00001101,30,00011110,43,00101011
93,01011101,46,00101110,139,10001011
76,01001100,95,01011111,171,10101011
61,00111101,115,01110011,176,10110000
67,01000011,75,01001011,142,10001110
123,01111011,53,00110101,176,10110000
38,00100110,51,00110011,89,01011001
73,01001001,84,01010100,157,10011101
57,00111001,82,01010010,139,10001011
24,00011000,114,01110010,138,10001010
95,01011111,124,01111100,219,11011011
103,01100111,7,00000111,110,01101110
7,00000111,39,00100111,46,00101110
61,00111101,80,01010000,141,10001101
69,01000101,122,01111010,191,10111111
111,01101111,43,00101011,154,10011010
25,00011001,63,00111111,88,01011000
58,00111010,27,00011011,85,01010101
8,00001000,44,00101100,52,00110100
97,01100001,64,01000000,161,10100001
29,00011101,117,01110101,146,10010010
11,00001011,75,01001011,86,01010110
49,00110001,34,00100010,83,01010011
34,00100010,111,01101111,145,10010001
117,01110101,116,01110100,233,11101001
80,01010000,87,01010111,167,10100111
55,00110111,37,00100101,92,01011100
105,01101001,118,01110110,223,11011111
48,00110000,0,00000000,48,00110000
74,01001010,62,00111110,136,10001000
119,01110111,40,00101000,159,10011111
67,01000011,107,01101011,174,10101110
62,00111110,41,00101001,103,01100111
33,00100001,16,00010000,49,00110001
123,01111011,56,00111000,179,10110011
115,01110011,36,00100100,151,10010111
28,00011100,42,00101010,70,01000110
10,00001010,53,00110101,63,00111111
99,01100011,124,01111100,223,11011111
127,01111111,111,01101111,238,11101110
72,01001000,67,01000011,139,10001011
55,00110111,26,00011010,81,01010001
121,01111001,25,00011001,146,10010010
117,01110101,124,01111100,241,11110001
25,00011001,81,01010001,106,01101010
113,01110001,54,00110110,167,10100111
63,00111111,32,00100000,95,01011111
21,00010101,126,01111110,147,10010011
0,00000000,74,01001010,74,01001010
50,00110010,92,01011100,142,10001110
53,00110101,9,00001001,62,00111110
7,00000111,43,00101011,50,00110010
39,00100111,22,00010110,61,00111101
56,00111000,90,01011010,146,10010010
126,01111110,122,01111010,248,11111000
91,01011011,64,01000000,155,10011011
26,00011010,24,00011000,50,00110010
125,01111101,33,00100001,158,10011110
28,00011100,19,00010011,47,00101111
124,01111100,120,01111000,244,11110100
104,01101000,100,01100100,204,11001100
59,00111011,104,01101000,163,10100011
25,00011001,69,01000101,94,01011110
53,00110101,12,00001100,65,01000001
116,01110100,7,00000111,123,01111011
48,00110000,49,00110001,97,01100001
75,01001011,22,00010110,97,01100001
93,01011101,125,01111101,218,11011010
121,01111001,21,00010101,142,10001110
102,01100110,68,01000100,170,10101010
110,01101110,100,01100100,210,11010010
84,01010100,46,00101110,130,10000010
22,00010110,124,01111100,146,10010010
12,00001100,40,00101000,52,00110100
42,00101010,11,00001011,53,00110101
96,01100000,108,01101100,204,11001100
36,00100100,63,00111111,99,01100011
72,01001000,67,01000011,139,10001011
20,00010100,87,01010111,107,01101011
125,01111101,64,01000000,189,10111101
39,00100111,80,01010000,119,01110111
68,01000100,27,00011011,95,01011111
56,00111000,67,01000011,123,01111011
9,00001001,8,00001000,17,00010001
15,00001111,18,00010010,33,00100001
49,00110001,109,01101101,158,10011110
28,00011100,29,00011101,57,00111001
20,00010100,29,00011101,49,00110001
27,00011011,114,01110010,141,10001101
19,00010011,32,00100000,51,00110011
127,01111111,64,01000000,191,10111111
70,01000110,89,01011001,159,10011111
109,01101101,44,00101100,153,10011001
14,00001110,103,01100111,117,01110101
13,00001101,59,00111011,72,01001000
95,01011111,3,00000011,98,01100010
4,00000100,114,01110010,118,01110110
97,01100001,38,00100110,135,10000111
123,01111011,6,00000110,129,10000001
107,01101011,87,01010111,194,11000010
71,01000111,119,01110111,190,10111110
107,01101011,1,00000001,108,01101100
1,00000001,83,01010011,84,01010100
52,00110100,74,01001010,126,01111110
57,00111001,73,01001001,130,10000010
124,01111100,14,00001110,138,10001010
47,00101111,15,00001111,62,00111110
7,00000111,37,00100101,44,00101100
77,01001101,82,01010010,159,10011111
93,01011101,49,00110001,142,10001110
97,01100001,52,00110100,149,10010101
54,00110110,107,01101011,161,10100001
49,00110001,56,00111000,105,01101001
55,00110111,94,01011110,149,10010101
96,01100000,101,01100101,197,11000101
70,01000110,83,01010011,153,10011001
102,01100110,110,01101110,212,11010100
84,01010100,1,00000001,85,01010101
26,00011010,27,00011011,53,00110101
69,01000101,89,01011001,158,10011110
34,00100010,112,01110000,146,10010010
113,01110001,18,00010010,131,10000011
22,00010110,110,01101110,132,10000100
20,00010100,19,00010011,39,00100111
125,01111101,19,00010011,144,10010000
73,01001001,109,01101101,182,10110110
105,01101001,114,01110010,219,11011011
85,01010101,44,00101100,129,10000001
94,01011110,52,00110100,146,10010010
110,01101110,17,00010001,127,01111111
63,00111111,102,01100110,165,10100101
116,01110100,111,01101111,227,11100011
55,00110111,96,01100000,151,10010111
121,01111001,111,01101111,232,11101000
26,00011010,30,00011110,56,00111000
112,01110000,47,00101111,159,10011111
25,00011001,57,00111001,82,01010010
83,01010011,38,00100110,121,01111001
28,00011100,75,01001011,103,01100111
88,01011000,117,01110101,205,11001101
70,01000110,35,00100011,105,01101001
102,01100110,0,00000000,102,01100110
88,01011000,108,01101100,196,11000100
126,01111110,9,00001001,135,10000111
73,01001001,19,00010011,92,01011100
28,00011100,39,00100111,67,01000011
101,01100101,93,01011101,194,11000010
15,00001111,16,00010000,31,00011111
76,01001100,32,00100000,108,01101100
124,01111100,51,00110011,175,10101111
91,01011011,55,00110111,146,10010010
119,01110111,59,00111011,178,10110010
67,01000011,6,00000110,73,01001001
83,01010011,49,00110001,132,10000100
25,00011001,85,01010101,110,01101110
6,00000110,67,01000011,73,01001001
115,01110011,113,01110001,228,11100100
42,00101010,103,01100111,145,10010001
70,01000110,109,01101101,179,10110011
115,01110011,66,01000010,181,10110101
105,01101001,21,00010101,126,01111110
126,01111110,107,01101011,233,11101001
35,00100011,121,01111001,156,10011100
49,00110001,117,01110101,166,10100110
86,01010110,92,01011100,178,10110010
100,01100100,89,01011001,189,10111101
95,01011111,16,00010000,111,01101111
89,01011001,28,00011100,117,01110101
121,01111001,49,00110001,170,10101010
60,00111100,102,01100110,162,10100010
108,01101100,24,00011000,132,10000100
39,00100111,82,01010010,121,01111001
107,01101011,124,01111100,231,11100111
14,00001110,91,01011011,105,01101001
8,00001000,2,00000010,10,00001010
63,00111111,54,00110110,117,01110101
21,00010101,114,01110010,135,10000111
73,01001001,46,00101110,119,01110111
9,00001001,34,00100010,43,00101011
33,00100001,11,00001011,44,00101100
99,01100011,118,01110110,217,11011001
72,01001000,18,00010010,90,01011010
31,00011111,65,01000001,96,01100000
49,00110001,30,00011110,79,01001111
111,01101111,38,00100110,149,10010101
45,00101101,75,01001011,120,01111000
0,00000000,48,00110000,48,00110000
26,00011010,100,01100100,126,01111110
126,01111110,110,01101110,236,11101100
118,01110110,6,00000110,124,01111100
61,00111101,5,00000101,66,01000010
66,01000010,90,01011010,156,10011100
35,00100011,95,01011111,130,10000010
20,00010100,121,01111001,141,10001101
53,00110101,77,01001101,130,10000010
76,01001100,42,00101010,118,01110110
26,00011010,80,01010000,106,01101010
84,01010100,33,00100001,117,01110101
86,01010110,21,00010101,107,01101011
21,00010101,53,00110101,74,01001010
53,00110101,21,00010101,74,01001010
14,00001110,126,01111110,140,10001100
49,00110001,106,01101010,155,10011011
6,00000110,70,01000110,76,01001100
18,00010010,108,01101100,126,01111110
2,00000010,112,01110000,114,01110010
111,01101111,56,00111000,167,10100111
118,01110110,52,00110100,170,10101010
73,01001001,91,01011011,164,10100100
45,00101101,30,00011110,75,01001011
123,01111011,79,01001111,202,11001010
17,00010001,24,00011000,41,00101001
102,01100110,8,00001000,110,01101110
4,00000100,10,00001010,14,00001110
87,01010111,93,01011101,180,10110100
41,00101001,74,01001010,115,01110011
72,01001000,104,01101000,176,10110000
40,00101000,119,01110111,159,10011111
47,00101111,19,00010011,66,01000010
44,00101100,69,01000101,113,01110001
41,00101001,22,00010110,63,00111111
3,00000011,35,00100011,38,00100110
103,01100111,79,01001111,182,10110110
46,00101110,14,00001110,60,00111100
126,01111110,53,00110101,179,10110011
10,00001010,5,00000101,15,00001111
105,01101001,38,00100110,143,10001111
122,01111010,54,00110110,176,10110000
48,00110000,105,01101001,153,10011001
18,00010010,124,01111100,142,10001110
118,01110110,83,01010011,201,11001001
16,00010000,16,00010000,32,00100000
115,01110011,60,00111100,175,10101111
127,01111111,56,00111000,183,10110111
87,01010111,37,00100101,124,01111100
16,00010000,58,00111010,74,01001010
70,01000110,101,01100101,171,10101011
95,01011111,39,00100111,134,10000110
84,01010100,63,00111111,147,10010011
103,01100111,24,00011000,127,01111111
117,01110101,75,01001011,192,11000000
53,00110101,113,01110001,166,10100110
57,00111001,48,00110000,105,01101001
1,00000001,45,00101101,46,00101110
125,01111101,98,01100010,223,11011111
110,01101110,58,00111010,168,10101000
87,01010111,109,01101101,196,11000100
52,00110100,48,00110000,100,01100100
43,00101011,101,01100101,144,10010000
82,01010010,30,00011110,112,01110000
122,01111010,60,00111100,182,10110110
70,01000110,106,01101010,176,10110000
57,00111001,84,01010100,141,10001101
65,01000001,24,00011000,89,01011001
100,01100100,42,00101010,142,10001110
11,00001011,35,00100011,46,00101110
65,01000001,28,00011100,93,01011101
24,00011000,125,01111101,149,10010101
90,01011010,8,00001000,98,01100010
43,00101011,74,01001010,117,01110101
46,00101110,115,01110011,161,10100001
48,00110000,13,00001101,61,00111101
86,01010110,6,00000110,92,01011100
47,00101111,74,01001010,121,01111001
38,00100110,98,01100010,136,10001000
92,01011100,113,01110001,205,11001101
33,00100001,70,01000110,103,01100111
72,01001000,122,01111010,194,11000010
26,00011010,4,00000100,30,00011110
42,00101010,37,00100101,79,01001111
63,00111111,48,00110000,111,01101111
93,01011101,43,00101011,136,10001000
103,01100111,40,00101000,143,10001111
96,01100000,94,01011110,190,10111110
87,01010111,17,00010001,104,01101000
21,00010101,47,00101111,68,01000100
17,00010001,34,00100010,51,00110011
16,00010000,119,01110111,135,10000111
2,00000010,63,00111111,65,01000001
44,00101100,62,00111110,106,01101010
9,00001001,112,01110000,121,01111001
114,01110010,34,00100010,148,10010100
4,00000100,74,01001010,78,01001110
104,01101000,24,00011000,128,10000000
70,01000110,102,01100110,172,10101100
69,01000101,106,01101010,175,10101111
5,00000101,98,01100010,103,01100111
43,00101011,29,00011101,72,01001000
13,00001101,90,01011010,103,01100111
107,01101011,76,01001100,183,10110111
109,01101101,17,00010001,126,01111110
64,01000000,54,00110110,118,01110110
87,01010111,58,00111010,145,10010001
119,01110111,13,00001101,132,10000100
50,00110010,87,01010111,137,10001001
47,00101111,49,00110001,96,01100000
28,00011100,10,00001010,38,00100110
5,00000101,119,01110111,124,01111100
119,01110111,50,00110010,169,10101001
82,01010010,12,00001100,94,01011110
53,00110101,8,00001000,61,00111101
107,01101011,9,00001001,116,01110100
46,00101110,97,01100001,143,10001111
94,01011110,87,01010111,181,10110101
70,01000110,60,00111100,130,10000010
10,00001010,30,00011110,40,00101000
53,00110101,30,00011110,83,01010011
43,00101011,21,00010101,64,01000000
24,00011000,62,00111110,86,01010110
97,01100001,42,00101010,139,10001011
72,01001000,126,01111110,198,11000110
16,00010000,66,01000010,82,01010010
123,01111011,3,00000011,126,01111110
111,01101111,47,00101111,158,10011110
72,01001000,8,00001000,80,01010000
98,01100010,26,00011010,124,01111100
60,00111100,98,01100010,158,10011110
90,01011010,106,01101010,196,11000100
119,01110111,125,01111101,244,11110100
107,01101011,43,00101011,150,10010110
30,00011110,95,01011111,125,01111101
79,01001111,104,01101000,183,10110111
77,01001101,65,01000001,142,10001110
92,01011100,107,01101011,199,11000111
99,01100011,21,00010101,120,01111000
83,01010011,79,01001111,162,10100010
82,01010010,29,00011101,111,01101111
35,00100011,59,00111011,94,01011110
15,00001111,89,01011001,104,01101000
61,00111101,50,00110010,111,01101111
71,01000111,75,01001011,146,10010010
121,01111001,50,00110010,171,10101011
46,00101110,43,00101011,89,01011001
119,01110111,14,00001110,133,10000101
3,00000011,23,00010111,26,00011010
66,01000010,85,01010101,151,10010111
6,00000110,29,00011101,35,00100011
16,00010000,121,01111001,137,10001001
76,01001100,38,00100110,114,01110010
100,01100100,56,00111000,156,10011100
57,00111001,117,01110101,174,10101110
81,01010001,107,01101011,188,10111100
66,01000010,88,01011000,154,10011010
45,00101101,25,00011001,70,01000110
85,01010101,96,01100000,181,10110101
21,00010101,1,00000001,22,00010110
51,00110011,31,00011111,82,01010010
33,00100001,82,01010010,115,01110011
46,00101110,92,01011100,138,10001010
39,00100111,34,00100010,73,01001001
115,01110011,69,01000101,184,10111000
50,00110010,24,00011000,74,01001010
54,00110110,76,01001100,130,10000010
40,00101000,98,01100010,138,10001010
6,00000110,108,01101100,114,01110010
13,00001101,47,00101111,60,00111100
81,01010001,106,01101010,187,10111011
101,01100101,112,01110000,213,11010101
42,00101010,48,00110000,90,01011010
5,00000101,17,00010001,22,00010110
11,00001011,53,00110101,64,01000000
103,01100111,19,00010011,122,01111010
42,00101010,1,00000001,43,00101011
16,00010000,53,00110101,69,01000101
68,01000100,30,00011110,98,01100010
110,01101110,11,00001011,121,01111001
48,00110000,110,01101110,158,10011110
115,01110011,113,01110001,228,11100100
99,01100011,52,00110100,151,10010111
106,01101010,107,01101011,213,11010101
85,01010101,103,01100111,188,10111100
118,01110110,125,01111101,243,11110011
19,00010011,108,01101100,127,01111111
19,00010011,101,01100101,120,01111000
62,00111110,106,01101010,168,10101000
126,01111110,67,01000011,193,11000001
52,00110100,116,01110100,168,10101000
45,00101101,73,01001001,118,01110110
114,01110010,16,00010000,130,10000010
33,00100001,88,01011000,121,01111001
54,00110110,11,00001011,65,01000001
12,00001100,28,00011100,40,00101000
90,01011010,103,01100111,193,11000001
94,01011110,81,01010001,175,10101111
7,00000111,6,00000110,13,00001101
75,01001011,57,00111001,132,10000100
11,00001011,77,01001101,88,01011000
31,00011111,74,01001010,105,01101001
95,01011111,14,00001110,109,01101101
71,01000111,1,00000001,72,01001000
46,00101110,90,01011010,136,10001000
82,01010010,108,01101100,190,10111110
29,00011101,78,01001110,107,01101011
103,01100111,23,00010111,126,01111110
78,01001110,5,00000101,83,01010011
122,01111010,26,00011010,148,10010100
9,00001001,80,01010000,89,01011001
29,00011101,24,00011000,53,00110101
68,01000100,46,00101110,114,01110010
102,01100110,86,01010110,188,10111100
62,00111110,21,00010101,83,01010011
12,00001100,35,00100011,47,00101111
61,00111101,108,01101100,169,10101001
30,00011110,1,00000001,31,00011111
23,00010111,119,01110111,142,10001110
92,01011100,32,00100000,124,01111100
103,01100111,62,00111110,165,10100101
34,00100010,15,00001111,49,00110001
25,00011001,52,00110100,77,01001101
22,00010110,24,00011000,46,00101110
68,01000100,65,01000001,133,10000101
47,00101111,6,00000110,53,00110101
60,00111100,24,00011000,84,01010100
34,00100010,70,01000110,104,01101000
62,00111110,83,01010011,145,10010001
45,00101101,61,00111101,106,01101010
77,01001101,117,01110101,194,11000010
115,01110011,74,01001010,189,10111101
69,01000101,8,00001000,77,01001101
42,00101010,84,01010100,126,01111110
63,00111111,76,01001100,139,10001011
6,00000110,18,00010010,24,00011000
79,01001111,87,01010111,166,10100110
116,01110100,84,01010100,200,11001000
86,01010110,48,00110000,134,10000110
88,01011000,110,01101110,198,11000110
44,00101100,34,00100010,78,01001110
97,01100001,111,01101111,208,11010000
97,01100001,100,01100100,197,11000101
99,01100011,98,01100010,197,11000101
109,01101101,59,00111011,168,10101000
26,00011010,96,01100000,122,01111010
113,01110001,27,00011011,140,10001100
110,01101110,16,00010000,126,01111110
97,01100001,17,00010001,114,01110010
78,01001110,108,01101100,186,10111010
48,00110000,1,00000001,49,00110001
49,00110001,0,00000000,49,00110001
33,00100001,84,01010100,117,01110101
19,00010011,6,00000110,25,00011001
78,01001110,119,01110111,197,11000101
86,01010110,27,00011011,113,01110001
120,01111000,116,01110100,236,11101100
122,01111010,24,00011000,146,10010010
107,01101011,39,00100111,146,10010010
104,01101000,34,00100010,138,10001010
110,01101110,111,01101111,221,11011101
37,00100101,110,01101110,147,10010011
45,00101101,50,00110010,95,01011111
60,00111100,10,00001010,70,01000110
14,00001110,125,01111101,139,10001011
72,01001000,126,01111110,198,11000110
9,00001001,82,01010010,91,01011011
89,01011001,108,01101100,197,11000101
54,00110110,33,00100001,87,01010111
114,01110010,30,00011110,144,10010000
60,00111100,108,01101100,168,10101000
40,00101000,12,00001100,52,00110100
86,01010110,82,01010010,168,10101000
10,00001010,37,00100101,47,00101111
82,01010010,112,01110000,194,11000010
87,01010111,34,00100010,121,01111001
5,00000101,78,01001110,83,01010011
106,01101010,42,00101010,148,10010100
10,00001010,8,00001000,18,00010010
9,00001001,49,00110001,58,00111010
21,00010101,70,01000110,91,01011011
127,01111111,70,01000110,197,11000101
6,00000110,112,01110000,118,01110110
114,01110010,15,00001111,129,10000001
106,01101010,68,01000100,174,10101110
63,00111111,1,00000001,64,01000000
100,01100100,67,01000011,167,10100111
92,01011100,79,01001111,171,10101011
64,01000000,36,00100100,100,01100100
82,01010010,0,00000000,82,01010010
70,01000110,59,00111011,129,10000001
93,01011101,75,01001011,168,10101000
38,00100110,42,00101010,80,01010000
10,00001010,80,01010000,90,01011010
59,00111011,84,01010100,143,10001111
45,00101101,35,00100011,80,01010000
107,01101011,102,01100110,209,11010001
113,01110001,4,00000100,117,01110101
60,00111100,62,00111110,122,01111010
44,00101100,75,01001011,119,01110111
92,01011100,100,01100100,192,11000000
53,00110101,13,00001101,66,01000010
42,00101010,2,00000010,44,00101100
40,00101000,49,00110001,89,01011001
7,00000111,68,01000100,75,01001011
40,00101000,101,01100101,141,10001101
110,01101110,9,00001001,119,01110111
78,01001110,101,01100101,179,10110011
15,00001111,87,01010111,102,01100110
0,00000000,50,00110010,50,00110010
72,01001000,97,01100001,169,10101001
115,01110011,21,00010101,136,10001000
68,01000100,77,01001101,145,10010001
22,00010110,96,01100000,118,01110110
12,00001100,94,01011110,106,01101010
12,00001100,20,00010100,32,00100000
59,00111011,102,01100110,161,10100001
31,00011111,97,01100001,128,10000000
42,00101010,4,00000100,46,00101110
34,00100010,49,00110001,83,01010011
12,00001100,72,01001000,84,01010100
74,01001010,108,01101100,182,10110110
12,00001100,21,00010101,33,00100001
126,01111110,105,01101001,231,11100111
28,00011100,110,01101110,138,10001010
84,01010100,12,00001100,96,01100000
50,00110010,23,00010111,73,01001001
26,00011010,105,01101001,131,10000011
108,01101100,50,00110010,158,10011110
64,01000000,72,01001000,136,10001000
35,00100011,24,00011000,59,00111011
124,01111100,26,00011010,150,10010110
21,00010101,22,00010110,43,00101011
80,01010000,96,01100000,176,10110000
125,01111101,55,00110111,180,10110100
20,00010100,18,00010010,38,00100110
116,01110100,73,01001001,189,10111101
3,00000011,81,01010001,84,01010100
91,01011011,10,00001010,101,01100101
22,00010110,50,00110010,72,01001000
38,00100110,25,00011001,63,00111111
115,01110011,13,00001101,128,10000000
124,01111100,3,00000011,127,01111111
117,01110101,72,01001000,189,10111101
116,01110100,30,00011110,146,10010010
59,00111011,98,01100010,157,10011101
21,00010101,109,01101101,130,10000010
85,01010101,92,01011100,177,10110001
35,00100011,38,00100110,73,01001001
77,01001101,9,00001001,86,01010110
77,01001101,22,00010110,99,01100011
49,00110001,120,01111000,169,10101001
116,01110100,103,01100111,219,11011011
67,01000011,52,00110100,119,01110111
34,00100010,82,01010010,116,01110100
42,00101010,68,01000100,110,01101110
0,00000000,27,00011011,27,00011011
41,00101001,47,00101111,88,01011000
54,00110110,72,01001000,126,01111110
42,00101010,51,00110011,93,01011101
116,01110100,46,00101110,162,10100010
76,01001100,113,01110001,189,10111101
85,01010101,11,00001011,96,01100000
126,01111110,115,01110011,241,11110001
46,00101110,18,00010010,64,01000000
51,00110011,71,01000111,122,01111010
61,00111101,77,01001101,138,10001010
38,00100110,16,00010000,54,00110110
50,00110010,34,00100010,84,01010100
0,00000000,74,01001010,74,01001010
45,00101101,44,00101100,89,01011001
5,00000101,67,01000011,72,01001000
115,01110011,80,01010000,195,11000011
10,00001010,55,00110111,65,01000001
26,00011010,5,00000101,31,00011111
17,00010001,21,00010101,38,00100110
53,00110101,101,01100101,154,10011010
109,01101101,7,00000111,116,01110100
9,00001001,112,01110000,121,01111001
93,01011101,65,01000001,158,10011110
64,01000000,83,01010011,147,10010011
89,01011001,100,01100100,189,10111101
0,00000000,120,01111000,120,01111000
47,00101111,122,01111010,169,10101001
46,00101110,87,01010111,133,10000101
16,00010000,121,01111001,137,10001001
126,01111110,116,01110100,242,11110010
10,00001010,73,01001001,83,01010011
87,01010111,58,00111010,145,10010001
44,00101100,62,00111110,106,01101010
66,01000010,73,01001001,139,10001011
109,01101101,93,01011101,202,11001010
32,00100000,97,01100001,129,10000001
39,00100111,72,01001000,111,01101111
5,00000101,61,00111101,66,01000010
92,01011100,92,01011100,184,10111000
126,01111110,38,00100110,164,10100100
123,01111011,95,01011111,218,11011010
54,00110110,97,01100001,151,10010111
10,00001010,111,01101111,121,01111001
58,00111010,20,00010100,78,01001110
125,01111101,117,01110101,242,11110010
116,01110100,49,00110001,165,10100101
114,01110010,122,01111010,236,11101100
60,00111100,104,01101000,164,10100100
82,01010010,2,00000010,84,01010100
60,00111100,115,01110011,175,10101111
28,00011100,42,00101010,70,01000110
30,00011110,5,00000101,35,00100011
109,01101101,28,00011100,137,10001001
55,00110111,78,01001110,133,10000101
0,00000000,3,00000011,3,00000011
31,00011111,97,01100001,128,10000000
16,00010000,7,00000111,23,00010111
58,00111010,9,00001001,67,01000011
126,01111110,73,01001001,199,11000111
58,00111010,83,01010011,141,10001101
87,01010111,59,00111011,146,10010010
27,00011011,53,00110101,80,01010000
86,01010110,39,00100111,125,01111101
30,00011110,93,01011101,123,01111011
34,00100010,74,01001010,108,01101100
25,00011001,81,01010001,106,01101010
90,01011010,92,01011100,182,10110110
68,01000100,20,00010100,88,01011000
58,00111010,33,00100001,91,01011011
109,01101101,60,00111100,169,10101001
68,01000100,9,00001001,77,01001101
15,00001111,115,01110011,130,10000010
94,01011110,25,00011001,119,01110111
77,01001101,50,00110010,127,01111111
13,00001101,49,00110001,62,00111110
86,01010110,53,00110101,139,10001011
88,01011000,26,00011010,114,01110010
53,00110101,96,01100000,149,10010101
86,01010110,81,01010001,167,10100111
115,01110011,40,00101000,155,10011011
60,00111100,124,01111100,184,10111000
122,01111010,61,00111101,183,10110111
51,00110011,65,01000001,116,01110100
88,01011000,85,01010101,173,10101101
23,00010111,67,01000011,90,01011010
114,01110010,97,01100001,211,11010011
91,01011011,92,01011100,183,10110111
40,00101000,82,01010010,122,01111010
47,00101111,80,01010000,127,01111111
104,01101000,95,01011111,199,11000111
71,01000111,77,01001101,148,10010100
76,01001100,29,00011101,105,01101001
2,00000010,17,00010001,19,00010011
73,01001001,65,01000001,138,10001010
16,00010000,4,00000100,20,00010100
35,00100011,16,00010000,51,00110011
79,01001111,0,00000000,79,01001111
106,01101010,84,01010100,190,10111110
37,00100101,83,01010011,120,01111000
14,00001110,105,01101001,119,01110111
100,01100100,110,01101110,210,11010010
37,00100101,84,01010100,121,01111001
51,00110011,25,00011001,76,01001100
86,01010110,41,00101001,127,01111111
10,00001010,78,01001110,88,01011000
23,00010111,33,00100001,56,00111000
4,00000100,116,01110100,120,01111000
75,01001011,43,00101011,118,01110110
88,01011000,71,01000111,159,10011111
9,00001001,117,01110101,126,01111110
115,01110011,91,01011011,206,11001110
76,01001100,54,00110110,130,10000010
31,00011111,73,01001001,104,01101000
96,01100000,86,01010110,182,10110110
17,00010001,38,00100110,55,00110111
118,01110110,7,00000111,125,01111101
5,00000101,42,00101010,47,00101111
39,00100111,5,00000101,44,00101100
50,00110010,40,00101000,90,01011010
98,01100010,67,01000011,165,10100101
4,00000100,22,00010110,26,00011010
13,00001101,17,00010001,30,00011110
64,01000000,8,00001000,72,01001000
95,01011111,125,01111101,220,11011100
44,00101100,10,00001010,54,00110110
1,00000001,83,01010011,84,01010100
31,00011111,7,00000111,38,00100110
18,00010010,120,01111000,138,10001010
25,00011001,56,00111000,81,01010001
75,01001011,14,00001110,89,01011001
98,01100010,100,01100100,198,11000110
90,01011010,85,01010101,175,10101111
6,00000110,8,00001000,14,00001110
124,01111100,103,01100111,227,11100011
70,01000110,116,01110100,186,10111010
35,00100011,58,00111010,93,01011101
76,01001100,30,00011110,106,01101010
92,01011100,35,00100011,127,01111111
29,00011101,98,01100010,127,01111111
29,00011101,113,01110001,142,10001110
116,01110100,30,00011110,146,10010010
106,01101010,111,01101111,217,11011001
91,01011011,82,01010010,173,10101101
16,00010000,107,01101011,123,01111011
36,00100100,106,01101010,142,10001110
106,01101010,47,00101111,153,10011001
115,01110011,22,00010110,137,10001001
82,01010010,43,00101011,125,01111101
84,01010100,49,00110001,133,10000101
91,01011011,34,00100010,125,01111101
76,01001100,109,01101101,185,10111001
78,01001110,3,00000011,81,01010001
99,01100011,82,01010010,181,10110101
120,01111000,117,01110101,237,11101101
9,00001001,121,01111001,130,10000010
97,01100001,39,00100111,136,10001000
33,00100001,16,00010000,49,00110001
97,01100001,36,00100100,133,10000101
1,00000001,81,01010001,82,01010010
97,01100001,23,00010111,120,01111000
63,00111111,82,01010010,145,10010001
11,00001011,124,01111100,135,10000111
121,01111001,84,01010100,205,11001101
68,01000100,35,00100011,103,01100111
72,01001000,3,00000011,75,01001011
61,00111101,2,00000010,63,00111111
115,01110011,62,00111110,177,10110001
107,01101011,67,01000011,174,10101110
7,00000111,20,00010100,27,00011011
47,00101111,94,01011110,141,10001101
34,00100010,109,01101101,143,10001111
5,00000101,72,01001000,77,01001101
119,01110111,110,01101110,229,11100101
123,01111011,125,01111101,248,11111000
33,00100001,24,00011000,57,00111001
84,01010100,73,01001001,157,10011101
121,01111001,9,00001001,130,10000010
119,01110111,66,01000010,185,10111001
120,01111000,123,01111011,243,11110011
99,01100011,115,01110011,214,11010110
127,01111111,36,00100100,163,10100011
6,00000110,115,01110011,121,01111001
94,01011110,99,01100011,193,11000001
62,00111110,24,00011000,86,01010110
79,01001111,88,01011000,167,10100111
102,01100110,27,00011011,129,10000001
57,00111001,24,00011000,81,01010001
86,01010110,121,01111001,207,11001111
87,01010111,10,00001010,97,01100001
26,00011010,65,01000001,91,01011011
2,00000010,1,00000001,3,00000011
58,00111010,94,01011110,152,10011000
21,00010101,68,01000100,89,01011001
67,01000011,58,00111010,125,01111101
63,00111111,119,01110111,182,10110110
77,01001101,126,01111110,203,11001011
75,01001011,30,00011110,105,01101001
85,01010101,30,00011110,115,01110011
57,00111001,2,00000010,59,00111011
52,00110100,120,01111000,172,10101100
72,01001000,22,00010110,94,01011110
71,01000111,101,01100101,172,10101100
58,00111010,122,01111010,180,10110100
47,00101111,34,00100010,81,01010001
115,01110011,93,01011101,208,11010000
45,00101101,37,00100101,82,01010010
11,00001011,87,01010111,98,01100010
7,00000111,17,00010001,24,00011000
34,00100010,72,01001000,106,01101010
101,01100101,40,00101000,141,10001101
59,00111011,106,01101010,165,10100101
76,01001100,106,01101010,182,10110110
15,00001111,73,01001001,88,01011000
82,01010010,54,00110110,136,10001000
52,00110100,70,01000110,122,01111010
28,00011100,17,00010001,45,00101101
26,00011010,23,00010111,49,00110001
64,01000000,36,00100100,100,01100100
101,01100101,90,01011010,191,10111111
92,01011100,65,01000001,157,10011101
53,00110101,67,01000011,120,01111000
81,01010001,112,01110000,193,11000001
30,00011110,122,01111010,152,10011000
126,01111110,78,01001110,204,11001100
99,01100011,74,01001010,173,10101101
50,00110010,41,00101001,91,01011011
79,01001111,1,00000001,80,01010000
108,01101100,24,00011000,132,10000100
7,00000111,78,01001110,85,01010101
90,01011010,1,00000001,91,01011011
87,01010111,108,01101100,195,11000011
61,00111101,8,00001000,69,01000101
64,01000000,21,00010101,85,01010101
94,01011110,60,00111100,154,10011010
67,01000011,18,00010010,85,01010101
32,00100000,114,01110010,146,10010010
98,01100010,13,00001101,111,01101111
9,00001001,106,01101010,115,01110011
60,00111100,3,00000011,63,00111111
60,00111100,53,00110101,113,01110001
109,01101101,104,01101000,213,11010101
20,00010100,112,01110000,132,10000100
49,00110001,44,00101100,93,01011101
0,00000000,108,01101100,108,01101100
40,00101000,102,01100110,142,10001110
75,01001011,0,00000000,75,01001011
53,00110101,74,01001010,127,01111111
66,01000010,17,00010001,83,01010011
39,00100111,69,01000101,108,01101100
9,00001001,73,01001001,82,01010010
27,00011011,126,01111110,153,10011001
36,00100100,53,00110101,89,01011001
108,01101100,26,00011010,134,10000110
2,00000010,49,00110001,51,00110011
93,01011101,118,01110110,211,11010011
95,01011111,99,01100011,194,11000010
66,01000010,17,00010001,83,01010011
120,01111000,104,01101000,224,11100000
25,00011001,89,01011001,114,01110010
24,00011000,99,01100011,123,01111011
121,01111001,88,01011000,209,11010001
43,00101011,79,01001111,122,01111010
41,00101001,57,00111001,98,01100010
101,01100101,49,00110001,150,10010110
74,01001010,16,00010000,90,01011010
35,00100011,43,00101011,78,01001110
71,01000111,0,00000000,71,01000111
110,01101110,87,01010111,197,11000101
22,00010110,94,01011110,116,01110100
24,00011000,61,00111101,85,01010101
84,01010100,27,00011011,111,01101111
7,00000111,12,00001100,19,00010011
93,01011101,72,01001000,165,10100101
42,00101010,74,01001010,116,01110100
70,01000110,103,01100111,173,10101101
22,00010110,100,01100100,122,01111010
40,00101000,43,00101011,83,01010011
94,01011110,71,01000111,165,10100101
110,01101110,118,01110110,228,11100100
55,00110111,34,00100010,89,01011001
95,01011111,37,00100101,132,10000100
106,01101010,41,00101001,147,10010011
120,01111000,72,01001000,192,11000000
124,01111100,92,01011100,216,11011000
120,01111000,1,00000001,121,01111001
39,00100111,122,01111010,161,10100001
18,00010010,113,01110001,131,10000011
55,00110111,108,01101100,163,10100011
41,00101001,13,00001101,54,00110110
15,00001111,68,01000100,83,01010011
91,01011011,55,00110111,146,10010010
2,00000010,37,00100101,39,00100111
67,01000011,86,01010110,153,10011001
117,01110101,121,01111001,238,11101110
6,00000110,10,00001010,16,00010000
8,00001000,108,01101100,116,01110100
124,01111100,36,00100100,160,10100000
101,01100101,18,00010010,119,01110111
35,00100011,97,01100001,132,10000100
91,01011011,39,00100111,130,10000010
48,00110000,123,01111011,171,10101011
85,01010101,57,00111001,142,10001110
77,01001101,66,01000010,143,10001111
38,00100110,59,00111011,97,01100001
38,00100110,17,00010001,55,00110111
84,01010100,65,01000001,149,10010101
106,01101010,22,00010110,128,10000000
71,01000111,118,01110110,189,10111101
43,00101011,95,01011111,138,10001010
114,01110010,103,01100111,217,11011001
69,01000101,11,00001011,80,01010000
34,00100010,96,01100000,130,10000010
88,01011000,86,01010110,174,10101110
66,01000010,77,01001101,143,10001111
103,01100111,2,00000010,105,01101001
84,01010100,26,00011010,110,01101110
112,01110000,33,00100001,145,10010001
21,00010101,12,00001100,33,00100001
76,01001100,35,00100011,111,01101111
16,00010000,101,01100101,117,01110101
79,01001111,85,01010101,164,10100100
87,01010111,59,00111011,146,10010010
123,01111011,20,00010100,143,10001111
17,00010001,65,01000001,82,01010010
57,00111001,126,01111110,183,10110111
46,00101110,72,01001000,118,01110110
35,00100011,2,00000010,37,00100101
50,00110010,64,01000000,114,01110010
74,01001010,65,01000001,139,10001011
58,00111010,105,01101001,163,10100011
121,01111001,124,01111100,245,11110101
74,01001010,71,01000111,145,10010001
22,00010110,96,01100000,118,01110110
19,00010011,114,01110010,133,10000101
111,01101111,30,00011110,141,10001101
100,01100100,47,00101111,147,10010011
104,01101000,25,00011001,129,10000001
47,00101111,19,00010011,66,01000010
51,00110011,13,00001101,64,01000000
17,00010001,93,01011101,110,01101110
15,00001111,55,00110111,70,01000110
50,00110010,37,00100101,87,01010111
2,00000010,115,01110011,117,01110101
99,01100011,53,00110101,152,10011000
82,01010010,81,01010001,163,10100011
37,00100101,36,00100100,73,01001001
111,01101111,71,01000111,182,10110110
66,01000010,20,00010100,86,01010110
17,00010001,80,01010000,97,01100001
122,01111010,2,00000010,124,01111100
94,01011110,75,01001011,169,10101001
102,01100110,25,00011001,127,01111111
58,00111010,109,01101101,167,10100111
69,01000101,23,00010111,92,01011100
42,00101010,25,00011001,67,01000011
12,00001100,5,00000101,17,00010001
22,00010110,112,01110000,134,10000110
62,00111110,2,00000010,64,01000000
1,00000001,21,00010101,22,00010110
51,00110011,29,00011101,80,01010000
57,00111001,126,01111110,183,10110111
70,01000110,47,00101111,117,01110101
2,00000010,88,01011000,90,01011010
8,00001000,27,00011011,35,00100011
9,00001001,59,00111011,68,01000100
62,00111110,15,00001111,77,01001101
19,00010011,11,00001011,30,00011110
104,01101000,55,00110111,159,10011111
88,01011000,121,01111001,209,11010001
19,00010011,124,01111100,143,10001111
6,00000110,114,01110010,120,01111000
102,01100110,107,01101011,209,11010001
26,00011010,54,00110110,80,01010000
121,01111001,47,00101111,168,10101000
112,01110000,99,01100011,211,11010011
73,01001001,1,00000001,74,01001010
44,00101100,41,00101001,85,01010101
1,00000001,76,01001100,77,01001101
122,01111010,103,01100111,225,11100001
39,00100111,37,00100101,76,01001100
3,00000011,14,00001110,17,00010001
64,01000000,118,01110110,182,10110110
115,01110011,11,00001011,126,01111110
65,01000001,101,01100101,166,10100110
127,01111111,115,01110011,242,11110010
107,01101011,76,01001100,183,10110111
86,01010110,93,01011101,179,10110011
49,00110001,46,00101110,95,01011111
67,01000011,11,00001011,78,01001110
62,00111110,66,01000010,128,10000000
30,00011110,49,00110001,79,01001111
53,00110101,9,00001001,62,00111110
52,00110100,112,01110000,164,10100100
15,00001111,120,01111000,135,10000111
17,00010001,2,00000010,19,00010011
82,01010010,123,01111011,205,11001101
109,01101101,33,00100001,142,10001110
24,00011000,56,00111000,80,01010000
47,00101111,37,00100101,84,01010100
83,01010011,80,01010000,163,10100011
11,00001011,42,00101010,53,00110101
58,00111010,33,00100001,91,01011011
94,01011110,11,00001011,105,01101001
73,01001001,43,00101011,116,01110100
73,01001001,91,01011011,164,10100100
35,00100011,39,00100111,74,01001010
73,01001001,69,01000101,142,10001110
34,00100010,32,00100000,66,01000010
15,00001111,32,00100000,47,00101111
75,01001011,100,01100100,175,10101111
43,00101011,39,00100111,82,01010010
59,00111011,95,01011111,154,10011010
85,01010101,73,01001001,158,10011110
66,01000010,121,01111001,187,10111011
107,01101011,24,00011000,131,10000011
95,01011111,102,01100110,197,11000101
7,00000111,99,01100011,106,01101010
100,01100100,76,01001100,176,10110000
19,00010011,94,01011110,113,01110001
106,01101010,11,00001011,117,01110101
82,01010010,58,00111010,140,10001100
26,00011010,66,01000010,92,01011100
73,01001001,64,01000000,137,10001001
33,00100001,53,00110101,86,01010110
24,00011000,38,00100110,62,00111110
31,00011111,100,01100100,131,10000011
103,01100111,115,01110011,218,11011010
112,01110000,68,01000100,180,10110100
127,01111111,69,01000101,196,11000100
123,01111011,63,00111111,186,10111010
31,00011111,5,00000101,36,00100100
121,01111001,78,01001110,199,11000111
120,01111000,98,01100010,218,11011010
44,00101100,83,01010011,127,01111111
29,00011101,75,01001011,104,01101000
100,01100100,6,00000110,106,01101010
107,01101011,91,01011011,198,11000110
17,00010001,78,01001110,95,01011111
7,00000111,16,00010000,23,00010111
16,00010000,120,01111000,136,10001000
74,01001010,123,01111011,197,11000101
26,00011010,63,00111111,89,01011001
32,00100000,48,00110000,80,01010000
114,01110010,42,00101010,156,10011100
8,00001000,112,01110000,120,01111000
108,01101100,107,01101011,215,11010111
2,00000010,41,00101001,43,00101011
104,01101000,68,01000100,172,10101100
83,01010011,86,01010110,169,10101001
66,01000010,122,01111010,188,10111100
35,00100011,25,00011001,60,00111100
16,00010000,11,00001011,27,00011011
5,00000101,11,00001011,16,00010000
87,01010111,89,01011001,176,10110000
121,01111001,74,01001010,195,11000011
32,00100000,29,00011101,61,00111101
103,01100111,87,01010111,190,10111110
124,01111100,72,01001000,196,11000100
111,01101111,97,01100001,208,11010000
21,00010101,21,00010101,42,00101010
108,01101100,100,01100100,208,11010000
116,01110100,98,01100010,214,11010110
56,00111000,7,00000111,63,00111111
116,01110100,49,00110001,165,10100101
109,01101101,90,01011010,199,11000111
56,00111000,67,01000011,123,01111011
58,00111010,52,00110100,110,01101110
85,01010101,67,01000011,152,10011000
113,01110001,95,01011111,208,11010000
107,01101011,73,01001001,180,10110100
23,00010111,21,00010101,44,00101100
87,01010111,31,00011111,118,01110110
55,00110111,107,01101011,162,10100010
1,00000001,38,00100110,39,00100111
29,00011101,30,00011110,59,00111011
35,00100011,97,01100001,132,10000100
46,00101110,24,00011000,70,01000110
100,01100100,63,00111111,163,10100011
25,00011001,0,00000000,25,00011001
104,01101000,10,00001010,114,01110010
122,01111010,7,00000111,129,10000001
66,01000010,18,00010010,84,01010100
62,00111110,112,01110000,174,10101110
93,01011101,37,00100101,130,10000010
106,01101010,75,01001011,181,10110101
92,01011100,70,01000110,162,10100010
75,01001011,22,00010110,97,01100001
30,00011110,79,01001111,109,01101101
72,01001000,44,00101100,116,01110100
115,01110011,19,00010011,134,10000110
111,01101111,111,01101111,222,11011110
121,01111001,109,01101101,230,11100110
20,00010100,62,00111110,82,01010010
108,01101100,0,00000000,108,01101100
106,01101010,39,00100111,145,10010001
114,01110010,52,00110100,166,10100110
96,01100000,124,01111100,220,11011100
117,01110101,75,01001011,192,11000000
113,01110001,32,00100000,145,10010001
13,00001101,121,01111001,134,10000110
105,01101001,106,01101010,211,11010011
18,00010010,93,01011101,111,01101111
92,01011100,65,01000001,157,10011101
118,01110110,80,01010000,198,11000110
2,00000010,49,00110001,51,00110011
80,01010000,21,00010101,101,01100101
116,01110100,36,00100100,152,10011000
109,01101101,39,00100111,148,10010100
6,00000110,109,01101101,115,01110011
63,00111111,12,00001100,75,01001011
41,00101001,53,00110101,94,01011110
101,01100101,126,01111110,227,11100011
62,00111110,15,00001111,77,01001101
83,01010011,89,01011001,172,10101100
75,01001011,71,01000111,146,10010010
61,00111101,71,01000111,132,10000100
35,00100011,15,00001111,50,00110010
81,01010001,122,01111010,203,11001011
49,00110001,97,01100001,146,10010010
115,01110011,3,00000011,118,01110110
2,00000010,87,01010111,89,01011001
50,00110010,102,01100110,152,10011000
121,01111001,54,00110110,175,10101111
30,00011110,26,00011010,56,00111000
92,01011100,25,00011001,117,01110101
58,00111010,55,00110111,113,01110001
11,00001011,35,00100011,46,00101110
56,00111000,38,00100110,94,01011110
112,01110000,55,00110111,167,10100111
2,00000010,30,00011110,32,00100000
3,00000011,110,01101110,113,01110001
0,00000000,103,01100111,103,01100111
85,01010101,111,01101111,196,11000100
45,00101101,109,01101101,154,10011010
17,00010001,62,00111110,79,01001111
50,00110010,0,00000000,50,00110010
84,01010100,89,01011001,173,10101101
70,01000110,32,00100000,102,01100110
108,01101100,92,01011100,200,11001000
93,01011101,69,01000101,162,10100010
62,00111110,35,00100011,97,01100001
10,00001010,83,01010011,93,01011101
38,00100110,4,00000100,42,00101010
43,00101011,9,00001001,52,00110100
60,00111100,122,01111010,182,10110110
8,00001000,38,00100110,46,00101110
12,00001100,35,00100011,47,00101111
31,00011111,49,00110001,80,01010000
107,01101011,58,00111010,165,10100101
25,00011001,45,00101101,70,01000110
40,00101000,5,00000101,45,00101101
17,00010001,101,01100101,118,01110110
98,01100010,20,00010100,118,01110110
24,00011000,46,00101110,70,01000110
4,00000100,101,01100101,105,01101001
22,00010110,116,01110100,138,10001010
16,00010000,122,01111010,138,10001010
46,00101110,110,01101110,156,10011100
112,01110000,5,00000101,117,01110101
73,01001001,0,00000000,73,01001001
99,01100011,83,01010011,182,10110110
32,00100000,121,01111001,153,10011001
44,00101100,115,01110011,159,10011111
82,01010010,61,00111101,143,10001111
12,00001100,33,00100001,45,00101101
85,01010101,14,00001110,99,01100011
46,00101110,105,01101001,151,10010111
11,00001011,20,00010100,31,00011111
53,00110101,47,00101111,100,01100100
105,01101001,90,01011010,195,11000011
90,01011010,108,01101100,198,11000110
47,00101111,109,01101101,156,10011100
112,01110000,127,01111111,239,11101111
31,00011111,24,00011000,55,00110111
64,01000000,107,01101011,171,10101011
60,00111100,80,01010000,140,10001100
101,01100101,118,01110110,219,11011011
20,00010100,9,00001001,29,00011101
50,00110010,50,00110010,100,01100100
104,01101000,125,01111101,229,11100101
66,01000010,108,01101100,174,10101110
15,00001111,125,01111101,140,10001100
80,01010000,69,01000101,149,10010101
101,01100101,65,01000001,166,10100110
100,01100100,54,00110110,154,10011010
54,00110110,62,00111110,116,01110100
96,01100000,20,00010100,116,01110100
68,01000100,100,01100100,168,10101000
55,00110111,20,00010100,75,01001011
40,00101000,61,00111101,101,01100101
33,00100001,103,01100111,136,10001000
97,01100001,98,01100010,195,11000011
6,00000110,97,01100001,103,01100111
126,01111110,102,01100110,228,11100100
110,01101110,8,00001000,118,01110110
31,00011111,14,00001110,45,00101101
97,01100001,117,01110101,214,11010110
101,01100101,65,01000001,166,10100110
77,01001101,103,01100111,180,10110100
4,00000100,69,01000101,73,01001001
27,00011011,103,01100111,130,10000010
51,00110011,85,01010101,136,10001000
125,01111101,9,00001001,134,10000110
12,00001100,86,01010110,98,01100010
45,00101101,68,01000100,113,01110001
61,00111101,47,00101111,108,01101100
96,01100000,86,01010110,182,10110110
18,00010010,113,01110001,131,10000011
66,01000010,110,01101110,176,10110000
118,01110110,93,01011101,211,11010011
58,00111010,82,01010010,140,10001100
100,01100100,23,00010111,123,01111011
4,00000100,75,01001011,79,01001111
14,00001110,119,01110111,133,10000101
34,00100010,8,00001000,42,00101010
67,01000011,28,00011100,95,01011111
3,00000011,115,01110011,118,01110110
98,01100010,35,00100011,133,10000101
41,00101001,35,00100011,76,01001100
6,00000110,58,00111010,64,01000000
97,01100001,115,01110011,212,11010100
16,00010000,4,00000100,20,00010100
105,01101001,92,01011100,197,11000101
26,00011010,69,01000101,95,01011111
46,00101110,83,01010011,129,10000001
82,01010010,4,00000100,86,01010110
36,00100100,75,01001011,111,01101111
117,01110101,3,00000011,120,01111000
62,00111110,95,01011111,157,10011101
66,01000010,126,01111110,192,11000000
36,00100100,85,01010101,121,01111001
37,00100101,92,01011100,129,10000001
11,00001011,31,00011111,42,00101010
22,00010110,79,01001111,101,01100101
72,01001000,53,00110101,125,01111101
12,00001100,69,01000101,81,01010001
54,00110110,60,00111100,114,01110010
100,01100100,98,01100010,198,11000110
6,00000110,37,00100101,43,00101011
9,00001001,42,00101010,51,00110011
110,01101110,38,00100110,148,10010100
93,01011101,62,00111110,155,10011011
111,01101111,123,01111011,234,11101010
94,01011110,41,00101001,135,10000111
29,00011101,116,01110100,145,10010001
1,00000001,100,01100100,101,01100101
18,00010010,97,01100001,115,01110011
103,01100111,46,00101110,149,10010101
52,00110100,36,00100100,88,01011000
102,01100110,101,01100101,203,11001011
48,00110000,5,00000101,53,00110101
110,01101110,85,01010101,195,11000011
109,01101101,33,00100001,142,10001110
75,01001011,75,01001011,150,10010110
126,01111110,62,00111110,188,10111100
83,01010011,77,01001101,160,10100000
49,00110001,56,00111000,105,01101001
115,01110011,26,00011010,141,10001101
15,00001111,0,00000000,15,00001111
90,01011010,6,00000110,96,01100000
6,00000110,123,01111011,129,10000001
47,00101111,124,01111100,171,10101011
30,00011110,120,01111000,150,10010110
74,01001010,21,00010101,95,01011111
28,00011100,82,01010010,110,01101110
34,00100010,71,01000111,105,01101001
127,01111111,48,00110000,175,10101111
90,01011010,16,00010000,106,01101010
95,01011111,119,01110111,214,11010110
49,00110001,65,01000001,114,01110010
16,00010000,48,00110000,64,01000000
86,01010110,77,01001101,163,10100011
9,00001001,35,00100011,44,00101100
4,00000100,9,00001001,13,00001101
94,01011110,19,00010011,113,01110001
0,00000000,47,00101111,47,00101111
109,01101101,70,01000110,179,10110011
43,00101011,56,00111000,99,01100011
39,00100111,89,01011001,128,10000000
83,01010011,94,01011110,177,10110001
75,01001011,23,00010111,98,01100010
105,01101001,74,01001010,179,10110011
14,00001110,115,01110011,129,10000001
11,00001011,58,00111010,69,01000101
22,00010110,123,01111011,145,10010001
119,01110111,113,01110001,232,11101000
98,01100010,46,00101110,144,10010000
1,00000001,120,01111000,121,01111001
20,00010100,12,00001100,32,00100000
8,00001000,4,00000100,12,00001100
122,01111010,65,01000001,187,10111011
77,01001101,93,01011101,170,10101010
117,01110101,27,00011011,144,10010000
104,01101000,41,00101001,145,10010001
40,00101000,81,01010001,121,01111001
109,01101101,106,01101010,215,11010111
93,01011101,76,01001100,169,10101001
81,01010001,90,01011010,171,10101011
10,00001010,50,00110010,60,00111100
110,01101110,67,01000011,177,10110001
68,01000100,1,00000001,69,01000101
3,00000011,77,01001101,80,01010000
79,01001111,31,00011111,110,01101110
46,00101110,71,01000111,117,01110101
123,01111011,72,01001000,195,11000011
84,01010100,116,01110100,200,11001000
13,00001101,125,01111101,138,10001010
9,00001001,123,01111011,132,10000100
92,01011100,59,00111011,151,10010111
39,00100111,93,01011101,132,10000100
23,00010111,84,01010100,107,01101011
43,00101011,76,01001100,119,01110111
42,00101010,11,00001011,53,00110101
87,01010111,111,01101111,198,11000110
57,00111001,88,01011000,145,10010001
43,00101011,114,01110010,157,10011101
119,01110111,30,00011110,149,10010101
70,01000110,14,00001110,84,01010100
69,01000101,72,01001000,141,10001101
86,01010110,43,00101011,129,10000001
7,00000111,97,01100001,104,01101000
31,00011111,92,01011100,123,01111011
40,00101000,27,00011011,67,01000011
65,01000001,59,00111011,124,01111100
113,01110001,31,00011111,144,10010000
19,00010011,80,01010000,99,01100011
5,00000101,69,01000101,74,01001010
43,00101011,5,00000101,48,00110000
104,01101000,98,01100010,202,11001010
79,01001111,127,01111111,206,11001110
81,01010001,46,00101110,127,01111111
118,01110110,56,00111000,174,10101110
88,01011000,86,01010110,174,10101110
60,00111100,39,00100111,99,01100011
75,01001011,106,01101010,181,10110101
70,01000110,53,00110101,123,01111011
127,01111111,73,01001001,200,11001000
48,00110000,86,01010110,134,10000110
59,00111011,113,01110001,172,10101100
75,01001011,52,00110100,127,01111111
43,00101011,29,00011101,72,01001000
126,01111110,115,01110011,241,11110001
44,00101100,56,00111000,100,01100100
91,01011011,57,00111001,148,10010100
101,01100101,23,00010111,124,01111100
3,00000011,89,01011001,92,01011100
21,00010101,44,00101100,65,01000001
82,01010010,117,01110101,199,11000111
42,00101010,7,00000111,49,00110001
103,01100111,93,01011101,196,11000100
16,00010000,121,01111001,137,10001001
14,00001110,64,01000000,78,01001110
86,01010110,117,01110101,203,11001011
91,01011011,21,00010101,112,01110000
71,01000111,80,01010000,151,10010111
69,01000101,86,01010110,155,10011011
21,00010101,4,00000100,25,00011001
24,00011000,36,00100100,60,00111100
95,01011111,51,00110011,146,10010010
114,01110010,94,01011110,208,11010000
2,00000010,48,00110000,50,00110010
97,01100001,78,01001110,175,10101111
49,00110001,74,01001010,123,01111011
8,00001000,125,01111101,133,10000101
83,01010011,6,00000110,89,01011001
107,01101011,84,01010100,191,10111111
9,00001001,6,00000110,15,00001111
116,01110100,62,00111110,178,10110010
101,01100101,10,00001010,111,01101111
19,00010011,53,00110101,72,01001000
22,00010110,6,00000110,28,00011100
105,01101001,2,00000010,107,01101011
80,01010000,6,00000110,86,01010110
109,01101101,75,01001011,184,10111000
79,01001111,54,00110110,133,10000101
94,01011110,15,00001111,109,01101101
121,01111001,18,00010010,139,10001011
74,01001010,107,01101011,181,10110101
111,01101111,50,00110010,161,10100001
118,01110110,5,00000101,123,01111011
23,00010111,39,00100111,62,00111110
74,01001010,37,00100101,111,01101111
33,00100001,80,01010000,113,01110001
126,01111110,103,01100111,229,11100101
49,00110001,12,00001100,61,00111101
36,00100100,115,01110011,151,10010111
96,01100000,69,01000101,165,10100101
58,00111010,114,01110010,172,10101100
18,00010010,97,01100001,115,01110011
118,01110110,32,00100000,150,10010110
63,00111111,69,01000101,132,10000100
87,01010111,31,00011111,118,01110110
22,00010110,33,00100001,55,00110111
100,01100100,27,00011011,127,01111111
114,01110010,118,01110110,232,11101000
48,00110000,101,01100101,149,10010101
124,01111100,12,00001100,136,10001000
85,01010101,9,00001001,94,01011110
2,00000010,34,00100010,36,00100100
100,01100100,42,00101010,142,10001110
61,00111101,82,01010010,143,10001111
22,00010110,77,01001101,99,01100011
79,01001111,113,01110001,192,11000000
58,00111010,43,00101011,101,01100101
118,01110110,91,01011011,209,11010001
16,00010000,121,01111001,137,10001001
57,00111001,41,00101001,98,01100010
67,01000011,118,01110110,185,10111001
71,01000111,15,00001111,86,01010110
92,01011100,58,00111010,150,10010110
65,01000001,40,00101000,105,01101001
80,01010000,27,00011011,107,01101011
6,00000110,39,00100111,45,00101101
111,01101111,16,00010000,127,01111111
127,01111111,75,01001011,202,11001010
105,01101001,42,00101010,147,10010011
115,01110011,2,00000010,117,01110101
104,01101000,124,01111100,228,11100100
99,01100011,28,00011100,127,01111111
17,00010001,8,00001000,25,00011001
70,01000110,51,00110011,121,01111001
47,00101111,111,01101111,158,10011110
81,01010001,77,01001101,158,10011110
39,00100111,19,00010011,58,00111010
121,01111001,48,00110000,169,10101001
101,01100101,86,01010110,187,10111011
58,00111010,21,00010101,79,01001111
124,01111100,66,01000010,190,10111110
50,00110010,21,00010101,71,01000111
114,01110010,68,01000100,182,10110110
108,01101100,3,00000011,111,01101111
122,01111010,113,01110001,235,11101011
4,00000100,25,00011001,29,00011101
55,00110111,107,01101011,162,10100010
26,00011010,94,01011110,120,01111000
64,01000000,62,00111110,126,01111110
45,00101101,47,00101111,92,01011100
90,01011010,86,01010110,176,10110000
108,01101100,75,01001011,183,10110111
75,01001011,43,00101011,118,01110110
11,00001011,2,00000010,13,00001101
65,01000001,17,00010001,82,01010010
45,00101101,41,00101001,86,01010110
11,00001011,42,00101010,53,00110101
72,01001000,97,01100001,169,10101001
15,00001111,109,01101101,124,01111100
127,01111111,104,01101000,231,11100111
32,00100000,25,00011001,57,00111001
33,00100001,73,01001001,106,01101010
30,00011110,21,00010101,51,00110011
92,01011100,20,00010100,112,01110000
65,01000001,100,01100100,165,10100101
11,00001011,55,00110111,66,01000010
10,00001010,16,00010000,26,00011010
91,01011011,127,01111111,218,11011010
67,01000011,10,00001010,77,01001101
66,01000010,32,00100000,98,01100010
120,01111000,0,00000000,120,01111000
35,00100011,73,01001001,108,01101100
76,01001100,88,01011000,164,10100100
24,00011000,71,01000111,95,01011111
51,00110011,32,00100000,83,01010011
36,00100100,126,01111110,162,10100010
48,00110000,72,01001000,120,01111000
22,00010110,88,01011000,110,01101110
43,00101011,7,00000111,50,00110010
123,01111011,83,01010011,206,11001110
16,00010000,84,01010100,100,01100100
114,01110010,83,01010011,197,11000101
107,01101011,55,00110111,162,10100010
42,00101010,79,01001111,121,01111001
18,00010010,67,01000011,85,01010101
50,00110010,8,00001000,58,00111010
73,01001001,79,01001111,152,10011000
98,01100010,103,01100111,201,11001001
5,00000101,56,00111000,61,00111101
57,00111001,118,01110110,175,10101111
27,00011011,98,01100010,125,01111101
17,00010001,57,00111001,74,01001010
114,01110010,53,00110101,167,10100111
108,01101100,34,00100010,142,10001110
25,00011001,113,01110001,138,10001010
38,00100110,124,01111100,162,10100010
100,01100100,91,01011011,191,10111111
37,00100101,117,01110101,154,10011010
72,01001000,124,01111100,196,11000100
125,01111101,27,00011011,152,10011000
55,00110111,41,00101001,96,01100000
85,01010101,109,01101101,194,11000010
69,01000101,15,00001111,84,01010100
14,00001110,17,00010001,31,00011111
20,00010100,30,00011110,50,00110010
87,01010111,2,00000010,89,01011001
124,01111100,99,01100011,223,11011111
116,01110100,70,01000110,186,10111010
90,01011010,126,01111110,216,11011000
95,01011111,68,01000100,163,10100011
122,01111010,110,01101110,232,11101000
79,01001111,40,00101000,119,01110111
52,00110100,112,01110000,164,10100100
4,00000100,104,01101000,108,01101100
38,00100110,5,00000101,43,00101011
90,01011010,36,00100100,126,01111110
15,00001111,116,01110100,131,10000011
84,01010100,103,01100111,187,10111011
51,00110011,48,00110000,99,01100011
115,01110011,73,01001001,188,10111100
73,01001001,18,00010010,91,01011011
90,01011010,3,00000011,93,01011101
94,01011110,91,01011011,185,10111001
6,00000110,61,00111101,67,01000011
13,00001101,30,00011110,43,00101011
45,00101101,85,01010101,130,10000010
122,01111010,1,00000001,123,01111011
28,00011100,107,01101011,135,10000111
65,01000001,0,00000000,65,01000001
107,01101011,120,01111000,227,11100011
118,01110110,17,00010001,135,10000111
42,00101010,99,01100011,141,10001101
66,01000010,84,01010100,150,10010110
62,00111110,77,01001101,139,10001011
49,00110001,74,01001010,123,01111011
126,01111110,24,00011000,150,10010110
20,00010100,40,00101000,60,00111100
61,00111101,52,00110100,113,01110001
111,01101111,77,01001101,188,10111100
103,01100111,30,00011110,133,10000101
122,01111010,13,00001101,135,10000111
29,00011101,81,01010001,110,01101110
93,01011101,34,00100010,127,01111111
20,00010100,28,00011100,48,00110000
9,00001001,34,00100010,43,00101011
106,01101010,54,00110110,160,10100000
10,00001010,39,00100111,49,00110001
121,01111001,126,01111110,247,11110111
96,01100000,112,01110000,208,11010000
7,00000111,15,00001111,22,00010110
17,00010001,102,01100110,119,01110111
109,01101101,25,00011001,134,10000110
94,01011110,53,00110101,147,10010011
17,00010001,71,01000111,88,01011000
47,00101111,7,00000111,54,00110110
102,01100110,29,00011101,131,10000011
122,01111010,60,00111100,182,10110110
61,00111101,89,01011001,150,10010110
14,00001110,5,00000101,19,00010011
51,00110011,58,00111010,109,01101101
17,00010001,95,01011111,112,01110000
6,00000110,121,01111001,127,01111111
95,01011111,86,01010110,181,10110101
11,00001011,51,00110011,62,00111110
71,01000111,106,01101010,177,10110001
19,00010011,49,00110001,68,01000100
10,00001010,85,01010101,95,01011111
94,01011110,90,01011010,184,10111000
48,00110000,113,01110001,161,10100001
91,01011011,75,01001011,166,10100110
90,01011010,55,00110111,145,10010001
12,00001100,30,00011110,42,00101010
10,00001010,42,00101010,52,00110100
17,00010001,70,01000110,87,01010111
18,00010010,55,00110111,73,01001001
107,01101011,117,01110101,224,11100000
72,01001000,102,01100110,174,10101110
103,01100111,113,01110001,216,11011000
41,00101001,39,00100111,80,01010000
49,00110001,43,00101011,92,01011100
70,01000110,71,01000111,141,10001101
87,01010111,48,00110000,135,10000111
84,01010100,122,01111010,206,11001110
39,00100111,19,00010011,58,00111010
41,00101001,123,01111011,164,10100100
14,00001110,19,00010011,33,00100001
92,01011100,59,00111011,151,10010111
1,00000001,25,00011001,26,00011010
7,00000111,85,01010101,92,01011100
19,00010011,70,01000110,89,01011001
62,00111110,18,00010010,80,01010000
25,00011001,50,00110010,75,01001011
17,00010001,56,00111000,73,01001001
75,01001011,54,00110110,129,10000001
95,01011111,78,01001110,173,10101101
122,01111010,68,01000100,190,10111110
36,00100100,72,01001000,108,01101100
57,00111001,73,01001001,130,10000010
62,00111110,3,00000011,65,01000001
0,00000000,124,01111100,124,01111100
51,00110011,12,00001100,63,00111111
62,00111110,72,01001000,134,10000110
122,01111010,24,00011000,146,10010010
115,01110011,46,00101110,161,10100001
108,01101100,59,00111011,167,10100111
49,00110001,22,00010110,71,01000111
13,00001101,103,01100111,116,01110100
75,01001011,91,01011011,166,10100110
107,01101011,89,01011001,196,11000100
56,00111000,80,01010000,136,10001000
70,01000110,44,00101100,114,01110010
18,00010010,20,00010100,38,00100110
29,00011101,90,01011010,119,01110111
116,01110100,106,01101010,222,11011110
12,00001100,37,00100101,49,00110001
83,01010011,72,01001000,155,10011011
99,01100011,4,00000100,103,01100111
22,00010110,76,01001100,98,01100010
90,01011010,44,00101100,134,10000110
50,00110010,67,01000011,117,01110101
21,00010101,7,00000111,28,00011100
10,00001010,120,01111000,130,10000010
103,01100111,83,01010011,186,10111010
124,01111100,107,01101011,231,11100111
26,00011010,91,01011011,117,01110101
18,00010010,29,00011101,47,00101111
1,00000001,123,01111011,124,01111100
81,01010001,119,01110111,200,11001000
88,01011000,102,01100110,190,10111110
6,00000110,62,00111110,68,01000100
89,01011001,9,00001001,98,01100010
13,00001101,52,00110100,65,01000001
78,01001110,68,01000100,146,10010010
66,01000010,76,01001100,142,10001110
80,01010000,77,01001101,157,10011101
2,00000010,97,01100001,99,01100011
31,00011111,126,01111110,157,10011101
47,00101111,98,01100010,145,10010001
28,00011100,127,01111111,155,10011011
6,00000110,25,00011001,31,00011111
75,01001011,4,00000100,79,01001111
30,00011110,88,01011000,118,01110110
94,01011110,117,01110101,211,11010011
57,00111001,45,00101101,102,01100110
42,00101010,69,01000101,111,01101111
8,00001000,77,01001101,85,01010101
116,01110100,14,00001110,130,10000010
42,00101010,111,01101111,153,10011001
66,01000010,126,01111110,192,11000000
107,01101011,10,00001010,117,01110101
91,01011011,4,00000100,95,01011111
36,00100100,38,00100110,74,01001010
75,01001011,127,01111111,202,11001010
36,00100100,21,00010101,57,00111001
24,00011000,63,00111111,87,01010111
48,00110000,88,01011000,136,10001000
89,01011001,103,01100111,192,11000000
76,01001100,5,00000101,81,01010001
53,00110101,59,00111011,112,01110000
12,00001100,83,01010011,95,01011111
56,00111000,52,00110100,108,01101100
90,01011010,43,00101011,133,10000101
110,01101110,78,01001110,188,10111100
88,01011000,48,00110000,136,10001000
64,01000000,34,00100010,98,01100010
59,00111011,40,00101000,99,01100011
4,00000100,124,01111100,128,10000000
102,01100110,29,00011101,131,10000011
11,00001011,13,00001101,24,00011000
31,00011111,13,00001101,44,00101100
106,01101010,87,01010111,193,11000001
64,01000000,42,00101010,106,01101010
50,00110010,57,00111001,107,01101011
6,00000110,31,00011111,37,00100101
85,01010101,32,00100000,117,01110101
4,00000100,29,00011101,33,00100001
98,01100010,83,01010011,181,10110101
8,00001000,92,01011100,100,01100100
93,01011101,16,00010000,109,01101101
11,00001011,120,01111000,131,10000011
67,01000011,13,00001101,80,01010000
106,01101010,55,00110111,161,10100001
91,01011011,75,01001011,166,10100110
86,01010110,25,00011001,111,01101111
34,00100010,97,01100001,131,10000011
29,00011101,89,01011001,118,01110110
81,01010001,120,01111000,201,11001001
29,00011101,127,01111111,156,10011100
84,01010100,100,01100100,184,10111000
77,01001101,16,00010000,93,01011101
127,01111111,17,00010001,144,10010000
105,01101001,9,00001001,114,01110010
118,01110110,104,01101000,222,11011110
59,00111011,125,01111101,184,10111000
86,01010110,105,01101001,191,10111111
26,00011010,112,01110000,138,10001010
24,00011000,11,00001011,35,00100011
1,00000001,104,01101000,105,01101001
52,00110100,34,00100010,86,01010110
58,00111010,35,00100011,93,01011101
71,01000111,39,00100111,110,01101110
42,00101010,79,01001111,121,01111001
39,00100111,41,00101001,80,01010000
77,01001101,23,00010111,100,01100100
2,00000010,49,00110001,51,00110011
12,00001100,16,00010000,28,00011100
121,01111001,16,00010000,137,10001001
0,00000000,102,01100110,102,01100110
46,00101110,19,00010011,65,01000001
12,00001100,11,00001011,23,00010111
87,01010111,57,00111001,144,10010000
109,01101101,94,01011110,203,11001011
114,01110010,29,00011101,143,10001111
84,01010100,70,01000110,154,10011010
49,00110001,109,01101101,158,10011110
15,00001111,61,00111101,76,01001100
86,01010110,12,00001100,98,01100010
64,01000000,123,01111011,187,10111011
73,01001001,1,00000001,74,01001010
2,00000010,123,01111011,125,01111101
113,01110001,21,00010101,134,10000110
16,00010000,59,00111011,75,01001011
2,00000010,126,01111110,128,10000000
120,01111000,97,01100001,217,11011001
110,01101110,0,00000000,110,01101110
14,00001110,26,00011010,40,00101000
9,00001001,104,01101000,113,01110001
2,00000010,52,00110100,54,00110110
61,00111101,68,01000100,129,10000001
8,00001000,93,01011101,101,01100101
112,01110000,23,00010111,135,10000111
54,00110110,107,01101011,161,10100001
41,00101001,118,01110110,159,10011111
24,00011000,73,01001001,97,01100001
90,01011010,29,00011101,119,01110111
23,00010111,36,00100100,59,00111011
47,00101111,60,00111100,107,01101011
39,00100111,112,01110000,151,10010111
8,00001000,77,01001101,85,01010101
72,01001000,40,00101000,112,01110000
16,00010000,101,01100101,117,01110101
105,01101001,54,00110110,159,10011111
5,00000101,48,00110000,53,00110101
32,00100000,96,01100000,128,10000000
66,01000010,42,00101010,108,01101100
30,00011110,79,01001111,109,01101101
23,00010111,89,01011001,112,01110000
52,00110100,101,01100101,153,10011001
4,00000100,32,00100000,36,00100100
39,00100111,12,00001100,51,00110011
22,00010110,83,01010011,105,01101001
21,00010101,27,00011011,48,00110000
113,01110001,45,00101101,158,10011110
106,01101010,120,01111000,226,11100010
12,00001100,67,01000011,79,01001111
75,01001011,41,00101001,116,01110100
119,01110111,5,00000101,124,01111100
88,01011000,95,01011111,183,10110111
85,01010101,79,01001111,164,10100100
87,01010111,54,00110110,141,10001101
20,00010100,109,01101101,129,10000001
23,00010111,47,00101111,70,01000110
121,01111001,116,01110100,237,11101101
26,00011010,36,00100100,62,00111110
75,01001011,73,01001001,148,10010100
4,00000100,64,01000000,68,01000100
45,00101101,124,01111100,169,10101001
38,00100110,4,00000100,42,00101010
14,00001110,25,00011001,39,00100111
121,01111001,73,01001001,194,11000010
35,00100011,38,00100110,73,01001001
82,01010010,58,00111010,140,10001100
85,01010101,99,01100011,184,10111000
7,00000111,17,00010001,24,00011000
44,00101100,52,00110100,96,01100000
12,00001100,67,01000011,79,01001111
94,01011110,40,00101000,134,10000110
97,01100001,44,00101100,141,10001101
1,00000001,96,01100000,97,01100001
41,00101001,68,01000100,109,01101101
58,00111010,126,01111110,184,10111000
106,01101010,17,00010001,123,01111011
28,00011100,62,00111110,90,01011010
26,00011010,80,01010000,106,01101010
75,01001011,102,01100110,177,10110001
10,00001010,1,00000001,11,00001011
67,01000011,105,01101001,172,10101100
120,01111000,52,00110100,172,10101100
74,01001010,38,00100110,112,01110000
50,00110010,27,00011011,77,01001101
91,01011011,46,00101110,137,10001001
62,00111110,3,00000011,65,01000001
70,01000110,70,01000110,140,10001100
2,00000010,108,01101100,110,01101110
57,00111001,91,01011011,148,10010100
80,01010000,108,01101100,188,10111100
1,00000001,94,01011110,95,01011111
123,01111011,1,00000001,124,01111100
42,00101010,47,00101111,89,01011001
103,01100111,26,00011010,129,10000001
35,00100011,7,00000111,42,00101010
80,01010000,105,01101001,185,10111001
59,00111011,54,00110110,113,01110001
75,01001011,69,01000101,144,10010000
77,01001101,102,01100110,179,10110011
111,01101111,27,00011011,138,10001010
87,01010111,98,01100010,185,10111001
72,01001000,15,00001111,87,01010111
65,01000001,72,01001000,137,10001001
3,00000011,43,00101011,46,00101110
32,00100000,51,00110011,83,01010011
73,01001001,18,00010010,91,01011011
42,00101010,30,00011110,72,01001000
0,00000000,97,01100001,97,01100001
121,01111001,74,01001010,195,11000011
43,00101011,79,01001111,122,01111010
68,01000100,61,00111101,129,10000001
22,00010110,105,01101001,127,01111111
93,01011101,95,01011111,188,10111100
91,01011011,55,00110111,146,10010010
47,00101111,91,01011011,138,10001010
71,01000111,2,00000010,73,01001001
60,00111100,51,00110011,111,01101111
109,01101101,88,01011000,197,11000101
4,00000100,93,01011101,97,01100001
58,00111010,124,01111100,182,10110110
97,01100001,51,00110011,148,10010100
78,01001110,25,00011001,103,01100111
32,00100000,60,00111100,92,01011100
117,01110101,124,01111100,241,11110001
83,01010011,61,00111101,144,10010000
24,00011000,54,00110110,78,01001110
59,00111011,102,01100110,161,10100001
92,01011100,39,00100111,131,10000011
76,01001100,85,01010101,161,10100001
8,00001000,32,00100000,40,00101000
11,00001011,55,00110111,66,01000010
96,01100000,91,01011011,187,10111011
48,00110000,47,00101111,95,01011111
73,01001001,36,00100100,109,01101101
13,00001101,78,01001110,91,01011011
107,01101011,55,00110111,162,10100010
27,00011011,69,01000101,96,01100000
106,01101010,94,01011110,200,11001000
103,01100111,111,01101111,214,11010110
4,00000100,126,01111110,130,10000010
7,00000111,34,00100010,41,00101001
84,01010100,28,00011100,112,01110000
63,00111111,78,01001110,141,10001101
11,00001011,122,01111010,133,10000101
89,01011001,122,01111010,211,11010011
64,01000000,120,01111000,184,10111000
102,01100110,30,00011110,132,10000100
14,00001110,31,00011111,45,00101101
6,00000110,38,00100110,44,00101100
104,01101000,111,01101111,215,11010111
69,01000101,33,00100001,102,01100110
21,00010101,52,00110100,73,01001001
107,01101011,16,00010000,123,01111011
91,01011011,36,00100100,127,01111111
86,01010110,82,01010010,168,10101000
92,01011100,52,00110100,144,10010000
49,00110001,55,00110111,104,01101000
36,00100100,8,00001000,44,00101100
60,00111100,81,01010001,141,10001101
110,01101110,103,01100111,213,11010101
108,01101100,64,01000000,172,10101100
44,00101100,61,00111101,105,01101001
11,00001011,35,00100011,46,00101110
121,01111001,35,00100011,156,10011100
72,01001000,89,01011001,161,10100001
6,00000110,86,01010110,92,01011100
120,01111000,118,01110110,238,11101110
117,01110101,8,00001000,125,01111101
10,00001010,94,01011110,104,01101000
117,01110101,55,00110111,172,10101100
49,00110001,24,00011000,73,01001001
81,01010001,123,01111011,204,11001100
126,01111110,42,00101010,168,10101000
108,01101100,33,00100001,141,10001101
49,00110001,43,00101011,92,01011100
70,01000110,97,01100001,167,10100111
117,01110101,52,00110100,169,10101001
99,01100011,21,00010101,120,01111000
49,00110001,81,01010001,130,10000010
23,00010111,49,00110001,72,01001000
68,01000100,18,00010010,86,01010110
25,00011001,0,00000000,25,00011001
19,00010011,61,00111101,80,01010000
92,01011100,103,01100111,195,11000011
77,01001101,23,00010111,100,01100100
22,00010110,72,01001000,94,01011110
68,01000100,48,00110000,116,01110100
69,01000101,22,00010110,91,01011011
95,01011111,71,01000111,166,10100110
83,01010011,126,01111110,209,11010001
81,01010001,4,00000100,85,01010101
5,00000101,81,01010001,86,01010110
17,00010001,57,00111001,74,01001010
3,00000011,96,01100000,99,01100011
4,00000100,82,01010010,86,01010110
1,00000001,71,01000111,72,01001000
68,01000100,53,00110101,121,01111001
122,01111010,54,00110110,176,10110000
110,01101110,73,01001001,183,10110111
39,00100111,80,01010000,119,01110111
58,00111010,103,01100111,161,10100001
83,01010011,2,00000010,85,01010101
87,01010111,127,01111111,214,11010110
77,01001101,98,01100010,175,10101111
20,00010100,81,01010001,101,01100101
6,00000110,77,01001101,83,01010011
65,01000001,111,01101111,176,10110000
84,01010100,109,01101101,193,11000001
61,00111101,8,00001000,69,01000101
85,01010101,72,01001000,157,10011101
12,00001100,16,00010000,28,00011100
29,00011101,77,01001101,106,01101010
78,01001110,89,01011001,167,10100111
45,00101101,29,00011101,74,01001010
25,00011001,22,00010110,47,00101111
27,00011011,27,00011011,54,00110110
36,00100100,10,00001010,46,00101110
77,01001101,99,01100011,176,10110000
122,01111010,54,00110110,176,10110000
56,00111000,53,00110101,109,01101101
16,00010000,64,01000000,80,01010000
49,00110001,113,01110001,162,10100010
44,00101100,100,01100100,144,10010000
45,00101101,104,01101000,149,10010101
19,00010011,36,00100100,55,00110111
105,01101001,25,00011001,130,10000010
96,01100000,36,00100100,132,10000100
123,01111011,117,01110101,240,11110000
38,00100110,48,00110000,86,01010110
84,01010100,16,00010000,100,01100100
14,00001110,67,01000011,81,01010001
5,00000101,4,00000100,9,00001001
40,00101000,22,00010110,62,00111110
26,00011010,37,00100101,63,00111111
76,01001100,36,00100100,112,01110000
51,00110011,91,01011011,142,10001110
67,01000011,94,01011110,161,10100001
15,00001111,114,01110010,129,10000001
20,00010100,109,01101101,129,10000001
48,00110000,38,00100110,86,01010110
23,00010111,18,00010010,41,00101001
79,01001111,36,00100100,115,01110011
103,01100111,113,01110001,216,11011000
27,00011011,57,00111001,84,01010100
32,00100000,26,00011010,58,00111010
127,01111111,0,00000000,127,01111111
87,01010111,56,00111000,143,10001111
52,00110100,67,01000011,119,01110111
92,01011100,34,00100010,126,01111110
75,01001011,57,00111001,132,10000100
111,01101111,72,01001000,183,10110111
54,00110110,48,00110000,102,01100110
56,00111000,70,01000110,126,01111110
124,01111100,18,00010010,142,10001110
100,01100100,37,00100101,137,10001001
31,00011111,127,01111111,158,10011110
101,01100101,58,00111010,159,10011111
84,01010100,38,00100110,122,01111010
99,01100011,6,00000110,105,01101001
13,00001101,117,01110101,130,10000010
57,00111001,7,00000111,64,01000000
111,01101111,7,00000111,118,01110110
8,00001000,125,01111101,133,10000101
62,00111110,79,01001111,141,10001101
37,00100101,25,00011001,62,00111110
51,00110011,106,01101010,157,10011101
4,00000100,69,01000101,73,01001001
113,01110001,8,00001000,121,01111001
108,01101100,12,00001100,120,01111000
127,01111111,64,01000000,191,10111111
126,01111110,66,01000010,192,11000000
93,01011101,22,00010110,115,01110011
62,00111110,10,00001010,72,01001000
112,01110000,122,01111010,234,11101010
27,00011011,0,00000000,27,00011011
46,00101110,90,01011010,136,10001000
47,00101111,22,00010110,69,01000101
24,00011000,74,01001010,98,01100010
92,01011100,91,01011011,183,10110111
74,01001010,38,00100110,112,01110000
110,01101110,11,00001011,121,01111001
93,01011101,29,00011101,122,01111010
69,01000101,31,00011111,100,01100100
29,00011101,7,00000111,36,00100100
81,01010001,111,01101111,192,11000000
35,00100011,50,00110010,85,01010101
105,01101001,74,01001010,179,10110011
42,00101010,88,01011000,130,10000010
105,01101001,6,00000110,111,01101111
97,01100001,72,01001000,169,10101001
68,01000100,111,01101111,179,10110011
12,00001100,67,01000011,79,01001111
40,00101000,93,01011101,133,10000101
41,00101001,36,00100100,77,01001101
63,00111111,49,00110001,112,01110000
19,00010011,39,00100111,58,00111010
104,01101000,34,00100010,138,10001010
55,00110111,37,00100101,92,01011100
101,01100101,118,01110110,219,11011011
83,01010011,98,01100010,181,10110101
29,00011101,55,00110111,84,01010100
25,00011001,75,01001011,100,01100100
31,00011111,1,00000001,32,00100000
84,01010100,19,00010011,103,01100111
112,01110000,87,01010111,199,11000111
47,00101111,83,01010011,130,10000010
79,01001111,100,01100100,179,10110011
108,01101100,119,01110111,227,11100011
79,01001111,85,01010101,164,10100100
76,01001100,125,01111101,201,11001001
17,00010001,100,01100100,117,01110101
113,01110001,28,00011100,141,10001101
123,01111011,51,00110011,174,10101110
27,00011011,109,01101101,136,10001000
110,01101110,93,01011101,203,11001011
61,00111101,90,01011010,151,10010111
55,00110111,80,01010000,135,10000111
116,01110100,102,01100110,218,11011010
66,01000010,58,00111010,124,01111100
103,01100111,14,00001110,117,01110101
125,01111101,51,00110011,176,10110000
106,01101010,101,01100101,207,11001111
120,01111000,68,01000100,188,10111100
43,00101011,82,01010010,125,01111101
65,01000001,11,00001011,76,01001100
40,00101000,4,00000100,44,00101100
68,01000100,56,00111000,124,01111100
41,00101001,4,00000100,45,00101101
10,00001010,119,01110111,129,10000001
68,01000100,7,00000111,75,01001011
110,01101110,32,00100000,142,10001110
70,01000110,100,01100100,170,10101010
47,00101111,119,01110111,166,10100110
33,00100001,42,00101010,75,01001011
21,00010101,84,01010100,105,01101001
18,00010010,2,00000010,20,00010100
80,01010000,2,00000010,82,01010010
126,01111110,37,00100101,163,10100011
78,01001110,45,00101101,123,01111011
37,00100101,85,01010101,122,01111010
97,01100001,35,00100011,132,10000100
25,00011001,65,01000001,90,01011010
1,00000001,125,01111101,126,01111110
112,01110000,118,01110110,230,11100110
105,01101001,33,00100001,138,10001010
57,00111001,54,00110110,111,01101111
83,01010011,31,00011111,114,01110010
15,00001111,7,00000111,22,00010110
22,00010110,19,00010011,41,00101001
9,00001001,53,00110101,62,00111110
84,01010100,19,00010011,103,01100111
45,00101101,37,00100101,82,01010010
1,00000001,84,01010100,85,01010101
113,01110001,13,00001101,126,01111110
61,00111101,87,01010111,148,10010100
124,01111100,99,01100011,223,11011111
79,01001111,67,01000011,146,10010010
33,00100001,2,00000010,35,00100011
98,01100010,59,00111011,157,10011101
125,01111101,77,01001101,202,11001010
124,01111100,109,01101101,233,11101001
68,01000100,20,00010100,88,01011000
8,00001000,122,01111010,130,10000010
111,01101111,43,00101011,154,10011010
1,00000001,109,01101101,110,01101110
27,00011011,75,01001011,102,01100110
113,01110001,51,00110011,164,10100100
8,00001000,62,00111110,70,01000110
72,01001000,39,00100111,111,01101111
35,00100011,78,01001110,113,01110001
101,01100101,10,00001010,111,01101111
80,01010000,27,00011011,107,01101011
77,01001101,25,00011001,102,01100110
110,01101110,93,01011101,203,11001011
76,01001100,28,00011100,104,01101000
52,00110100,10,00001010,62,00111110
6,00000110,99,01100011,105,01101001
98,01100010,76,01001100,174,10101110
20,00010100,84,01010100,104,01101000
59,00111011,21,00010101,80,01010000
93,01011101,121,01111001,214,11010110
126,01111110,85,01010101,211,11010011
104,01101000,26,00011010,130,10000010
79,01001111,43,00101011,122,01111010
98,01100010,124,01111100,222,11011110
10,00001010,12,00001100,22,00010110
77,01001101,114,01110010,191,10111111
44,00101100,100,01100100,144,10010000
87,01010111,23,00010111,110,01101110
82,01010010,0,00000000,82,01010010
33,00100001,90,01011010,123,01111011
71,01000111,24,00011000,95,01011111
44,00101100,86,01010110,130,10000010
7,00000111,100,01100100,107,01101011
46,00101110,44,00101100,90,01011010
43,00101011,113,01110001,156,10011100
74,01001010,22,00010110,96,01100000
80,01010000,117,01110101,197,11000101
59,00111011,3,00000011,62,00111110
44,00101100,37,00100101,81,01010001
104,01101000,64,01000000,168,10101000
26,00011010,100,01100100,126,01111110
58,00111010,125,01111101,183,10110111
99,01100011,80,01010000,179,10110011
95,01011111,59,00111011,154,10011010
88,01011000,35,00100011,123,01111011
51,00110011,2,00000010,53,00110101
117,01110101,75,01001011,192,11000000
42,00101010,55,00110111,97,01100001
28,00011100,108,01101100,136,10001000
126,01111110,23,00010111,149,10010101
1,00000001,78,01001110,79,01001111
51,00110011,33,00100001,84,01010100
81,01010001,112,01110000,193,11000001
97,01100001,118,01110110,215,11010111
28,00011100,58,00111010,86,01010110
62,00111110,26,00011010,88,01011000
75,01001011,86,01010110,161,10100001
26,00011010,122,01111010,148,10010100
98,01100010,91,01011011,189,10111101
109,01101101,85,01010101,194,11000010
60,00111100,25,00011001,85,01010101
119,01110111,1,00000001,120,01111000
117,01110101,115,01110011,232,11101000
27,00011011,0,00000000,27,00011011
27,00011011,127,01111111,154,10011010
112,01110000,22,00010110,134,10000110
84,01010100,50,00110010,134,10000110
111,01101111,11,00001011,122,01111010
100,01100100,46,00101110,146,10010010
38,00100110,27,00011011,65,01000001
24,00011000,89,01011001,113,01110001
53,00110101,72,01001000,125,01111101
44,00101100,63,00111111,107,01101011
108,01101100,45,00101101,153,10011001
107,01101011,59,00111011,166,10100110
91,01011011,32,00100000,123,01111011
79,01001111,10,00001010,89,01011001
81,01010001,46,00101110,127,01111111
36,00100100,25,00011001,61,00111101
28,00011100,82,01010010,110,01101110
9,00001001,30,00011110,39,00100111
75,01001011,28,00011100,103,01100111
88,01011000,114,01110010,202,11001010
3,00000011,4,00000100,7,00000111
71,01000111,39,00100111,110,01101110
95,01011111,80,01010000,175,10101111
25,00011001,74,01001010,99,01100011
9,00001001,76,01001100,85,01010101
94,01011110,85,01010101,179,10110011
71,01000111,79,01001111,150,10010110
4,00000100,19,00010011,23,00010111
24,00011000,111,01101111,135,10000111
42,00101010,21,00010101,63,00111111
71,01000111,103,01100111,174,10101110
90,01011010,94,01011110,184,10111000
35,00100011,95,01011111,130,10000010
33,00100001,28,00011100,61,00111101
52,00110100,26,00011010,78,01001110
30,00011110,55,00110111,85,01010101
110,01101110,94,01011110,204,11001100
70,01000110,117,01110101,187,10111011
6,00000110,94,01011110,100,01100100
61,00111101,62,00111110,123,01111011
23,00010111,103,01100111,126,01111110
20,00010100,30,00011110,50,00110010
69,01000101,103,01100111,172,10101100
88,01011000,47,00101111,135,10000111
25,00011001,58,00111010,83,01010011
120,01111000,4,00000100,124,01111100
105,01101001,127,01111111,232,11101000
81,01010001,4,00000100,85,01010101
24,00011000,0,00000000,24,00011000
36,00100100,21,00010101,57,00111001
41,00101001,15,00001111,56,00111000
5,00000101,2,00000010,7,00000111
99,01100011,26,00011010,125,01111101
55,00110111,118,01110110,173,10101101
40,00101000,61,00111101,101,01100101
19,00010011,84,01010100,103,01100111
105,01101001,56,00111000,161,10100001
16,00010000,112,01110000,128,10000000
91,01011011,5,00000101,96,01100000
14,00001110,102,01100110,116,01110100
32,00100000,114,01110010,146,10010010
3,00000011,21,00010101,24,00011000
8,00001000,59,00111011,67,01000011
50,00110010,112,01110000,162,10100010
123,01111011,27,00011011,150,10010110
67,01000011,5,00000101,72,01001000
61,00111101,114,01110010,175,10101111
64,01000000,52,00110100,116,01110100
110,01101110,15,00001111,125,01111101
24,00011000,62,00111110,86,01010110
47,00101111,72,01001000,119,01110111
58,00111010,102,01100110,160,10100000
73,01001001,47,00101111,120,01111000
31,00011111,127,01111111,158,10011110
45,00101101,23,00010111,68,01000100
17,00010001,112,01110000,129,10000001
50,00110010,1,00000001,51,00110011
69,01000101,73,01001001,142,10001110
56,00111000,47,00101111,103,01100111
113,01110001,58,00111010,171,10101011
73,01001001,113,01110001,186,10111010
33,00100001,108,01101100,141,10001101
44,00101100,18,00010010,62,00111110
108,01101100,67,01000011,175,10101111
38,00100110,95,01011111,133,10000101
27,00011011,41,00101001,68,01000100
112,01110000,118,01110110,230,11100110
119,01110111,120,01111000,239,11101111
91,01011011,39,00100111,130,10000010
56,00111000,67,01000011,123,01111011
57,00111001,78,01001110,135,10000111
121,01111001,125,01111101,246,11110110
65,01000001,32,00100000,97,01100001
85,01010101,96,01100000,181,10110101
91,01011011,116,01110100,207,11001111
29,00011101,18,00010010,47,00101111
30,00011110,4,00000100,34,00100010
68,01000100,76,01001100,144,10010000
127,01111111,5,00000101,132,10000100
57,00111001,12,00001100,69,01000101
60,00111100,91,01011011,151,10010111
3,00000011,71,01000111,74,01001010
65,01000001,112,01110000,177,10110001
21,00010101,44,00101100,65,01000001
39,00100111,91,01011011,130,10000010
38,00100110,34,00100010,72,01001000
61,00111101,99,01100011,160,10100000
119,01110111,30,00011110,149,10010101
64,01000000,14,00001110,78,01001110
59,00111011,40,00101000,99,01100011
77,01001101,13,00001101,90,01011010
112,01110000,28,00011100,140,10001100
17,00010001,12,00001100,29,00011101
127,01111111,125,01111101,252,11111100
17,00010001,114,01110010,131,10000011
68,01000100,121,01111001,189,10111101
89,01011001,118,01110110,207,11001111
78,01001110,71,01000111,149,10010101
15,00001111,0,00000000,15,00001111
120,01111000,75,01001011,195,11000011
65,01000001,25,00011001,90,01011010
10,00001010,121,01111001,131,10000011
44,00101100,52,00110100,96,01100000
22,00010110,0,00000000,22,00010110
52,00110100,74,01001010,126,01111110
111,01101111,35,00100011,146,10010010
37,00100101,16,00010000,53,00110101
48,00110000,41,00101001,89,01011001
17,00010001,126,01111110,143,10001111
29,00011101,72,01001000,101,01100101
119,01110111,94,01011110,213,11010101
53,00110101,5,00000101,58,00111010
121,01111001,77,01001101,198,11000110
39,00100111,108,01101100,147,10010011
100,01100100,95,01011111,195,11000011
51,00110011,9,00001001,60,00111100
5,00000101,66,01000010,71,01000111
36,00100100,80,01010000,116,01110100
92,01011100,23,00010111,115,01110011
98,01100010,118,01110110,216,11011000
47,00101111,14,00001110,61,00111101
124,01111100,45,00101101,169,10101001
127,01111111,62,00111110,189,10111101
89,01011001,102,01100110,191,10111111
16,00010000,78,01001110,94,01011110
94,01011110,109,01101101,203,11001011
110,01101110,43,00101011,153,10011001
71,01000111,77,01001101,148,10010100
34,00100010,79,01001111,113,01110001
80,01010000,59,00111011,139,10001011
109,01101101,59,00111011,168,10101000
108,01101100,88,01011000,196,11000100
47,00101111,112,01110000,159,10011111
114,01110010,116,01110100,230,11100110
54,00110110,113,01110001,167,10100111
121,01111001,60,00111100,181,10110101
11,00001011,109,01101101,120,01111000
127,01111111,79,01001111,206,11001110
32,00100000,101,01100101,133,10000101
4,00000100,112,01110000,116,01110100
19,00010011,106,01101010,125,01111101
106,01101010,109,01101101,215,11010111
90,01011010,39,00100111,129,10000001
28,00011100,100,01100100,128,10000000
17,00010001,48,00110000,65,01000001
4,00000100,12,00001100,16,00010000
75,01001011,42,00101010,117,01110101
17,00010001,28,00011100,45,00101101
96,01100000,12,00001100,108,01101100
8,00001000,65,01000001,73,01001001
30,00011110,53,00110101,83,01010011
3,00000011,101,01100101,104,01101000
117,01110101,127,01111111,244,11110100
81,01010001,66,01000010,147,10010011
104,01101000,110,01101110,214,11010110
89,01011001,77,01001101,166,10100110
22,00010110,117,01110101,139,10001011
25,00011001,107,01101011,132,10000100
63,00111111,86,01010110,149,10010101
37,00100101,47,00101111,84,01010100
10,00001010,16,00010000,26,00011010
63,00111111,36,00100100,99,01100011
9,00001001,92,01011100,101,01100101
121,01111001,45,00101101,166,10100110
16,00010000,35,00100011,51,00110011
52,00110100,59,00111011,111,01101111
125,01111101,52,00110100,177,10110001
29,00011101,85,01010101,114,01110010
78,01001110,70,01000110,148,10010100
12,00001100,92,01011100,104,01101000
70,01000110,28,00011100,98,01100010
53,00110101,99,01100011,152,10011000
92,01011100,94,01011110,186,10111010
72,01001000,54,00110110,126,01111110
59,00111011,32,00100000,91,01011011
91,01011011,121,01111001,212,11010100
21,00010101,109,01101101,130,10000010
72,01001000,5,00000101,77,01001101
84,01010100,100,01100100,184,10111000
94,01011110,89,01011001,183,10110111
114,01110010,87,01010111,201,11001001
64,01000000,82,01010010,146,10010010
104,01101000,48,00110000,152,10011000
49,00110001,5,00000101,54,00110110
75,01001011,14,00001110,89,01011001
95,01011111,99,01100011,194,11000010
120,01111000,108,01101100,228,11100100
93,01011101,87,01010111,180,10110100
29,00011101,91,01011011,120,01111000
120,01111000,96,01100000,216,11011000
32,00100000,72,01001000,104,01101000
28,00011100,11,00001011,39,00100111
79,01001111,85,01010101,164,10100100
124,01111100,79,01001111,203,11001011
17,00010001,111,01101111,128,10000000
104,01101000,71,01000111,175,10101111
16,00010000,14,00001110,30,00011110
12,00001100,115,01110011,127,01111111
35,00100011,99,01100011,134,10000110
100,01100100,27,00011011,127,01111111
64,01000000,1,00000001,65,01000001
11,00001011,53,00110101,64,01000000
102,01100110,50,00110010,152,10011000
68,01000100,2,00000010,70,01000110
3,00000011,86,01010110,89,01011001
55,00110111,82,01010010,137,10001001
19,00010011,127,01111111,146,10010010
4,00000100,21,00010101,25,00011001
63,00111111,24,00011000,87,01010111
52,00110100,70,01000110,122,01111010
86,01010110,72,01001000,158,10011110
20,00010100,76,01001100,96,01100000
18,00010010,84,01010100,102,01100110
31,00011111,104,01101000,135,10000111
3,00000011,113,01110001,116,01110100
108,01101100,34,00100010,142,10001110
3,00000011,31,00011111,34,00100010
64,01000000,78,01001110,142,10001110
56,00111000,86,01010110,142,10001110
14,00001110,35,00100011,49,00110001
14,00001110,84,01010100,98,01100010
52,00110100,99,01100011,151,10010111
41,00101001,17,00010001,58,00111010
102,01100110,46,00101110,148,10010100
40,00101000,106,01101010,146,10010010
19,00010011,89,01011001,108,01101100
45,00101101,89,01011001,134,10000110
47,00101111,120,01111000,167,10100111
47,00101111,31,00011111,78,01001110
97,01100001,35,00100011,132,10000100
54,00110110,54,00110110,108,01101100
19,00010011,119,01110111,138,10001010
24,00011000,26,00011010,50,00110010
69,01000101,8,00001000,77,01001101
34,00100010,88,01011000,122,01111010
118,01110110,2,00000010,120,01111000
21,00010101,66,01000010,87,01010111
4,00000100,103,01100111,107,01101011
52,00110100,52,00110100,104,01101000
65,01000001,42,00101010,107,01101011
56,00111000,86,01010110,142,10001110
121,01111001,50,00110010,171,10101011
105,01101001,27,00011011,132,10000100
79,01001111,8,00001000,87,01010111
66,01000010,38,00100110,104,01101000
87,01010111,49,00110001,136,10001000
18,00010010,19,00010011,37,00100101
74,01001010,31,00011111,105,01101001
88,01011000,113,01110001,201,11001001
0,00000000,2,00000010,2,00000010
123,01111011,65,01000001,188,10111100
71,01000111,79,01001111,150,10010110
107,01101011,69,01000101,176,10110000
23,00010111,70,01000110,93,01011101
34,00100010,120,01111000,154,10011010
114,01110010,33,00100001,147,10010011
102,01100110,8,00001000,110,01101110
20,00010100,56,00111000,76,01001100
83,01010011,113,01110001,196,11000100
121,01111001,126,01111110,247,11110111
46,00101110,87,01010111,133,10000101
7,00000111,47,00101111,54,00110110
115,01110011,34,00100010,149,10010101
91,01011011,124,01111100,215,11010111
18,00010010,56,00111000,74,01001010
122,01111010,104,01101000,226,11100010
39,00100111,116,01110100,155,10011011
98,01100010,48,00110000,146,10010010
74,01001010,16,00010000,90,01011010
29,00011101,75,01001011,104,01101000
45,00101101,63,00111111,108,01101100
58,00111010,27,00011011,85,01010101
78,01001110,79,01001111,157,10011101
68,01000100,39,00100111,107,01101011
97,01100001,42,00101010,139,10001011
5,00000101,59,00111011,64,01000000
46,00101110,119,01110111,165,10100101
44,00101100,54,00110110,98,01100010
60,00111100,2,00000010,62,00111110
61,00111101,88,01011000,149,10010101
51,00110011,78,01001110,129,10000001
4,00000100,53,00110101,57,00111001
92,01011100,41,00101001,133,10000101
7,00000111,83,01010011,90,01011010
96,01100000,112,01110000,208,11010000
80,01010000,21,00010101,101,01100101
49,00110001,118,01110110,167,10100111
41,00101001,15,00001111,56,00111000
99,01100011,40,00101000,139,10001011
26,00011010,2,00000010,28,00011100
30,00011110,4,00000100,34,00100010
104,01101000,58,00111010,162,10100010
49,00110001,99,01100011,148,10010100
48,00110000,20,00010100,68,01000100
16,00010000,54,00110110,70,01000110
18,00010010,65,01000001,83,01010011
107,01101011,78,01001110,185,10111001
34,00100010,50,00110010,84,01010100
11,00001011,31,00011111,42,00101010
92,01011100,67,01000011,159,10011111
110,01101110,84,01010100,194,11000010
8,00001000,48,00110000,56,00111000
51,00110011,102,01100110,153,10011001
94,01011110,78,01001110,172,10101100
83,01010011,40,00101000,123,01111011
61,00111101,44,00101100,105,01101001
85,01010101,124,01111100,209,11010001
8,00001000,111,01101111,119,01110111
59,00111011,1,00000001,60,00111100
26,00011010,4,00000100,30,00011110
13,00001101,69,01000101,82,01010010
57,00111001,63,00111111,120,01111000
86,01010110,113,01110001,199,11000111
124,01111100,31,00011111,155,10011011
7,00000111,37,00100101,44,00101100
122,01111010,21,00010101,143,10001111
58,00111010,110,01101110,168,10101000
102,01100110,62,00111110,164,10100100
63,00111111,123,01111011,186,10111010
117,01110101,108,01101100,225,11100001
9,00001001,28,00011100,37,00100101
64,01000000,94,01011110,158,10011110
19,00010011,91,01011011,110,01101110
17,00010001,63,00111111,80,01010000
35,00100011,14,00001110,49,00110001
59,00111011,29,00011101,88,01011000
89,01011001,83,01010011,172,10101100
8,00001000,29,00011101,37,00100101
97,01100001,29,00011101,126,01111110
77,01001101,68,01000100,145,10010001
57,00111001,42,00101010,99,01100011
76,01001100,14,00001110,90,01011010
46,00101110,36,00100100,82,01010010
33,00100001,47,00101111,80,01010000
54,00110110,74,01001010,128,10000000
119,01110111,12,00001100,131,10000011
4,00000100,116,01110100,120,01111000
19,00010011,110,01101110,129,10000001
11,00001011,76,01001100,87,01010111
119,01110111,5,00000101,124,01111100
66,01000010,63,00111111,129,10000001
113,01110001,4,00000100,117,01110101
35,00100011,10,00001010,45,00101101
92,01011100,104,01101000,196,11000100
123,01111011,73,01001001,196,11000100
61,00111101,16,00010000,77,01001101
66,01000010,36,00100100,102,01100110
107,01101011,38,00100110,145,10010001
19,00010011,23,00010111,42,00101010
32,00100000,85,01010101,117,01110101
24,00011000,123,01111011,147,10010011
6,00000110,94,01011110,100,01100100
3,00000011,18,00010010,21,00010101
72,01001000,121,01111001,193,11000001
117,01110101,72,01001000,189,10111101
11,00001011,118,01110110,129,10000001
15,00001111,98,01100010,113,01110001
54,00110110,10,00001010,64,01000000
54,00110110,101,01100101,155,10011011
17,00010001,24,00011000,41,00101001
109,01101101,57,00111001,166,10100110
110,01101110,23,00010111,133,10000101
30,00011110,101,01100101,131,10000011
73,01001001,102,01100110,175,10101111
54,00110110,61,00111101,115,01110011
95,01011111,99,01100011,194,11000010
114,01110010,84,01010100,198,11000110
101,01100101,12,00001100,113,01110001
9,00001001,90,01011010,99,01100011
35,00100011,63,00111111,98,01100010
7,00000111,99,01100011,106,01101010
117,01110101,30,00011110,147,10010011
108,01101100,114,01110010,222,11011110
48,00110000,27,00011011,75,01001011
99,01100011,99,01100011,198,11000110
64,01000000,2,00000010,66,01000010
14,00001110,99,01100011,113,01110001
7,00000111,116,01110100,123,01111011
35,00100011,23,00010111,58,00111010
1,00000001,21,00010101,22,00010110
77,01001101,38,00100110,115,01110011
29,00011101,35,00100011,64,01000000
48,00110000,43,00101011,91,01011011
38,00100110,90,01011010,128,10000000
123,01111011,13,00001101,136,10001000
27,00011011,100,01100100,127,01111111
29,00011101,7,00000111,36,00100100
84,01010100,29,00011101,113,01110001
96,01100000,106,01101010,202,11001010
6,00000110,64,01000000,70,01000110
86,01010110,34,00100010,120,01111000
83,01010011,36,00100100,119,01110111
117,01110101,13,00001101,130,10000010
4,00000100,111,01101111,115,01110011
6,00000110,93,01011101,99,01100011
18,00010010,6,00000110,24,00011000
93,01011101,90,01011010,183,10110111
122,01111010,11,00001011,133,10000101
36,00100100,42,00101010,78,01001110
80,01010000,68,01000100,148,10010100
37,00100101,98,01100010,135,10000111
127,01111111,22,00010110,149,10010101
124,01111100,67,01000011,191,10111111
59,00111011,97,01100001,156,10011100
5,00000101,82,01010010,87,01010111
48,00110000,34,00100010,82,01010010
57,00111001,117,01110101,174,10101110
90,01011010,69,01000101,159,10011111
60,00111100,58,00111010,118,01110110
126,01111110,100,01100100,226,11100010
14,00001110,105,01101001,119,01110111
86,01010110,124,01111100,210,11010010
75,01001011,8,00001000,83,01010011
70,01000110,78,01001110,148,10010100
84,01010100,45,00101101,129,10000001
37,00100101,57,00111001,94,01011110
121,01111001,87,01010111,208,11010000
21,00010101,93,01011101,114,01110010
47,00101111,36,00100100,83,01010011
32,00100000,123,01111011,155,10011011
78,01001110,27,00011011,105,01101001
18,00010010,57,00111001,75,01001011
60,00111100,126,01111110,186,10111010
71,01000111,45,00101101,116,01110100
55,00110111,115,01110011,170,10101010
2,00000010,115,01110011,117,01110101
31,00011111,124,01111100,155,10011011
78,01001110,84,01010100,162,10100010
16,00010000,118,01110110,134,10000110
53,00110101,125,01111101,178,10110010
127,01111111,62,00111110,189,10111101
78,01001110,70,01000110,148,10010100
28,00011100,124,01111100,152,10011000
21,00010101,10,00001010,31,00011111
109,01101101,100,01100100,209,11010001
74,01001010,119,01110111,193,11000001
90,01011010,31,00011111,121,01111001
48,00110000,27,00011011,75,01001011
35,00100011,58,00111010,93,01011101
78,01001110,61,00111101,139,10001011
67,01000011,103,01100111,170,10101010
94,01011110,101,01100101,195,11000011
113,01110001,73,01001001,186,10111010
74,01001010,92,01011100,166,10100110
63,00111111,48,00110000,111,01101111
113,01110001,46,00101110,159,10011111
75,01001011,64,01000000,139,10001011
99,01100011,107,01101011,206,11001110
8,00001000,12,00001100,20,00010100
40,00101000,80,01010000,120,01111000
99,01100011,64,01000000,163,10100011
12,00001100,33,00100001,45,00101101
51,00110011,62,00111110,113,01110001
123,01111011,106,01101010,229,11100101
28,00011100,77,01001101,105,01101001
68,01000100,9,00001001,77,01001101
46,00101110,0,00000000,46,00101110
68,01000100,106,01101010,174,10101110
47,00101111,87,01010111,134,10000110
58,00111010,72,01001000,130,10000010
15,00001111,107,01101011,122,01111010
33,00100001,5,00000101,38,00100110
82,01010010,42,00101010,124,01111100
114,01110010,98,01100010,212,11010100
60,00111100,101,01100101,161,10100001
111,01101111,14,00001110,125,01111101
62,00111110,91,01011011,153,10011001
7,00000111,60,00111100,67,01000011
23,00010111,2,00000010,25,00011001
51,00110011,17,00010001,68,01000100
65,01000001,41,00101001,106,01101010
50,00110010,111,01101111,161,10100001
40,00101000,12,00001100,52,00110100
70,01000110,43,00101011,113,01110001
62,00111110,105,01101001,167,10100111
30,00011110,51,00110011,81,01010001
45,00101101,29,00011101,74,01001010
37,00100101,47,00101111,84,01010100
90,01011010,78,01001110,168,10101000
60,00111100,83,01010011,143,10001111
127,01111111,89,01011001,216,11011000
104,01101000,70,01000110,174,10101110
40,00101000,60,00111100,100,01100100
55,00110111,84,01010100,139,10001011
93,01011101,3,00000011,96,01100000
89,01011001,5,00000101,94,01011110
112,01110000,105,01101001,217,11011001
108,01101100,30,00011110,138,10001010
125,01111101,89,01011001,214,11010110
55,00110111,17,00010001,72,01001000
87,01010111,59,00111011,146,10010010
94,01011110,5,00000101,99,01100011
100,01100100,105,01101001,205,11001101
90,01011010,43,00101011,133,10000101
52,00110100,110,01101110,162,10100010
13,00001101,107,01101011,120,01111000
109,01101101,88,01011000,197,11000101
59,00111011,13,00001101,72,01001000
72,01001000,69,01000101,141,10001101
58,00111010,40,00101000,98,01100010
23,00010111,10,00001010,33,00100001
66,01000010,39,00100111,105,01101001
112,01110000,10,00001010,122,01111010
48,00110000,18,00010010,66,01000010
109,01101101,113,01110001,222,11011110
29,00011101,31,00011111,60,00111100
14,00001110,62,00111110,76,01001100
18,00010010,42,00101010,60,00111100
71,01000111,2,00000010,73,01001001
122,01111010,109,01101101,231,11100111
75,01001011,2,00000010,77,01001101
36,00100100,59,00111011,95,01011111
31,00011111,125,01111101,156,10011100
26,00011010,22,00010110,48,00110000
85,01010101,106,01101010,191,10111111
27,00011011,31,00011111,58,00111010
63,00111111,112,01110000,175,10101111
35,00100011,117,01110101,152,10011000
94,01011110,76,01001100,170,10101010
103,01100111,14,00001110,117,01110101
66,01000010,118,01110110,184,10111000
56,00111000,126,01111110,182,10110110
5,00000101,22,00010110,27,00011011
120,01111000,108,01101100,228,11100100
52,00110100,22,00010110,74,01001010
126,01111110,94,01011110,220,11011100
110,01101110,121,01111001,231,11100111
87,01010111,105,01101001,192,11000000
60,00111100,33,00100001,93,01011101
127,01111111,50,00110010,177,10110001
84,01010100,86,01010110,170,10101010
27,00011011,119,01110111,146,10010010
51,00110011,124,01111100,175,10101111
103,01100111,90,01011010,193,11000001
26,00011010,42,00101010,68,01000100
58,00111010,45,00101101,103,01100111
120,01111000,65,01000001,185,10111001
105,01101001,33,00100001,138,10001010
100,01100100,59,00111011,159,10011111
52,00110100,84,01010100,136,10001000
52,00110100,27,00011011,79,01001111
100,01100100,37,00100101,137,10001001
4,00000100,91,01011011,95,01011111
73,01001001,18,00010010,91,01011011
72,01001000,62,00111110,134,10000110
49,00110001,68,01000100,117,01110101
106,01101010,73,01001001,179,10110011
81,01010001,113,01110001,194,11000010
18,00010010,19,00010011,37,00100101
109,01101101,54,00110110,163,10100011
24,00011000,50,00110010,74,01001010
3,00000011,10,00001010,13,00001101
34,00100010,83,01010011,117,01110101
7,00000111,59,00111011,66,01000010
87,01010111,17,00010001,104,01101000
115,01110011,46,00101110,161,10100001
82,01010010,80,01010000,162,10100010
93,01011101,70,01000110,163,10100011
121,01111001,91,01011011,212,11010100
29,00011101,84,01010100,113,01110001
1,00000001,123,01111011,124,01111100
16,00010000,6,00000110,22,00010110
112,01110000,44,00101100,156,10011100
83,01010011,62,00111110,145,10010001
56,00111000,24,00011000,80,01010000
32,00100000,105,01101001,137,10001001
37,00100101,120,01111000,157,10011101
1,00000001,22,00010110,23,00010111
18,00010010,124,01111100,142,10001110
42,00101010,16,00010000,58,00111010
55,00110111,108,01101100,163,10100011
43,00101011,34,00100010,77,01001101
85,01010101,101,01100101,186,10111010
26,00011010,76,01001100,102,01100110
59,00111011,19,00010011,78,01001110
99,01100011,112,01110000,211,11010011
17,00010001,84,01010100,101,01100101
7,00000111,86,01010110,93,01011101
58,00111010,108,01101100,166,10100110
121,01111001,71,01000111,192,11000000
56,00111000,61,00111101,117,01110101
107,01101011,27,00011011,134,10000110
10,00001010,115,01110011,125,01111101
95,01011111,101,01100101,196,11000100
78,01001110,14,00001110,92,01011100
12,00001100,21,00010101,33,00100001
21,00010101,9,00001001,30,00011110
33,00100001,0,00000000,33,00100001
48,00110000,30,00011110,78,01001110
14,00001110,70,01000110,84,01010100
41,00101001,16,00010000,57,00111001
64,01000000,75,01001011,139,10001011
111,01101111,90,01011010,201,11001001
57,00111001,67,01000011,124,01111100
83,01010011,1,00000001,84,01010100
34,00100010,127,01111111,161,10100001
36,00100100,88,01011000,124,01111100
69,01000101,43,00101011,112,01110000
107,01101011,37,00100101,144,10010000
51,00110011,19,00010011,70,01000110
82,01010010,91,01011011,173,10101101
89,01011001,31,00011111,120,01111000
22,00010110,1,00000001,23,00010111
33,00100001,1,00000001,34,00100010
38,00100110,54,00110110,92,01011100
22,00010110,121,01111001,143,10001111
102,01100110,78,01001110,180,10110100
122,01111010,86,01010110,208,11010000
94,01011110,45,00101101,139,10001011
63,00111111,68,01000100,131,10000011
47,00101111,118,01110110,165,10100101
98,01100010,63,00111111,161,10100001
94,01011110,26,00011010,120,01111000
50,00110010,74,01001010,124,01111100
53,00110101,37,00100101,90,01011010
96,01100000,124,01111100,220,11011100
72,01001000,109,01101101,181,10110101
37,00100101,44,00101100,81,01010001
39,00100111,30,00011110,69,01000101
99,01100011,125,01111101,224,11100000
36,00100100,85,01010101,121,01111001
5,00000101,46,00101110,51,00110011
72,01001000,78,01001110,150,10010110
85,01010101,39,00100111,124,01111100
125,01111101,99,01100011,224,11100000
12,00001100,68,01000100,80,01010000
38,00100110,105,01101001,143,10001111
73,01001001,30,00011110,103,01100111
113,01110001,23,00010111,136,10001000
84,01010100,93,01011101,177,10110001
24,00011000,44,00101100,68,01000100
91,01011011,83,01010011,174,10101110
29,00011101,93,01011101,122,01111010
22,00010110,5,00000101,27,00011011
97,01100001,86,01010110,183,10110111
35,00100011,3,00000011,38,00100110
69,01000101,111,01101111,180,10110100
91,01011011,107,01101011,198,11000110
4,00000100,93,01011101,97,01100001
96,01100000,35,00100011,131,10000011
34,00100010,89,01011001,123,01111011
20,00010100,120,01111000,140,10001100
66,01000010,47,00101111,113,01110001
44,00101100,65,01000001,109,01101101
32,00100000,83,01010011,115,01110011
78,01001110,119,01110111,197,11000101
109,01101101,4,00000100,113,01110001
109,01101101,106,01101010,215,11010111
39,00100111,13,00001101,52,00110100
84,01010100,58,00111010,142,10001110
53,00110101,117,01110101,170,10101010
48,00110000,121,01111001,169,10101001
96,01100000,101,01100101,197,11000101
102,01100110,53,00110101,155,10011011
71,01000111,67,01000011,138,10001010
108,01101100,6,00000110,114,01110010
125,01111101,71,01000111,196,11000100
118,01110110,73,01001001,191,10111111
11,00001011,105,01101001,116,01110100
75,01001011,55,00110111,130,10000010
125,01111101,9,00001001,134,10000110
47,00101111,2,00000010,49,00110001
45,00101101,20,00010100,65,01000001
35,00100011,75,01001011,110,01101110
99,01100011,39,00100111,138,10001010
92,01011100,100,01100100,192,11000000
67,01000011,118,01110110,185,10111001
87,01010111,40,00101000,127,01111111
20,00010100,106,01101010,126,01111110
38,00100110,6,00000110,44,00101100
66,01000010,100,01100100,166,10100110
10,00001010,44,00101100,54,00110110
111,01101111,63,00111111,174,10101110
126,01111110,122,01111010,248,11111000
98,01100010,17,00010001,115,01110011
7,00000111,101,01100101,108,01101100
92,01011100,5,00000101,97,01100001
102,01100110,53,00110101,155,10011011
103,01100111,16,00010000,119,01110111
102,01100110,67,01000011,169,10101001
93,01011101,23,00010111,116,01110100
20,00010100,90,01011010,110,01101110
4,00000100,28,00011100,32,00100000
41,00101001,109,01101101,150,10010110
52,00110100,82,01010010,134,10000110
81,01010001,28,00011100,109,01101101
27,00011011,29,00011101,56,00111000
112,01110000,75,01001011,187,10111011
116,01110100,77,01001101,193,11000001
21,00010101,78,01001110,99,01100011
70,01000110,97,01100001,167,10100111
106,01101010,19,00010011,125,01111101
15,00001111,43,00101011,58,00111010
115,01110011,16,00010000,131,10000011
118,01110110,103,01100111,221,11011101
116,01110100,114,01110010,230,11100110
86,01010110,108,01101100,194,11000010
66,01000010,105,01101001,171,10101011
118,01110110,50,00110010,168,10101000
3,00000011,2,00000010,5,00000101
11,00001011,59,00111011,70,01000110
19,00010011,107,01101011,126,01111110
68,01000100,91,01011011,159,10011111
84,01010100,104,01101000,188,10111100
117,01110101,51,00110011,168,10101000
71,01000111,117,01110101,188,10111100
33,00100001,12,00001100,45,00101101
95,01011111,54,00110110,149,10010101
66,01000010,42,00101010,108,01101100
15,00001111,107,01101011,122,01111010
6,00000110,71,01000111,77,01001101
114,01110010,13,00001101,127,01111111
126,01111110,71,01000111,197,11000101
41,00101001,105,01101001,146,10010010
40,00101000,14,00001110,54,00110110
14,00001110,46,00101110,60,00111100
19,00010011,30,00011110,49,00110001
39,00100111,117,01110101,156,10011100
1,00000001,20,00010100,21,00010101
94,01011110,81,01010001,175,10101111
33,00100001,126,01111110,159,10011111
62,00111110,41,00101001,103,01100111
91,01011011,38,00100110,129,10000001
105,01101001,18,00010010,123,01111011
100,01100100,64,01000000,164,10100100
12,00001100,94,01011110,106,01101010
46,00101110,67,01000011,113,01110001
11,00001011,70,01000110,81,01010001
11,00001011,92,01011100,103,01100111
3,00000011,82,01010010,85,01010101
70,01000110,110,01101110,180,10110100
11,00001011,69,01000101,80,01010000
108,01101100,39,00100111,147,10010011
20,00010100,113,01110001,133,10000101
40,00101000,113,01110001,153,10011001
75,01001011,0,00000000,75,01001011
107,01101011,104,01101000,211,11010011
114,01110010,125,01111101,239,11101111
27,00011011,16,00010000,43,00101011
110,01101110,20,00010100,130,10000010
29,00011101,88,01011000,117,01110101
112,01110000,102,01100110,214,11010110
71,01000111,45,00101101,116,01110100
79,01001111,32,00100000,111,01101111
6,00000110,104,01101000,110,01101110
36,00100100,111,01101111,147,10010011
53,00110101,49,00110001,102,01100110
96,01100000,109,01101101,205,11001101
6,00000110,22,00010110,28,00011100
73,01001001,8,00001000,81,01010001
0,00000000,18,00010010,18,00010010
3,00000011,61,00111101,64,01000000
49,00110001,103,01100111,152,10011000
51,00110011,31,00011111,82,01010010
46,00101110,88,01011000,134,10000110
16,00010000,48,00110000,64,01000000
53,00110101,42,00101010,95,01011111
101,01100101,50,00110010,151,10010111
42,00101010,17,00010001,59,00111011
7,00000111,78,01001110,85,01010101
75,01001011,112,01110000,187,10111011
57,00111001,86,01010110,143,10001111
127,01111111,98,01100010,225,11100001
33,00100001,86,01010110,119,01110111
6,00000110,16,00010000,22,00010110
0,00000000,101,01100101,101,01100101
34,00100010,95,01011111,129,10000001
82,01010010,113,01110001,195,11000011
2,00000010,48,00110000,50,00110010
33,00100001,63,00111111,96,01100000
16,00010000,33,00100001,49,00110001
95,01011111,35,00100011,130,10000010
27,00011011,47,00101111,74,01001010
75,01001011,73,01001001,148,10010100
14,00001110,103,01100111,117,01110101
93,01011101,74,01001010,167,10100111
89,01011001,81,01010001,170,10101010
123,01111011,77,01001101,200,11001000
62,00111110,72,01001000,134,10000110
118,01110110,47,00101111,165,10100101
74,01001010,39,00100111,113,01110001
54,00110110,59,00111011,113,01110001
45,00101101,90,01011010,135,10000111
60,00111100,11,00001011,71,01000111
127,01111111,14,00001110,141,10001101
20,00010100,17,00010001,37,00100101
101,01100101,33,00100001,134,10000110
120,01111000,95,01011111,215,11010111
22,00010110,76,01001100,98,01100010
90,01011010,94,01011110,184,10111000
19,00010011,82,01010010,101,01100101
69,01000101,69,01000101,138,10001010
56,00111000,115,01110011,171,10101011
46,00101110,109,01101101,155,10011011
80,01010000,66,01000010,146,10010010
119,01110111,118,01110110,237,11101101
118,01110110,81,01010001,199,11000111
34,00100010,18,00010010,52,00110100
100,01100100,67,01000011,167,10100111
97,01100001,44,00101100,141,10001101
103,01100111,15,00001111,118,01110110
82,01010010,87,01010111,169,10101001
39,00100111,102,01100110,141,10001101
25,00011001,71,01000111,96,01100000
10,00001010,111,01101111,121,01111001
84,01010100,11,00001011,95,01011111
9,00001001,43,00101011,52,00110100
53,00110101,40,00101000,93,01011101
22,00010110,20,00010100,42,00101010
98,01100010,93,01011101,191,10111111
24,00011000,23,00010111,47,00101111
13,00001101,116,01110100,129,10000001
21,00010101,31,00011111,52,00110100
40,00101000,34,00100010,74,01001010
89,01011001,53,00110101,142,10001110
104,01101000,64,01000000,168,10101000
112,01110000,37,00100101,149,10010101
73,01001001,100,01100100,173,10101101
25,00011001,67,01000011,92,01011100
51,00110011,99,01100011,150,10010110
70,01000110,66,01000010,136,10001000
85,01010101,3,00000011,88,01011000
8,00001000,116,01110100,124,01111100
123,01111011,45,00101101,168,10101000
35,00100011,20,00010100,55,00110111
62,00111110,119,01110111,181,10110101
3,00000011,18,00010010,21,00010101
87,01010111,80,01010000,167,10100111
28,00011100,36,00100100,64,01000000
13,00001101,120,01111000,133,10000101
23,00010111,18,00010010,41,00101001
10,00001010,43,00101011,53,00110101
122,01111010,37,00100101,159,10011111
99,01100011,99,01100011,198,11000110
72,01001000,45,00101101,117,01110101
120,01111000,45,00101101,165,10100101
61,00111101,80,01010000,141,10001101
117,01110101,44,00101100,161,10100001
113,01110001,120,01111000,233,11101001
13,00001101,71,01000111,84,01010100
83,01010011,14,00001110,97,01100001
61,00111101,4,00000100,65,01000001
24,00011000,105,01101001,129,10000001
78,01001110,102,01100110,180,10110100
106,01101010,29,00011101,135,10000111
54,00110110,17,00010001,71,01000111
36,00100100,123,01111011,159,10011111
33,00100001,123,01111011,156,10011100
114,01110010,1,00000001,115,01110011
38,00100110,38,00100110,76,01001100
104,01101000,70,01000110,174,10101110
33,00100001,58,00111010,91,01011011
75,01001011,121,01111001,196,11000100
95,01011111,115,01110011,210,11010010
45,00101101,68,01000100,113,01110001
42,00101010,41,00101001,83,01010011
101,01100101,100,01100100,201,11001001
127,01111111,107,01101011,234,11101010
25,00011001,18,00010010,43,00101011
87,01010111,63,00111111,150,10010110
56,00111000,28,00011100,84,01010100
77,01001101,96,01100000,173,10101101
52,00110100,57,00111001,109,01101101
75,01001011,23,00010111,98,01100010
77,01001101,96,01100000,173,10101101
68,01000100,46,00101110,114,01110010
64,01000000,42,00101010,106,01101010
54,00110110,112,01110000,166,10100110
123,01111011,69,01000101,192,11000000
79,01001111,31,00011111,110,01101110
76,01001100,67,01000011,143,10001111
61,00111101,127,01111111,188,10111100
4,00000100,26,00011010,30,00011110
105,01101001,70,01000110,175,10101111
45,00101101,53,00110101,98,01100010
104,01101000,59,00111011,163,10100011
124,01111100,37,00100101,161,10100001
19,00010011,122,01111010,141,10001101
12,00001100,69,01000101,81,01010001
66,01000010,110,01101110,176,10110000
47,00101111,27,00011011,74,01001010
101,01100101,89,01011001,190,10111110
47,00101111,55,00110111,102,01100110
127,01111111,3,00000011,130,10000010
24,00011000,123,01111011,147,10010011
58,00111010,110,01101110,168,10101000
70,01000110,34,00100010,104,01101000
85,01010101,38,00100110,123,01111011
34,00100010,100,01100100,134,10000110
89,01011001,103,01100111,192,11000000
4,00000100,103,01100111,107,01101011
53,00110101,114,01110010,167,10100111
17,00010001,55,00110111,72,01001000
124,01111100,75,01001011,199,11000111
36,00100100,60,00111100,96,01100000
126,01111110,12,00001100,138,10001010
15,00001111,33,00100001,48,00110000
87,01010111,117,01110101,204,11001100
42,00101010,78,01001110,120,01111000
71,01000111,75,01001011,146,10010010
16,00010000,26,00011010,42,00101010
106,01101010,37,00100101,143,10001111
103,01100111,112,01110000,215,11010111
6,00000110,68,01000100,74,01001010
78,01001110,105,01101001,183,10110111
74,01001010,23,00010111,97,01100001
82,01010010,78,01001110,160,10100000
12,00001100,11,00001011,23,00010111
126,01111110,76,01001100,202,11001010
91,01011011,90,01011010,181,10110101
52,00110100,16,00010000,68,01000100
104,01101000,42,00101010,146,10010010
22,00010110,95,01011111,117,01110101
63,00111111,28,00011100,91,01011011
26,00011010,110,01101110,136,10001000
10,00001010,69,01000101,79,01001111
10,00001010,18,00010010,28,00011100
23,00010111,70,01000110,93,01011101
114,01110010,76,01001100,190,10111110
108,01101100,56,00111000,164,10100100
29,00011101,38,00100110,67,01000011
68,01000100,25,00011001,93,01011101
99,01100011,52,00110100,151,10010111
2,00000010,9,00001001,11,00001011
58,00111010,7,00000111,65,01000001
82,01010010,34,00100010,116,01110100
36,00100100,122,01111010,158,10011110
75,01001011,21,00010101,96,01100000
111,01101111,78,01001110,189,10111101
86,01010110,47,00101111,133,10000101
61,00111101,79,01001111,140,10001100
36,00100100,51,00110011,87,01010111
98,01100010,74,01001010,172,10101100
125,01111101,25,00011001,150,10010110
126,01111110,108,01101100,234,11101010
111,01101111,67,01000011,178,10110010
33,00100001,8,00001000,41,00101001
50,00110010,91,01011011,141,10001101
8,00001000,69,01000101,77,01001101
39,00100111,123,01111011,162,10100010
72,01001000,115,01110011,187,10111011
96,01100000,95,01011111,191,10111111
13,00001101,20,00010100,33,00100001
122,01111010,126,01111110,248,11111000
96,01100000,108,01101100,204,11001100
75,01001011,50,00110010,125,01111101
124,01111100,116,01110100,240,11110000
76,01001100,65,01000001,141,10001101
106,01101010,103,01100111,209,11010001
55,00110111,96,01100000,151,10010111
113,01110001,10,00001010,123,01111011
83,01010011,97,01100001,180,10110100
107,01101011,16,00010000,123,01111011
74,01001010,36,00100100,110,01101110
103,01100111,22,00010110,125,01111101
71,01000111,78,01001110,149,10010101
77,01001101,115,01110011,192,11000000
35,00100011,61,00111101,96,01100000
19,00010011,39,00100111,58,00111010
92,01011100,47,00101111,139,10001011
3,00000011,82,01010010,85,01010101
31,00011111,24,00011000,55,00110111
87,01010111,86,01010110,173,10101101
41,00101001,90,01011010,131,10000011
44,00101100,68,01000100,112,01110000
101,01100101,109,01101101,210,11010010
9,00001001,68,01000100,77,01001101
91,01011011,88,01011000,179,10110011
116,01110100,87,01010111,203,11001011
58,00111010,40,00101000,98,01100010
80,01010000,73,01001001,153,10011001
112,01110000,61,00111101,173,10101101
91,01011011,48,00110000,139,10001011
45,00101101,38,00100110,83,01010011
30,00011110,48,00110000,78,01001110
44,00101100,44,00101100,88,01011000
11,00001011,54,00110110,65,01000001
28,00011100,23,00010111,51,00110011
118,01110110,5,00000101,123,01111011
16,00010000,25,00011001,41,00101001
31,00011111,84,01010100,115,01110011
73,01001001,17,00010001,90,01011010
23,00010111,93,01011101,116,01110100
0,00000000,10,00001010,10,00001010
43,00101011,19,00010011,62,00111110
62,00111110,16,00010000,78,01001110
65,01000001,93,01011101,158,10011110
103,01100111,35,00100011,138,10001010
118,01110110,66,01000010,184,10111000
74,01001010,70,01000110,144,10010000
73,01001001,52,00110100,125,01111101
61,00111101,77,01001101,138,10001010
63,00111111,3,00000011,66,01000010
35,00100011,80,01010000,115,01110011
7,00000111,14,00001110,21,00010101
12,00001100,49,00110001,61,00111101
120,01111000,93,01011101,213,11010101
115,01110011,11,00001011,126,01111110
35,00100011,57,00111001,92,01011100
98,01100010,81,01010001,179,10110011
47,00101111,92,01011100,139,10001011
57,00111001,62,00111110,119,01110111
0,00000000,16,00010000,16,00010000
37,00100101,88,01011000,125,01111101
7,00000111,105,01101001,112,01110000
70,01000110,28,00011100,98,01100010
5,00000101,121,01111001,126,01111110
88,01011000,95,01011111,183,10110111
90,01011010,69,01000101,159,10011111
53,00110101,46,00101110,99,01100011
67,01000011,33,00100001,100,01100100
3,00000011,91,01011011,94,01011110
93,01011101,127,01111111,220,11011100
110,01101110,43,00101011,153,10011001
69,01000101,114,01110010,183,10110111
123,01111011,81,01010001,204,11001100
126,01111110,36,00100100,162,10100010
0,00000000,71,01000111,71,01000111
53,00110101,115,01110011,168,10101000
68,01000100,19,00010011,87,01010111
12,00001100,42,00101010,54,00110110
44,00101100,72,01001000,116,01110100
79,01001111,8,00001000,87,01010111
15,00001111,70,01000110,85,01010101
16,00010000,83,01010011,99,01100011
36,00100100,73,01001001,109,01101101
10,00001010,54,00110110,64,01000000
26,00011010,116,01110100,142,10001110
119,01110111,4,00000100,123,01111011
54,00110110,105,01101001,159,10011111
57,00111001,42,00101010,99,01100011
36,00100100,35,00100011,71,01000111
63,00111111,123,01111011,186,10111010
115,01110011,85,01010101,200,11001000
89,01011001,14,00001110,103,01100111
86,01010110,48,00110000,134,10000110
94,01011110,44,00101100,138,10001010
110,01101110,60,00111100,170,10101010
85,01010101,20,00010100,105,01101001
10,00001010,59,00111011,69,01000101
124,01111100,113,01110001,237,11101101
4,00000100,74,01001010,78,01001110
126,01111110,4,00000100,130,10000010
126,01111110,25,00011001,151,10010111
122,01111010,45,00101101,167,10100111
109,01101101,77,01001101,186,10111010
7,00000111,47,00101111,54,00110110
94,01011110,125,01111101,219,11011011
35,00100011,26,00011010,61,00111101
67,01000011,2,00000010,69,01000101
35,00100011,82,01010010,117,01110101
70,01000110,112,01110000,182,10110110
119,01110111,113,01110001,232,11101000
91,01011011,94,01011110,185,10111001
74,01001010,89,01011001,163,10100011
56,00111000,122,01111010,178,10110010
14,00001110,42,00101010,56,00111000
106,01101010,39,00100111,145,10010001
91,01011011,2,00000010,93,01011101
79,01001111,69,01000101,148,10010100
30,00011110,118,01110110,148,10010100
61,00111101,79,01001111,140,10001100
58,00111010,61,00111101,119,01110111
93,01011101,76,01001100,169,10101001
107,01101011,3,00000011,110,01101110
102,01100110,4,00000100,106,01101010
108,01101100,75,01001011,183,10110111
104,01101000,122,01111010,226,11100010
37,00100101,4,00000100,41,00101001
60,00111100,65,01000001,125,01111101
81,01010001,110,01101110,191,10111111
3,00000011,126,01111110,129,10000001
22,00010110,116,01110100,138,10001010
32,00100000,73,01001001,105,01101001
63,00111111,44,00101100,107,01101011
41,00101001,71,01000111,112,01110000
13,00001101,22,00010110,35,00100011
26,00011010,101,01100101,127,01111111
93,01011101,102,01100110,195,11000011
100,01100100,47,00101111,147,10010011
85,01010101,27,00011011,112,01110000
112,01110000,109,01101101,221,11011101
63,00111111,14,00001110,77,01001101
106,01101010,109,01101101,215,11010111
88,01011000,115,01110011,203,11001011
124,01111100,78,01001110,202,11001010
69,01000101,82,01010010,151,10010111
113,01110001,64,01000000,177,10110001
111,01101111,54,00110110,165,10100101
78,01001110,78,01001110,156,10011100
52,00110100,84,01010100,136,10001000
32,00100000,46,00101110,78,01001110
44,00101100,58,00111010,102,01100110
0,00000000,109,01101101,109,01101101
103,01100111,14,00001110,117,01110101
93,01011101,62,00111110,155,10011011
2,00000010,93,01011101,95,01011111
3,00000011,95,01011111,98,01100010
80,01010000,64,01000000,144,10010000
3,00000011,23,00010111,26,00011010
87,01010111,62,00111110,149,10010101
110,01101110,17,00010001,127,01111111
1,00000001,49,00110001,50,00110010
84,01010100,16,00010000,100,01100100
94,01011110,66,01000010,160,10100000
126,01111110,85,01010101,211,11010011
59,00111011,38,00100110,97,01100001
18,00010010,103,01100111,121,01111001
36,00100100,5,00000101,41,00101001
74,01001010,49,00110001,123,01111011
117,01110101,72,01001000,189,10111101
17,00010001,77,01001101,94,01011110
31,00011111,59,00111011,90,01011010
112,01110000,118,01110110,230,11100110
94,01011110,12,00001100,106,01101010
87,01010111,81,01010001,168,10101000
89,01011001,72,01001000,161,10100001
37,00100101,38,00100110,75,01001011
52,00110100,52,00110100,104,01101000
34,00100010,114,01110010,148,10010100
105,01101001,61,00111101,166,10100110
81,01010001,79,01001111,160,10100000
54,00110110,69,01000101,123,01111011
65,01000001,101,01100101,166,10100110
113,01110001,103,01100111,216,11011000
99,01100011,118,01110110,217,11011001
81,01010001,52,00110100,133,10000101
2,00000010,20,00010100,22,00010110
10,00001010,31,00011111,41,00101001
76,01001100,68,01000100,144,10010000
65,01000001,86,01010110,151,10010111
94,01011110,22,00010110,116,01110100
109,01101101,76,01001100,185,10111001
58,00111010,113,01110001,171,10101011
35,00100011,32,00100000,67,01000011
42,00101010,122,01111010,164,10100100
53,00110101,115,01110011,168,10101000
51,00110011,65,01000001,116,01110100
51,00110011,63,00111111,114,01110010
87,01010111,92,01011100,179,10110011
74,01001010,45,00101101,119,01110111
46,00101110,86,01010110,132,10000100
75,01001011,116,01110100,191,10111111
98,01100010,43,00101011,141,10001101
86,01010110,100,01100100,186,10111010
115,01110011,33,00100001,148,10010100
60,00111100,88,01011000,148,10010100
126,01111110,71,01000111,197,11000101
12,00001100,19,00010011,31,00011111
39,00100111,24,00011000,63,00111111
39,00100111,85,01010101,124,01111100
124,01111100,101,01100101,225,11100001
60,00111100,105,01101001,165,10100101
38,00100110,117,01110101,155,10011011
99,01100011,33,00100001,132,10000100
63,00111111,96,01100000,159,10011111
122,01111010,101,01100101,223,11011111
72,01001000,94,01011110,166,10100110
22,00010110,117,01110101,139,10001011
18,00010010,17,00010001,35,00100011
127,01111111,16,00010000,143,10001111
57,00111001,92,01011100,149,10010101
124,01111100,119,01110111,243,11110011
55,00110111,30,00011110,85,01010101
80,01010000,114,01110010,194,11000010
69,01000101,34,00100010,103,01100111
77,01001101,19,00010011,96,01100000
57,00111001,113,01110001,170,10101010
12,00001100,106,01101010,118,01110110
110,01101110,22,00010110,132,10000100
116,01110100,114,01110010,230,11100110
64,01000000,81,01010001,145,10010001
54,00110110,30,00011110,84,01010100
108,01101100,102,01100110,210,11010010
110,01101110,119,01110111,229,11100101
52,00110100,80,01010000,132,10000100
23,00010111,96,01100000,119,01110111
93,01011101,84,01010100,177,10110001
60,00111100,8,00001000,68,01000100
33,00100001,8,00001000,41,00101001
78,01001110,60,00111100,138,10001010
122,01111010,85,01010101,207,11001111
23,00010111,72,01001000,95,01011111
125,01111101,36,00100100,161,10100001
2,00000010,100,01100100,102,01100110
59,00111011,112,01110000,171,10101011
26,00011010,62,00111110,88,01011000
39,00100111,26,00011010,65,01000001
19,00010011,17,00010001,36,00100100
116,01110100,6,00000110,122,01111010
65,01000001,34,00100010,99,01100011
39,00100111,127,01111111,166,10100110
70,01000110,69,01000101,139,10001011
102,01100110,94,01011110,196,11000100
82,01010010,61,00111101,143,10001111
77,01001101,65,01000001,142,10001110
111,01101111,82,01010010,193,11000001
74,01001010,104,01101000,178,10110010
18,00010010,63,00111111,81,01010001
78,01001110,88,01011000,166,10100110
107,01101011,42,00101010,149,10010101
42,00101010,97,01100001,139,10001011
11,00001011,62,00111110,73,01001001
22,00010110,101,01100101,123,01111011
0,00000000,19,00010011,19,00010011
99,01100011,74,01001010,173,10101101
95,01011111,79,01001111,174,10101110
5,00000101,99,01100011,104,01101000
41,00101001,117,01110101,158,10011110
110,01101110,115,01110011,225,11100001
111,01101111,78,01001110,189,10111101
58,00111010,81,01010001,139,10001011
101,01100101,100,01100100,201,11001001
90,01011010,60,00111100,150,10010110
79,01001111,27,00011011,106,01101010
105,01101001,91,01011011,196,11000100
46,00101110,101,01100101,147,10010011
105,01101001,36,00100100,141,10001101
89,01011001,75,01001011,164,10100100
53,00110101,24,00011000,77,01001101
7,00000111,66,01000010,73,01001001
67,01000011,89,01011001,156,10011100
120,01111000,52,00110100,172,10101100
120,01111000,106,01101010,226,11100010
1,00000001,117,01110101,118,01110110
89,01011001,125,01111101,214,11010110
112,01110000,18,00010010,130,10000010
77,01001101,38,00100110,115,01110011
86,01010110,113,01110001,199,11000111
30,00011110,40,00101000,70,01000110
89,01011001,67,01000011,156,10011100
63,00111111,89,01011001,152,10011000
41,00101001,39,00100111,80,01010000
74,01001010,28,00011100,102,01100110
14,00001110,106,01101010,120,01111000
93,01011101,61,00111101,154,10011010
50,00110010,96,01100000,146,10010010
91,01011011,120,01111000,211,11010011
127,01111111,42,00101010,169,10101001
57,00111001,126,01111110,183,10110111
35,00100011,56,00111000,91,01011011
112,01110000,108,01101100,220,11011100
91,01011011,112,01110000,203,11001011
44,00101100,109,01101101,153,10011001
29,00011101,16,00010000,45,00101101
110,01101110,76,01001100,186,10111010
14,00001110,11,00001011,25,00011001
1,00000001,74,01001010,75,01001011
120,01111000,2,00000010,122,01111010
53,00110101,5,00000101,58,00111010
125,01111101,120,01111000,245,11110101
85,01010101,13,00001101,98,01100010
44,00101100,59,00111011,103,01100111
64,01000000,81,01010001,145,10010001
94,01011110,68,01000100,162,10100010
50,00110010,115,01110011,165,10100101
119,01110111,68,01000100,187,10111011
84,01010100,35,00100011,119,01110111
75,01001011,117,01110101,192,11000000
86,01010110,78,01001110,164,10100100
77,01001101,81,01010001,158,10011110
47,00101111,124,01111100,171,10101011
9,00001001,55,00110111,64,01000000
65,01000001,18,00010010,83,01010011
107,01101011,51,00110011,158,10011110
45,00101101,87,01010111,132,10000100
61,00111101,92,01011100,153,10011001
59,00111011,21,00010101,80,01010000
47,00101111,101,01100101,148,10010100
4,00000100,105,01101001,109,01101101
64,01000000,42,00101010,106,01101010
66,01000010,107,01101011,173,10101101
123,01111011,84,01010100,207,11001111
3,00000011,84,01010100,87,01010111
96,01100000,124,01111100,220,11011100
70,01000110,82,01010010,152,10011000
27,00011011,81,01010001,108,01101100
44,00101100,68,01000100,112,01110000
121,01111001,62,00111110,183,10110111
40,00101000,92,01011100,132,10000100
51,00110011,112,01110000,163,10100011
29,00011101,121,01111001,150,10010110
83,01010011,33,00100001,116,01110100
67,01000011,13,00001101,80,01010000
63,00111111,77,01001101,140,10001100
101,01100101,52,00110100,153,10011001
3,00000011,60,00111100,63,00111111
63,00111111,21,00010101,84,01010100
41,00101001,61,00111101,102,01100110
3,00000011,24,00011000,27,00011011
7,00000111,118,01110110,125,01111101
65,01000001,18,00010010,83,01010011
43,00101011,67,01000011,110,01101110
22,00010110,12,00001100,34,00100010
46,00101110,125,01111101,171,10101011
26,00011010,121,01111001,147,10010011
64,01000000,29,00011101,93,01011101
52,00110100,92,01011100,144,10010000
43,00101011,116,01110100,159,10011111
88,01011000,26,00011010,114,01110010
46,00101110,0,00000000,46,00101110
80,01010000,21,00010101,101,01100101
37,00100101,85,01010101,122,01111010
3,00000011,19,00010011,22,00010110
83,01010011,34,00100010,117,01110101
104,01101000,64,01000000,168,10101000
127,01111111,102,01100110,229,11100101
91,01011011,69,01000101,160,10100000
56,00111000,56,00111000,112,01110000
69,01000101,28,00011100,97,01100001
110,01101110,58,00111010,168,10101000
66,01000010,83,01010011,149,10010101
74,01001010,48,00110000,122,01111010
20,00010100,121,01111001,141,10001101
100,01100100,37,00100101,137,10001001
123,01111011,124,01111100,247,11110111
124,01111100,102,01100110,226,11100010
70,01000110,110,01101110,180,10110100
11,00001011,19,00010011,30,00011110
113,01110001,21,00010101,134,10000110
18,00010010,15,00001111,33,00100001
36,00100100,55,00110111,91,01011011
7,00000111,117,01110101,124,01111100
120,01111000,45,00101101,165,10100101
11,00001011,40,00101000,51,00110011
87,01010111,50,00110010,137,10001001
37,00100101,81,01010001,118,01110110
10,00001010,35,00100011,45,00101101
8,00001000,24,00011000,32,00100000
13,00001101,48,00110000,61,00111101
76,01001100,63,00111111,139,10001011
112,01110000,103,01100111,215,11010111
32,00100000,105,01101001,137,10001001
33,00100001,9,00001001,42,00101010
100,01100100,74,01001010,174,10101110
36,00100100,64,01000000,100,01100100
6,00000110,8,00001000,14,00001110
58,00111010,17,00010001,75,01001011
21,00010101,100,01100100,121,01111001
79,01001111,98,01100010,177,10110001
17,00010001,45,00101101,62,00111110
81,01010001,56,00111000,137,10001001
3,00000011,114,01110010,117,01110101
3,00000011,48,00110000,51,00110011
114,01110010,119,01110111,233,11101001
88,01011000,66,01000010,154,10011010
102,01100110,100,01100100,202,11001010
40,00101000,116,01110100,156,10011100
5,00000101,126,01111110,131,10000011
108,01101100,110,01101110,218,11011010
26,00011010,62,00111110,88,01011000
108,01101100,16,00010000,124,01111100
35,00100011,114,01110010,149,10010101
15,00001111,40,00101000,55,00110111
72,01001000,3,00000011,75,01001011
65,01000001,98,01100010,163,10100011
95,01011111,82,01010010,177,10110001
96,01100000,67,01000011,163,10100011
41,00101001,73,01001001,114,01110010
108,01101100,56,00111000,164,10100100
63,00111111,83,01010011,146,10010010
24,00011000,5,00000101,29,00011101
11,00001011,105,01101001,116,01110100
12,00001100,103,01100111,115,01110011
65,01000001,33,00100001,98,01100010
95,01011111,36,00100100,131,10000011
9,00001001,53,00110101,62,00111110
121,01111001,27,00011011,148,10010100
38,00100110,46,00101110,84,01010100
69,01000101,5,00000101,74,01001010
29,00011101,116,01110100,145,10010001
30,00011110,76,01001100,106,01101010
126,01111110,3,00000011,129,10000001
88,01011000,94,01011110,182,10110110
95,01011111,126,01111110,221,11011101
15,00001111,103,01100111,118,01110110
46,00101110,108,01101100,154,10011010
119,01110111,44,00101100,163,10100011
5,00000101,73,01001001,78,01001110
46,00101110,22,00010110,68,01000100
122,01111010,72,01001000,194,11000010
105,01101001,95,01011111,200,11001000
28,00011100,36,00100100,64,01000000
65,01000001,7,00000111,72,01001000
23,00010111,127,01111111,150,10010110
31,00011111,39,00100111,70,01000110
96,01100000,26,00011010,122,01111010
66,01000010,23,00010111,89,01011001
10,00001010,64,01000000,74,01001010
42,00101010,56,00111000,98,01100010
46,00101110,18,00010010,64,01000000
31,00011111,67,01000011,98,01100010
44,00101100,31,00011111,75,01001011
81,01010001,19,00010011,100,01100100
26,00011010,70,01000110,96,01100000
81,01010001,24,00011000,105,01101001
109,01101101,106,01101010,215,11010111
97,01100001,121,01111001,218,11011010
39,00100111,41,00101001,80,01010000
120,01111000,97,01100001,217,11011001
17,00010001,29,00011101,46,00101110
107,01101011,105,01101001,212,11010100
102,01100110,87,01010111,189,10111101
73,01001001,90,01011010,163,10100011
13,00001101,13,00001101,26,00011010
77,01001101,17,00010001,94,01011110
118,01110110,48,00110000,166,10100110
88,01011000,11,00001011,99,01100011
81,01010001,103,01100111,184,10111000
104,01101000,113,01110001,217,11011001
78,01001110,63,00111111,141,10001101
32,00100000,8,00001000,40,00101000
116,01110100,66,01000010,182,10110110
27,00011011,87,01010111,114,01110010
87,01010111,98,01100010,185,10111001
56,00111000,22,00010110,78,01001110
38,00100110,67,01000011,105,01101001
70,01000110,30,00011110,100,01100100
29,00011101,123,01111011,152,10011000
24,00011000,98,01100010,122,01111010
29,00011101,113,01110001,142,10001110
32,00100000,82,01010010,114,01110010
0,00000000,81,01010001,81,01010001
50,00110010,36,00100100,86,01010110
114,01110010,120,01111000,234,11101010
80,01010000,123,01111011,203,11001011
116,01110100,70,01000110,186,10111010
62,00111110,33,00100001,95,01011111
78,01001110,14,00001110,92,01011100
9,00001001,105,01101001,114,01110010
5,00000101,110,01101110,115,01110011
64,01000000,100,01100100,164,10100100
43,00101011,30,00011110,73,01001001
44,00101100,59,00111011,103,01100111
103,01100111,105,01101001,208,11010000
96,01100000,73,01001001,169,10101001
127,01111111,13,00001101,140,10001100
70,01000110,92,01011100,162,10100010
90,01011010,73,01001001,163,10100011
71,01000111,82,01010010,153,10011001
16,00010000,124,01111100,140,10001100
10,00001010,50,00110010,60,00111100
103,01100111,58,00111010,161,10100001
3,00000011,4,00000100,7,00000111
89,01011001,64,01000000,153,10011001
81,01010001,103,01100111,184,10111000
8,00001000,27,00011011,35,00100011
62,00111110,58,00111010,120,01111000
93,01011101,7,00000111,100,01100100
111,01101111,126,01111110,237,11101101
40,00101000,0,00000000,40,00101000
61,00111101,31,00011111,92,01011100
110,01101110,86,01010110,196,11000100
92,01011100,49,00110001,141,10001101
42,00101010,60,00111100,102,01100110
19,00010011,108,01101100,127,01111111
97,01100001,114,01110010,211,11010011
76,01001100,18,00010010,94,01011110
19,00010011,89,01011001,108,01101100
98,01100010,21,00010101,119,01110111
61,00111101,104,01101000,165,10100101
124,01111100,35,00100011,159,10011111
16,00010000,62,00111110,78,01001110
116,01110100,65,01000001,181,10110101
121,01111001,33,00100001,154,10011010
79,01001111,16,00010000,95,01011111
107,01101011,11,00001011,118,01110110
27,00011011,30,00011110,57,00111001
52,00110100,122,01111010,174,10101110
63,00111111,55,00110111,118,01110110
84,01010100,86,01010110,170,10101010
107,01101011,47,00101111,154,10011010
74,01001010,97,01100001,171,10101011
21,00010101,119,01110111,140,10001100
109,01101101,87,01010111,196,11000100
20,00010100,50,00110010,70,01000110
55,00110111,0,00000000,55,00110111
94,01011110,73,01001001,167,10100111
28,00011100,63,00111111,91,01011011
116,01110100,31,00011111,147,10010011
51,00110011,27,00011011,78,01001110
100,01100100,40,00101000,140,10001100
58,00111010,37,00100101,95,01011111
19,00010011,115,01110011,134,10000110
47,00101111,87,01010111,134,10000110
124,01111100,32,00100000,156,10011100
101,01100101,22,00010110,123,01111011
106,01101010,33,00100001,139,10001011
100,01100100,88,01011000,188,10111100
76,01001100,25,00011001,101,01100101
9,00001001,74,01001010,83,01010011
79,01001111,73,01001001,152,10011000
0,00000000,122,01111010,122,01111010
31,00011111,0,00000000,31,00011111
121,01111001,55,00110111,176,10110000
104,01101000,5,00000101,109,01101101
64,01000000,77,01001101,141,10001101
89,01011001,103,01100111,192,11000000
71,01000111,98,01100010,169,10101001
99,01100011,31,00011111,130,10000010
119,01110111,2,00000010,121,01111001
73,01001001,60,00111100,133,10000101
48,00110000,18,00010010,66,01000010
44,00101100,95,01011111,139,10001011
71,01000111,48,00110000,119,01110111
48,00110000,9,00001001,57,00111001
35,00100011,89,01011001,124,01111100
26,00011010,19,00010011,45,00101101
33,00100001,80,01010000,113,01110001
124,01111100,15,00001111,139,10001011
0,00000000,103,01100111,103,01100111
99,01100011,14,00001110,113,01110001
93,01011101,49,00110001,142,10001110
86,01010110,46,00101110,132,10000100
13,00001101,38,00100110,51,00110011
102,01100110,33,00100001,135,10000111
49,00110001,107,01101011,156,10011100
5,00000101,114,01110010,119,01110111
48,00110000,8,00001000,56,00111000
3,00000011,101,01100101,104,01101000
70,01000110,77,01001101,147,10010011
105,01101001,38,00100110,143,10001111
89,01011001,78,01001110,167,10100111
1,00000001,109,01101101,110,01101110
88,01011000,6,00000110,94,01011110
44,00101100,123,01111011,167,10100111
87,01010111,98,01100010,185,10111001
92,01011100,44,00101100,136,10001000
55,00110111,33,00100001,88,01011000
64,01000000,51,00110011,115,01110011
100,01100100,15,00001111,115,01110011
41,00101001,126,01111110,167,10100111
122,01111010,125,01111101,247,11110111
88,01011000,39,00100111,127,01111111
56,00111000,103,01100111,159,10011111
53,00110101,4,00000100,57,00111001
94,01011110,117,01110101,211,11010011
2,00000010,68,01000100,70,01000110
75,01001011,94,01011110,169,10101001
70,01000110,30,00011110,100,01100100
116,01110100,99,01100011,215,11010111
66,01000010,53,00110101,119,01110111
34,00100010,45,00101101,79,01001111
17,00010001,72,01001000,89,01011001
62,00111110,125,01111101,187,10111011
85,01010101,13,00001101,98,01100010
33,00100001,74,01001010,107,01101011
44,00101100,39,00100111,83,01010011
71,01000111,76,01001100,147,10010011
23,00010111,104,01101000,127,01111111
74,01001010,11,00001011,85,01010101
2,00000010,65,01000001,67,01000011
56,00111000,42,00101010,98,01100010
0,00000000,31,00011111,31,00011111
31,00011111,84,01010100,115,01110011
94,01011110,62,00111110,156,10011100
17,00010001,56,00111000,73,01001001
127,01111111,79,01001111,206,11001110
31,00011111,69,01000101,100,01100100
5,00000101,5,00000101,10,00001010
54,00110110,91,01011011,145,10010001
43,00101011,105,01101001,148,10010100
13,00001101,77,01001101,90,01011010
91,01011011,103,01100111,194,11000010
77,01001101,0,00000000,77,01001101
102,01100110,42,00101010,144,10010000
18,00010010,15,00001111,33,00100001
117,01110101,75,01001011,192,11000000
24,00011000,116,01110100,140,10001100
100,01100100,22,00010110,122,01111010
3,00000011,85,01010101,88,01011000
22,00010110,2,00000010,24,00011000
103,01100111,56,00111000,159,10011111
27,00011011,110,01101110,137,10001001
3,00000011,118,01110110,121,01111001
40,00101000,40,00101000,80,01010000
53,00110101,89,01011001,142,10001110
32,00100000,125,01111101,157,10011101
57,00111001,26,00011010,83,01010011
92,01011100,127,01111111,219,11011011
53,00110101,83,01010011,136,10001000
106,01101010,31,00011111,137,10001001
7,00000111,105,01101001,112,01110000
62,00111110,69,01000101,131,10000011
54,00110110,16,00010000,70,01000110
0,00000000,13,00001101,13,00001101
44,00101100,57,00111001,101,01100101
110,01101110,51,00110011,161,10100001
29,00011101,48,00110000,77,01001101
62,00111110,46,00101110,108,01101100
31,00011111,52,00110100,83,01010011
93,01011101,97,01100001,190,10111110
120,01111000,9,00001001,129,10000001
103,01100111,47,00101111,150,10010110
124,01111100,70,01000110,194,11000010
104,01101000,64,01000000,168,10101000
98,01100010,116,01110100,214,11010110
22,00010110,110,01101110,132,10000100
50,00110010,113,01110001,163,10100011
112,01110000,16,00010000,128,10000000
19,00010011,45,00101101,64,01000000
52,00110100,96,01100000,148,10010100
55,00110111,69,01000101,124,01111100
31,00011111,35,00100011,66,01000010
92,01011100,62,00111110,154,10011010
62,00111110,22,00010110,84,01010100
26,00011010,30,00011110,56,00111000
106,01101010,35,00100011,141,10001101
117,01110101,12,00001100,129,10000001
53,00110101,49,00110001,102,01100110
105,01101001,69,01000101,174,10101110
6,00000110,4,00000100,10,00001010
32,00100000,23,00010111,55,00110111
32,00100000,105,01101001,137,10001001
118,01110110,109,01101101,227,11100011
27,00011011,18,00010010,45,00101101
19,00010011,72,01001000,91,01011011
86,01010110,11,00001011,97,01100001
11,00001011,40,00101000,51,00110011
53,00110101,103,01100111,156,10011100
102,01100110,53,00110101,155,10011011
86,01010110,70,01000110,156,10011100
38,00100110,60,00111100,98,01100010
112,01110000,10,00001010,122,01111010
36,00100100,57,00111001,93,01011101
11,00001011,77,01001101,88,01011000
43,00101011,78,01001110,121,01111001
29,00011101,8,00001000,37,00100101
9,00001001,48,00110000,57,00111001
53,00110101,101,01100101,154,10011010
106,01101010,76,01001100,182,10110110
126,01111110,83,01010011,209,11010001
57,00111001,117,01110101,174,10101110
96,01100000,123,01111011,219,11011011
49,00110001,9,00001001,58,00111010
92,01011100,58,00111010,150,10010110
49,00110001,80,01010000,129,10000001
36,00100100,43,00101011,79,01001111
14,00001110,10,00001010,24,00011000
121,01111001,49,00110001,170,10101010
114,01110010,101,01100101,215,11010111
43,00101011,9,00001001,52,00110100
16,00010000,98,01100010,114,01110010
98,01100010,118,01110110,216,11011000
2,00000010,112,01110000,114,01110010
17,00010001,114,01110010,131,10000011
38,00100110,8,00001000,46,00101110
8,00001000,26,00011010,34,00100010
75,01001011,0,00000000,75,01001011
74,01001010,2,00000010,76,01001100
17,00010001,106,01101010,123,01111011
77,01001101,116,01110100,193,11000001
97,01100001,7,00000111,104,01101000
28,00011100,38,00100110,66,01000010
52,00110100,90,01011010,142,10001110
17,00010001,46,00101110,63,00111111
48,00110000,20,00010100,68,01000100
115,01110011,115,01110011,230,11100110
24,00011000,75,01001011,99,01100011
77,01001101,72,01001000,149,10010101
40,00101000,31,00011111,71,01000111
62,00111110,56,00111000,118,01110110
20,00010100,69,01000101,89,01011001
111,01101111,109,01101101,220,11011100
20,00010100,99,01100011,119,01110111
87,01010111,127,01111111,214,11010110
90,01011010,100,01100100,190,10111110
122,01111010,65,01000001,187,10111011
88,01011000,72,01001000,160,10100000
68,01000100,61,00111101,129,10000001
13,00001101,65,01000001,78,01001110
124,01111100,42,00101010,166,10100110
16,00010000,93,01011101,109,01101101
34,00100010,108,01101100,142,10001110
18,00010010,38,00100110,56,00111000
108,01101100,0,00000000,108,01101100
87,01010111,32,00100000,119,01110111
89,01011001,118,01110110,207,11001111
17,00010001,36,00100100,53,00110101
53,00110101,123,01111011,176,10110000
15,00001111,122,01111010,137,10001001
117,01110101,17,00010001,134,10000110
74,01001010,97,01100001,171,10101011
113,01110001,63,00111111,176,10110000
17,00010001,77,01001101,94,01011110
95,01011111,64,01000000,159,10011111
3,00000011,79,01001111,82,01010010
79,01001111,9,00001001,88,01011000
117,01110101,91,01011011,208,11010000
8,00001000,5,00000101,13,00001101
9,00001001,69,01000101,78,01001110
65,01000001,6,00000110,71,01000111
113,01110001,125,01111101,238,11101110
7,00000111,17,00010001,24,00011000
73,01001001,57,00111001,130,10000010
71,01000111,39,00100111,110,01101110
78,01001110,24,00011000,102,01100110
31,00011111,51,00110011,82,01010010
60,00111100,120,01111000,180,10110100
123,01111011,85,01010101,208,11010000
46,00101110,23,00010111,69,01000101
8,00001000,118,01110110,126,01111110
29,00011101,109,01101101,138,10001010
4,00000100,10,00001010,14,00001110
23,00010111,92,01011100,115,01110011
36,00100100,102,01100110,138,10001010
119,01110111,99,01100011,218,11011010
66,01000010,49,00110001,115,01110011
74,01001010,45,00101101,119,01110111
12,00001100,109,01101101,121,01111001
2,00000010,3,00000011,5,00000101
121,01111001,86,01010110,207,11001111
50,00110010,82,01010010,132,10000100
103,01100111,93,01011101,196,11000100
126,01111110,23,00010111,149,10010101
13,00001101,12,00001100,25,00011001
0,00000000,90,01011010,90,01011010
118,01110110,105,01101001,223,11011111
58,00111010,12,00001100,70,01000110
11,00001011,92,01011100,103,01100111
84,01010100,38,00100110,122,01111010
2,00000010,30,00011110,32,00100000
82,01010010,72,01001000,154,10011010
45,00101101,40,00101000,85,01010101
117,01110101,28,00011100,145,10010001
33,00100001,113,01110001,146,10010010
89,01011001,72,01001000,161,10100001
49,00110001,112,01110000,161,10100001
87,01010111,3,00000011,90,01011010
105,01101001,111,01101111,216,11011000
9,00001001,71,01000111,80,01010000
85,01010101,74,01001010,159,10011111
47,00101111,96,01100000,143,10001111
59,00111011,38,00100110,97,01100001
31,00011111,16,00010000,47,00101111
109,01101101,3,00000011,112,01110000
107,01101011,12,00001100,119,01110111
71,01000111,82,01010010,153,10011001
124,01111100,27,00011011,151,10010111
75,01001011,122,01111010,197,11000101
103,01100111,86,01010110,189,10111101
1,00000001,103,01100111,104,01101000
11,00001011,102,01100110,113,01110001
30,00011110,83,01010011,113,01110001
32,00100000,74,01001010,106,01101010
0,00000000,2,00000010,2,00000010
78,01001110,105,01101001,183,10110111
66,01000010,62,00111110,128,10000000
111,01101111,24,00011000,135,10000111
10,00001010,17,00010001,27,00011011
28,00011100,124,01111100,152,10011000
99,01100011,28,00011100,127,01111111
91,01011011,116,01110100,207,11001111
43,00101011,12,00001100,55,00110111
125,01111101,10,00001010,135,10000111
64,01000000,123,01111011,187,10111011
125,01111101,37,00100101,162,10100010
45,00101101,30,00011110,75,01001011
94,01011110,38,00100110,132,10000100
126,01111110,67,01000011,193,11000001
26,00011010,116,01110100,142,10001110
64,01000000,21,00010101,85,01010101
98,01100010,1,00000001,99,01100011
43,00101011,16,00010000,59,00111011
67,01000011,112,01110000,179,10110011
18,00010010,11,00001011,29,00011101
83,01010011,108,01101100,191,10111111
32,00100000,98,01100010,130,10000010
97,01100001,55,00110111,152,10011000
88,01011000,35,00100011,123,01111011
3,00000011,109,01101101,112,01110000
80,01010000,4,00000100,84,01010100
54,00110110,127,01111111,181,10110101
87,01010111,114,01110010,201,11001001
88,01011000,116,01110100,204,11001100
98,01100010,95,01011111,193,11000001
96,01100000,51,00110011,147,10010011
21,00010101,31,00011111,52,00110100
35,00100011,54,00110110,89,01011001
25,00011001,101,01100101,126,01111110
116,01110100,119,01110111,235,11101011
11,00001011,102,01100110,113,01110001
42,00101010,56,00111000,98,01100010
106,01101010,82,01010010,188,10111100
85,01010101,111,01101111,196,11000100
97,01100001,122,01111010,219,11011011
13,00001101,30,00011110,43,00101011
123,01111011,126,01111110,249,11111001
87,01010111,19,00010011,106,01101010
101,01100101,52,00110100,153,10011001
65,01000001,95,01011111,160,10100000
113,01110001,38,00100110,151,10010111
71,01000111,76,01001100,147,10010011
52,00110100,58,00111010,110,01101110
14,00001110,30,00011110,44,00101100
113,01110001,5,00000101,118,01110110
79,01001111,20,00010100,99,01100011
23,00010111,107,01101011,130,10000010
49,00110001,73,01001001,122,01111010
107,01101011,88,01011000,195,11000011
107,01101011,82,01010010,189,10111101
78,01001110,125,01111101,203,11001011
81,01010001,56,00111000,137,10001001
82,01010010,86,01010110,168,10101000
5,00000101,17,00010001,22,00010110
121,01111001,18,00010010,139,10001011
4,00000100,70,01000110,74,01001010
49,00110001,45,00101101,94,01011110
22,00010110,82,01010010,104,01101000
12,00001100,55,00110111,67,01000011
99,01100011,24,00011000,123,01111011
108,01101100,16,00010000,124,01111100
99,01100011,121,01111001,220,11011100
36,00100100,115,01110011,151,10010111
39,00100111,109,01101101,148,10010100
91,01011011,8,00001000,99,01100011
27,00011011,121,01111001,148,10010100
26,00011010,100,01100100,126,01111110
105,01101001,22,00010110,127,01111111
98,01100010,119,01110111,217,11011001
54,00110110,69,01000101,123,01111011
88,01011000,68,01000100,156,10011100
20,00010100,97,01100001,117,01110101
55,00110111,95,01011111,150,10010110
95,01011111,80,01010000,175,10101111
120,01111000,76,01001100,196,11000100
6,00000110,35,00100011,41,00101001
37,00100101,116,01110100,153,10011001
31,00011111,68,01000100,99,01100011
102,01100110,47,00101111,149,10010101
26,00011010,39,00100111,65,01000001
85,01010101,123,01111011,208,11010000
46,00101110,67,01000011,113,01110001
53,00110101,37,00100101,90,01011010
16,00010000,87,01010111,103,01100111
116,01110100,5,00000101,121,01111001
50,00110010,35,00100011,85,01010101
86,01010110,73,01001001,159,10011111
81,01010001,51,00110011,132,10000100
13,00001101,73,01001001,86,01010110
102,01100110,54,00110110,156,10011100
101,01100101,23,00010111,124,01111100
115,01110011,40,00101000,155,10011011
78,01001110,39,00100111,117,01110101
62,00111110,67,01000011,129,10000001
62,00111110,88,01011000,150,10010110
84,01010100,102,01100110,186,10111010
8,00001000,79,01001111,87,01010111
11,00001011,44,00101100,55,00110111
110,01101110,60,00111100,170,10101010
35,00100011,9,00001001,44,00101100
69,01000101,123,01111011,192,11000000
98,01100010,14,00001110,112,01110000
108,01101100,79,01001111,187,10111011
111,01101111,13,00001101,124,01111100
104,01101000,121,01111001,225,11100001
5,00000101,16,00010000,21,00010101
74,01001010,94,01011110,168,10101000
68,01000100,51,00110011,119,01110111
94,01011110,112,01110000,206,11001110
88,01011000,63,00111111,151,10010111
10,00001010,70,01000110,80,01010000
35,00100011,15,00001111,50,00110010
101,01100101,43,00101011,144,10010000
122,01111010,2,00000010,124,01111100
12,00001100,28,00011100,40,00101000
41,00101001,41,00101001,82,01010010
57,00111001,95,01011111,152,10011000
16,00010000,0,00000000,16,00010000
7,00000111,52,00110100,59,00111011
108,01101100,92,01011100,200,11001000
66,01000010,55,00110111,121,01111001
2,00000010,96,01100000,98,01100010
120,01111000,102,01100110,222,11011110
5,00000101,4,00000100,9,00001001
95,01011111,20,00010100,115,01110011
72,01001000,117,01110101,189,10111101
105,01101001,61,00111101,166,10100110
108,01101100,53,00110101,161,10100001
39,00100111,80,01010000,119,01110111
27,00011011,45,00101101,72,01001000
74,01001010,6,00000110,80,01010000
17,00010001,25,00011001,42,00101010
16,00010000,123,01111011,139,10001011
103,01100111,36,00100100,139,10001011
53,00110101,57,00111001,110,01101110
6,00000110,19,00010011,25,00011001
90,01011010,33,00100001,123,01111011
127,01111111,73,01001001,200,11001000
117,01110101,11,00001011,128,10000000
71,01000111,118,01110110,189,10111101
86,01010110,95,01011111,181,10110101
101,01100101,77,01001101,178,10110010
116,01110100,20,00010100,136,10001000
34,00100010,31,00011111,65,01000001
31,00011111,20,00010100,51,00110011
9,00001001,11,00001011,20,00010100
42,00101010,74,01001010,116,01110100
117,01110101,120,01111000,237,11101101
103,01100111,11,00001011,114,01110010
71,01000111,45,00101101,116,01110100
52,00110100,41,00101001,93,01011101
53,00110101,5,00000101,58,00111010
101,01100101,38,00100110,139,10001011
105,01101001,41,00101001,146,10010010
15,00001111,35,00100011,50,00110010
61,00111101,36,00100100,97,01100001
123,01111011,62,00111110,185,10111001
124,01111100,106,01101010,230,11100110
56,00111000,88,01011000,144,10010000
44,00101100,54,00110110,98,01100010
122,01111010,67,01000011,189,10111101
64,01000000,116,01110100,180,10110100
4,00000100,101,01100101,105,01101001
3,00000011,110,01101110,113,01110001
57,00111001,76,01001100,133,10000101
70,01000110,122,01111010,192,11000000
26,00011010,80,01010000,106,01101010
12,00001100,79,01001111,91,01011011
88,01011000,99,01100011,187,10111011
9,00001001,59,00111011,68,01000100
85,01010101,74,01001010,159,10011111
70,01000110,125,01111101,195,11000011
118,01110110,97,01100001,215,11010111
30,00011110,21,00010101,51,00110011
84,01010100,61,00111101,145,10010001
124,01111100,91,01011011,215,11010111
51,00110011,64,01000000,115,01110011
84,01010100,67,01000011,151,10010111
77,01001101,66,01000010,143,10001111
127,01111111,84,01010100,211,11010011
112,01110000,29,00011101,141,10001101
50,00110010,99,01100011,149,10010101
50,00110010,21,00010101,71,01000111
50,00110010,7,00000111,57,00111001
100,01100100,59,00111011,159,10011111
50,00110010,69,01000101,119,01110111
93,01011101,88,01011000,181,10110101
37,00100101,83,01010011,120,01111000
56,00111000,117,01110101,173,10101101
118,01110110,55,00110111,173,10101101
17,00010001,44,00101100,61,00111101
9,00001001,81,01010001,90,01011010
57,00111001,105,01101001,162,10100010
107,01101011,88,01011000,195,11000011
70,01000110,107,01101011,177,10110001
24,00011000,112,01110000,136,10001000
107,01101011,32,00100000,139,10001011
121,01111001,100,01100100,221,11011101
55,00110111,50,00110010,105,01101001
42,00101010,101,01100101,143,10001111
120,01111000,34,00100010,154,10011010
99,01100011,17,00010001,116,01110100
87,01010111,69,01000101,156,10011100
108,01101100,35,00100011,143,10001111
11,00001011,46,00101110,57,00111001
84,01010100,71,01000111,155,10011011
121,01111001,123,01111011,244,11110100
55,00110111,127,01111111,182,10110110
24,00011000,12,00001100,36,00100100
40,00101000,91,01011011,131,10000011
6,00000110,69,01000101,75,01001011
27,00011011,52,00110100,79,01001111
59,00111011,59,00111011,118,01110110
3,00000011,108,01101100,111,01101111
84,01010100,50,00110010,134,10000110
23,00010111,85,01010101,108,01101100
123,01111011,19,00010011,142,10001110
99,01100011,62,00111110,161,10100001
10,00001010,77,01001101,87,01010111
119,01110111,68,01000100,187,10111011
116,01110100,16,00010000,132,10000100
123,01111011,96,01100000,219,11011011
86,01010110,32,00100000,118,01110110
4,00000100,106,01101010,110,01101110
58,00111010,64,01000000,122,01111010
60,00111100,6,00000110,66,01000010
41,00101001,80,01010000,121,01111001
125,01111101,11,00001011,136,10001000
113,01110001,61,00111101,174,10101110
24,00011000,115,01110011,139,10001011
88,01011000,38,00100110,126,01111110
26,00011010,117,01110101,143,10001111
106,01101010,37,00100101,143,10001111
110,01101110,12,00001100,122,01111010
20,00010100,107,01101011,127,01111111
69,01000101,6,00000110,75,01001011
71,01000111,10,00001010,81,01010001
68,01000100,123,01111011,191,10111111
89,01011001,27,00011011,116,01110100
117,01110101,85,01010101,202,11001010
99,01100011,91,01011011,190,10111110
46,00101110,39,00100111,85,01010101
110,01101110,32,00100000,142,10001110
13,00001101,56,00111000,69,01000101
102,01100110,98,01100010,200,11001000
51,00110011,127,01111111,178,10110010
4,00000100,11,00001011,15,00001111
58,00111010,44,00101100,102,01100110
56,00111000,20,00010100,76,01001100
26,00011010,35,00100011,61,00111101
101,01100101,20,00010100,121,01111001
38,00100110,83,01010011,121,01111001
115,01110011,1,00000001,116,01110100
108,01101100,67,01000011,175,10101111
1,00000001,4,00000100,5,00000101
7,00000111,5,00000101,12,00001100
96,01100000,63,00111111,159,10011111
19,00010011,75,01001011,94,01011110
36,00100100,82,01010010,118,01110110
71,01000111,43,00101011,114,01110010
122,01111010,13,00001101,135,10000111
111,01101111,4,00000100,115,01110011
116,01110100,87,01010111,203,11001011
89,01011001,21,00010101,110,01101110
122,01111010,86,01010110,208,11010000
124,01111100,93,01011101,217,11011001
9,00001001,17,00010001,26,00011010
38,00100110,125,01111101,163,10100011
68,01000100,113,01110001,181,10110101
43,00101011,105,01101001,148,10010100
39,00100111,25,00011001,64,01000000
88,01011000,24,00011000,112,01110000
108,01101100,21,00010101,129,10000001
31,00011111,68,01000100,99,01100011
47,00101111,50,00110010,97,01100001
15,00001111,70,01000110,85,01010101
5,00000101,44,00101100,49,00110001
107,01101011,14,00001110,121,01111001
69,01000101,111,01101111,180,10110100
34,00100010,3,00000011,37,00100101
37,00100101,63,00111111,100,01100100
109,01101101,11,00001011,120,01111000
78,01001110,27,00011011,105,01101001
109,01101101,45,00101101,154,10011010
74,01001010,4,00000100,78,01001110
63,00111111,104,01101000,167,10100111
86,01010110,101,01100101,187,10111011
114,01110010,120,01111000,234,11101010
117,01110101,25,00011001,142,10001110
126,01111110,55,00110111,181,10110101
33,00100001,53,00110101,86,01010110
9,00001001,42,00101010,51,00110011
90,01011010,103,01100111,193,11000001
32,00100000,123,01111011,155,10011011
122,01111010,92,01011100,214,11010110
9,00001001,93,01011101,102,01100110
82,01010010,75,01001011,157,10011101
54,00110110,1,00000001,55,00110111
94,01011110,51,00110011,145,10010001
123,01111011,34,00100010,157,10011101
67,01000011,43,00101011,110,01101110
52,00110100,70,01000110,122,01111010
10,00001010,107,01101011,117,01110101
0,00000000,41,00101001,41,00101001
47,00101111,123,01111011,170,10101010
13,00001101,126,01111110,139,10001011
54,00110110,15,00001111,69,01000101
14,00001110,26,00011010,40,00101000
71,01000111,116,01110100,187,10111011
33,00100001,13,00001101,46,00101110
13,00001101,85,01010101,98,01100010
33,00100001,93,01011101,126,01111110
42,00101010,37,00100101,79,01001111
14,00001110,53,00110101,67,01000011
83,01010011,103,01100111,186,10111010
97,01100001,42,00101010,139,10001011
51,00110011,86,01010110,137,10001001
33,00100001,90,01011010,123,01111011
39,00100111,80,01010000,119,01110111
54,00110110,59,00111011,113,01110001
116,01110100,0,00000000,116,01110100
52,00110100,61,00111101,113,01110001
10,00001010,26,00011010,36,00100100
121,01111001,32,00100000,153,10011001
43,00101011,3,00000011,46,00101110
84,01010100,29,00011101,113,01110001
86,01010110,11,00001011,97,01100001
119,01110111,52,00110100,171,10101011
68,01000100,35,00100011,103,01100111
27,00011011,70,01000110,97,01100001
107,01101011,106,01101010,213,11010101
120,01111000,19,00010011,139,10001011
37,00100101,39,00100111,76,01001100
93,01011101,52,00110100,145,10010001
8,00001000,48,00110000,56,00111000
56,00111000,86,01010110,142,10001110
38,00100110,8,00001000,46,00101110
8,00001000,57,00111001,65,01000001
23,00010111,34,00100010,57,00111001
56,00111000,83,01010011,139,10001011
85,01010101,19,00010011,104,01101000
5,00000101,55,00110111,60,00111100
1,00000001,14,00001110,15,00001111
10,00001010,93,01011101,103,01100111
38,00100110,103,01100111,141,10001101
1,00000001,63,00111111,64,01000000
14,00001110,23,00010111,37,00100101
8,00001000,71,01000111,79,01001111
44,00101100,111,01101111,155,10011011
21,00010101,34,00100010,55,00110111
55,00110111,77,01001101,132,10000100
83,01010011,117,01110101,200,11001000
61,00111101,93,01011101,154,10011010
71,01000111,126,01111110,197,11000101
106,01101010,54,00110110,160,10100000
38,00100110,105,01101001,143,10001111
57,00111001,26,00011010,83,01010011
101,01100101,127,01111111,228,11100100
86,01010110,86,01010110,172,10101100
28,00011100,110,01101110,138,10001010
89,01011001,79,01001111,168,10101000
41,00101001,19,00010011,60,00111100
124,01111100,97,01100001,221,11011101
77,01001101,80,01010000,157,10011101
74,01001010,51,00110011,125,01111101
84,01010100,83,01010011,167,10100111
113,01110001,16,00010000,129,10000001
88,01011000,44,00101100,132,10000100
92,01011100,75,01001011,167,10100111
37,00100101,121,01111001,158,10011110
81,01010001,53,00110101,134,10000110
83,01010011,14,00001110,97,01100001
29,00011101,92,01011100,121,01111001
91,01011011,120,01111000,211,11010011
35,00100011,15,00001111,50,00110010
18,00010010,104,01101000,122,01111010
95,01011111,55,00110111,150,10010110
50,00110010,109,01101101,159,10011111
73,01001001,19,00010011,92,01011100
56,00111000,82,01010010,138,10001010
12,00001100,30,00011110,42,00101010
124,01111100,84,01010100,208,11010000
76,01001100,94,01011110,170,10101010
127,01111111,18,00010010,145,10010001
54,00110110,60,00111100,114,01110010
14,00001110,83,01010011,97,01100001
20,00010100,21,00010101,41,00101001
121,01111001,98,01100010,219,11011011
106,01101010,30,00011110,136,10001000
86,01010110,43,00101011,129,10000001
53,00110101,58,00111010,111,01101111
72,01001000,18,00010010,90,01011010
78,01001110,10,00001010,88,01011000
33,00100001,107,01101011,140,10001100
23,00010111,99,01100011,122,01111010
94,01011110,60,00111100,154,10011010
65,01000001,30,00011110,95,01011111
66,01000010,19,00010011,85,01010101
20,00010100,121,01111001,141,10001101
97,01100001,53,00110101,150,10010110
46,00101110,127,01111111,173,10101101
9,00001001,108,01101100,117,01110101
74,01001010,39,00100111,113,01110001
71,01000111,60,00111100,131,10000011
42,00101010,2,00000010,44,00101100
96,01100000,23,00010111,119,01110111
125,01111101,69,01000101,194,11000010
100,01100100,120,01111000,220,11011100
93,01011101,127,01111111,220,11011100
60,00111100,60,00111100,120,01111000
82,01010010,23,00010111,105,01101001
1,00000001,80,01010000,81,01010001
76,01001100,99,01100011,175,10101111
60,00111100,69,01000101,129,10000001
29,00011101,84,01010100,113,01110001
54,00110110,11,00001011,65,01000001
106,01101010,31,00011111,137,10001001
108,01101100,72,01001000,180,10110100
84,01010100,36,00100100,120,01111000
68,01000100,126,01111110,194,11000010
46,00101110,33,00100001,79,01001111
51,00110011,49,00110001,100,01100100
87,01010111,56,00111000,143,10001111
117,01110101,115,01110011,232,11101000
91,01011011,26,00011010,117,01110101
21,00010101,58,00111010,79,01001111
100,01100100,98,01100010,198,11000110
17,00010001,56,00111000,73,01001001
62,00111110,114,01110010,176,10110000
86,01010110,104,01101000,190,10111110
21,00010101,36,00100100,57,00111001
111,01101111,89,01011001,200,11001000
105,01101001,67,01000011,172,10101100
25,00011001,63,00111111,88,01011000
115,01110011,78,01001110,193,11000001
67,01000011,110,01101110,177,10110001
99,01100011,122,01111010,221,11011101
25,00011001,80,01010000,105,01101001
111,01101111,82,01010010,193,11000001
34,00100010,9,00001001,43,00101011
23,00010111,101,01100101,124,01111100
96,01100000,101,01100101,197,11000101
118,01110110,127,01111111,245,11110101
55,00110111,62,00111110,117,01110101
46,00101110,28,00011100,74,01001010
126,01111110,77,01001101,203,11001011
50,00110010,12,00001100,62,00111110
100,01100100,57,00111001,157,10011101
60,00111100,115,01110011,175,10101111
126,01111110,2,00000010,128,10000000
14,00001110,87,01010111,101,01100101
68,01000100,115,01110011,183,10110111
55,00110111,35,00100011,90,01011010
126,01111110,64,01000000,190,10111110
111,01101111,115,01110011,226,11100010
11,00001011,88,01011000,99,01100011
102,01100110,73,01001001,175,10101111
113,01110001,110,01101110,223,11011111
81,01010001,72,01001000,153,10011001
74,01001010,71,01000111,145,10010001
120,01111000,113,01110001,233,11101001
67,01000011,23,00010111,90,01011010
34,00100010,117,01110101,151,10010111
22,00010110,70,01000110,92,01011100
58,00111010,101,01100101,159,10011111
76,01001100,105,01101001,181,10110101
83,01010011,126,01111110,209,11010001
72,01001000,33,00100001,105,01101001
125,01111101,113,01110001,238,11101110
95,01011111,5,00000101,100,01100100
120,01111000,81,01010001,201,11001001
51,00110011,2,00000010,53,00110101
103,01100111,17,00010001,120,01111000
33,00100001,40,00101000,73,01001001
79,01001111,61,00111101,140,10001100
68,01000100,0,00000000,68,01000100
84,01010100,72,01001000,156,10011100
1,00000001,19,00010011,20,00010100
123,01111011,85,01010101,208,11010000
14,00001110,70,01000110,84,01010100
48,00110000,5,00000101,53,00110101
98,01100010,48,00110000,146,10010010
73,01001001,94,01011110,167,10100111
127,01111111,122,01111010,249,11111001
125,01111101,35,00100011,160,10100000
43,00101011,122,01111010,165,10100101
108,01101100,2,00000010,110,01101110
95,01011111,69,01000101,164,10100100
103,01100111,35,00100011,138,10001010
58,00111010,4,00000100,62,00111110
99,01100011,33,00100001,132,10000100
91,01011011,96,01100000,187,10111011
20,00010100,31,00011111,51,00110011
123,01111011,62,00111110,185,10111001
29,00011101,125,01111101,154,10011010
88,01011000,93,01011101,181,10110101
21,00010101,101,01100101,122,01111010
88,01011000,113,01110001,201,11001001
14,00001110,119,01110111,133,10000101
56,00111000,112,01110000,168,10101000
119,01110111,20,00010100,139,10001011
115,01110011,115,01110011,230,11100110
43,00101011,97,01100001,140,10001100
70,01000110,5,00000101,75,01001011
11,00001011,79,01001111,90,01011010
8,00001000,41,00101001,49,00110001
11,00001011,13,00001101,24,00011000
23,00010111,74,01001010,97,01100001
101,01100101,20,00010100,121,01111001
64,01000000,18,00010010,82,01010010
31,00011111,18,00010010,49,00110001
72,01001000,5,00000101,77,01001101
54,00110110,19,00010011,73,01001001
55,00110111,21,00010101,76,01001100
98,01100010,127,01111111,225,11100001
22,00010110,50,00110010,72,01001000
110,01101110,57,00111001,167,10100111
81,01010001,2,00000010,83,01010011
76,01001100,52,00110100,128,10000000
45,00101101,53,00110101,98,01100010
114,01110010,45,00101101,159,10011111
100,01100100,120,01111000,220,11011100
50,00110010,33,00100001,83,01010011
80,01010000,58,00111010,138,10001010
103,01100111,11,00001011,114,01110010
33,00100001,21,00010101,54,00110110
34,00100010,62,00111110,96,01100000
85,01010101,54,00110110,139,10001011
60,00111100,64,01000000,124,01111100
127,01111111,65,01000001,192,11000000
0,00000000,84,01010100,84,01010100
52,00110100,46,00101110,98,01100010
1,00000001,117,01110101,118,01110110
91,01011011,115,01110011,206,11001110
55,00110111,27,00011011,82,01010010
72,01001000,111,01101111,183,10110111
125,01111101,59,00111011,184,10111000
2,00000010,77,01001101,79,01001111
106,01101010,34,00100010,140,10001100
73,01001001,42,00101010,115,01110011
21,00010101,86,01010110,107,01101011
59,00111011,93,01011101,152,10011000
117,01110101,75,01001011,192,11000000
25,00011001,68,01000100,93,01011101
73,01001001,66,01000010,139,10001011
40,00101000,100,01100100,140,10001100
16,00010000,8,00001000,24,00011000
29,00011101,116,01110100,145,10010001
83,01010011,51,00110011,134,10000110
93,01011101,6,00000110,99,01100011
57,00111001,38,00100110,95,01011111
12,00001100,106,01101010,118,01110110
106,01101010,117,01110101,223,11011111
45,00101101,7,00000111,52,00110100
120,01111000,71,01000111,191,10111111
116,01110100,19,00010011,135,10000111
118,01110110,103,01100111,221,11011101
8,00001000,0,00000000,8,00001000
10,00001010,88,01011000,98,01100010
82,01010010,38,00100110,120,01111000
49,00110001,49,00110001,98,01100010
71,01000111,31,00011111,102,01100110
94,01011110,8,00001000,102,01100110
74,01001010,119,01110111,193,11000001
81,01010001,83,01010011,164,10100100
102,01100110,114,01110010,216,11011000
27,00011011,25,00011001,52,00110100
84,01010100,47,00101111,131,10000011
125,01111101,54,00110110,179,10110011
114,01110010,102,01100110,216,11011000
75,01001011,27,00011011,102,01100110
5,00000101,38,00100110,43,00101011
73,01001001,39,00100111,112,01110000
94,01011110,34,00100010,128,10000000
81,01010001,54,00110110,135,10000111
11,00001011,2,00000010,13,00001101
123,01111011,32,00100000,155,10011011
39,00100111,120,01111000,159,10011111
51,00110011,73,01001001,124,01111100
98,01100010,10,00001010,108,01101100
25,00011001,87,01010111,112,01110000
54,00110110,95,01011111,149,10010101
109,01101101,122,01111010,231,11100111
51,00110011,77,01001101,128,10000000
117,01110101,71,01000111,188,10111100
41,00101001,37,00100101,78,01001110
109,01101101,69,01000101,178,10110010
76,01001100,111,01101111,187,10111011
100,01100100,92,01011100,192,11000000
3,00000011,70,01000110,73,01001001
43,00101011,46,00101110,89,01011001
62,00111110,70,01000110,132,10000100
4,00000100,28,00011100,32,00100000
36,00100100,23,00010111,59,00111011
31,00011111,122,01111010,153,10011001
91,01011011,91,01011011,182,10110110
121,01111001,4,00000100,125,01111101
50,00110010,17,00010001,67,01000011
17,00010001,62,00111110,79,01001111
51,00110011,102,01100110,153,10011001
58,00111010,102,01100110,160,10100000
21,00010101,94,01011110,115,01110011
77,01001101,21,00010101,98,01100010
112,01110000,111,01101111,223,11011111
62,00111110,70,01000110,132,10000100
75,01001011,9,00001001,84,01010100
100,01100100,102,01100110,202,11001010
76,01001100,0,00000000,76,01001100
32,00100000,36,00100100,68,01000100
53,00110101,113,01110001,166,10100110
23,00010111,48,00110000,71,01000111
51,00110011,24,00011000,75,01001011
94,01011110,118,01110110,212,11010100
62,00111110,26,00011010,88,01011000
49,00110001,28,00011100,77,01001101
125,01111101,94,01011110,219,11011011
117,01110101,92,01011100,209,11010001
44,00101100,98,01100010,142,10001110
92,01011100,78,01001110,170,10101010
85,01010101,121,01111001,206,11001110
119,01110111,25,00011001,144,10010000
6,00000110,10,00001010,16,00010000
23,00010111,11,00001011,34,00100010
85,01010101,69,01000101,154,10011010
44,00101100,116,01110100,160,10100000
110,01101110,124,01111100,234,11101010
65,01000001,103,01100111,168,10101000
11,00001011,97,01100001,108,01101100
43,00101011,57,00111001,100,01100100
120,01111000,16,00010000,136,10001000
80,01010000,108,01101100,188,10111100
59,00111011,39,00100111,98,01100010
65,01000001,4,00000100,69,01000101
0,00000000,107,01101011,107,01101011
71,01000111,8,00001000,79,01001111
78,01001110,103,01100111,181,10110101
54,00110110,89,01011001,143,10001111
29,00011101,21,00010101,50,00110010
0,00000000,95,01011111,95,01011111
41,00101001,1,00000001,42,00101010
127,01111111,94,01011110,221,11011101
77,01001101,54,00110110,131,10000011
54,00110110,103,01100111,157,10011101
82,01010010,15,00001111,97,01100001
46,00101110,90,01011010,136,10001000
3,00000011,32,00100000,35,00100011
115,01110011,90,01011010,205,11001101
8,00001000,5,00000101,13,00001101
66,01000010,42,00101010,108,01101100
101,01100101,96,01100000,197,11000101
45,00101101,74,01001010,119,01110111
89,01011001,14,00001110,103,01100111
115,01110011,29,00011101,144,10010000
35,00100011,83,01010011,118,01110110
119,01110111,72,01001000,191,10111111
126,01111110,111,01101111,237,11101101
43,00101011,21,00010101,64,01000000
122,01111010,65,01000001,187,10111011
100,01100100,4,00000100,104,01101000
26,00011010,43,00101011,69,01000101
84,01010100,117,01110101,201,11001001
25,00011001,59,00111011,84,01010100
25,00011001,36,00100100,61,00111101
98,01100010,4,00000100,102,01100110
87,01010111,105,01101001,192,11000000
33,00100001,105,01101001,138,10001010
14,00001110,4,00000100,18,00010010
44,00101100,23,00010111,67,01000011
49,00110001,42,00101010,91,01011011
12,00001100,85,01010101,97,01100001
121,01111001,84,01010100,205,11001101
120,01111000,10,00001010,130,10000010
52,00110100,20,00010100,72,01001000
60,00111100,117,01110101,177,10110001
67,01000011,105,01101001,172,10101100
39,00100111,79,01001111,118,01110110
27,00011011,3,00000011,30,00011110
33,00100001,108,01101100,141,10001101
22,00010110,116,01110100,138,10001010
97,01100001,95,01011111,192,11000000
118,01110110,0,00000000,118,01110110
86,01010110,11,00001011,97,01100001
83,01010011,10,00001010,93,01011101
60,00111100,4,00000100,64,01000000
67,01000011,117,01110101,184,10111000
101,01100101,21,00010101,122,01111010
77,01001101,0,00000000,77,01001101
39,00100111,24,00011000,63,00111111
102,01100110,50,00110010,152,10011000
41,00101001,1,00000001,42,00101010
127,01111111,39,00100111,166,10100110
110,01101110,113,01110001,223,11011111
108,01101100,105,01101001,213,11010101
57,00111001,116,01110100,173,10101101
19,00010011,76,01001100,95,01011111
107,01101011,6,00000110,113,01110001
43,00101011,2,00000010,45,00101101
44,00101100,2,00000010,46,00101110
100,01100100,18,00010010,118,01110110
60,00111100,59,00111011,119,01110111
15,00001111,91,01011011,106,01101010
65,01000001,102,01100110,167,10100111
93,01011101,126,01111110,219,11011011
11,00001011,62,00111110,73,01001001
45,00101101,85,01010101,130,10000010
4,00000100,25,00011001,29,00011101
122,01111010,111,01101111,233,11101001
90,01011010,49,00110001,139,10001011
34,00100010,34,00100010,68,01000100
92,01011100,97,01100001,189,10111101
13,00001101,4,00000100,17,00010001
53,00110101,26,00011010,79,01001111
54,00110110,76,01001100,130,10000010
62,00111110,107,01101011,169,10101001
125,01111101,45,00101101,170,10101010
9,00001001,55,00110111,64,01000000
69,01000101,44,00101100,113,01110001
53,00110101,126,01111110,179,10110011
9,00001001,73,01001001,82,01010010
25,00011001,2,00000010,27,00011011
45,00101101,4,00000100,49,00110001
45,00101101,97,01100001,142,10001110
69,01000101,67,01000011,136,10001000
113,01110001,5,00000101,118,01110110
123,01111011,3,00000011,126,01111110
108,01101100,11,00001011,119,01110111
74,01001010,15,00001111,89,01011001
49,00110001,99,01100011,148,10010100
63,00111111,76,01001100,139,10001011
49,00110001,125,01111101,174,10101110
21,00010101,95,01011111,116,01110100
105,01101001,33,00100001,138,10001010
81,01010001,41,00101001,122,01111010
50,00110010,51,00110011,101,01100101
98,01100010,83,01010011,181,10110101
110,01101110,91,01011011,201,11001001
16,00010000,7,00000111,23,00010111
62,00111110,107,01101011,169,10101001
24,00011000,6,00000110,30,00011110
114,01110010,48,00110000,162,10100010
109,01101101,98,01100010,207,11001111
53,00110101,73,01001001,126,01111110
21,00010101,11,00001011,32,00100000
43,00101011,67,01000011,110,01101110
16,00010000,16,00010000,32,00100000
7,00000111,33,00100001,40,00101000
40,00101000,118,01110110,158,10011110
91,01011011,116,01110100,207,11001111
127,01111111,75,01001011,202,11001010
127,01111111,58,00111010,185,10111001
118,01110110,95,01011111,213,11010101
11,00001011,119,01110111,130,10000010
35,00100011,127,01111111,162,10100010
79,01001111,95,01011111,174,10101110
12,00001100,105,01101001,117,01110101
44,00101100,2,00000010,46,00101110
13,00001101,48,00110000,61,00111101
54,00110110,34,00100010,88,01011000
25,00011001,45,00101101,70,01000110
57,00111001,15,00001111,72,01001000
60,00111100,48,00110000,108,01101100
44,00101100,31,00011111,75,01001011
102,01100110,87,01010111,189,10111101
16,00010000,97,01100001,113,01110001
120,01111000,49,00110001,169,10101001
50,00110010,28,00011100,78,01001110
11,00001011,109,01101101,120,01111000
105,01101001,94,01011110,199,11000111
106,01101010,29,00011101,135,10000111
75,01001011,45,00101101,120,01111000
2,00000010,32,00100000,34,00100010
72,01001000,13,00001101,85,01010101
55,00110111,96,01100000,151,10010111
100,01100100,85,01010101,185,10111001
36,00100100,55,00110111,91,01011011
80,01010000,105,01101001,185,10111001
124,01111100,112,01110000,236,11101100
18,00010010,122,01111010,140,10001100
112,01110000,10,00001010,122,01111010
43,00101011,70,01000110,113,01110001
123,01111011,74,01001010,197,11000101
107,01101011,89,01011001,196,11000100
71,01000111,49,00110001,120,01111000
31,00011111,97,01100001,128,10000000
73,01001001,119,01110111,192,11000000
87,01010111,50,00110010,137,10001001
42,00101010,14,00001110,56,00111000
14,00001110,47,00101111,61,00111101
91,01011011,74,01001010,165,10100101
105,01101001,122,01111010,227,11100011
4,00000100,89,01011001,93,01011101
18,00010010,89,01011001,107,01101011
124,01111100,94,01011110,218,11011010
77,01001101,96,01100000,173,10101101
21,00010101,118,01110110,139,10001011
126,01111110,55,00110111,181,10110101
8,00001000,25,00011001,33,00100001
83,01010011,28,00011100,111,01101111
3,00000011,79,01001111,82,01010010
105,01101001,87,01010111,192,11000000
107,01101011,12,00001100,119,01110111
72,01001000,112,01110000,184,10111000
22,00010110,95,01011111,117,01110101
1,00000001,123,01111011,124,01111100
51,00110011,79,01001111,130,10000010
81,01010001,73,01001001,154,10011010
43,00101011,110,01101110,153,10011001
96,01100000,25,00011001,121,01111001
88,01011000,80,01010000,168,10101000
101,01100101,86,01010110,187,10111011
26,00011010,44,00101100,70,01000110
4,00000100,18,00010010,22,00010110
67,01000011,112,01110000,179,10110011
105,01101001,13,00001101,118,01110110
89,01011001,4,00000100,93,01011101
46,00101110,40,00101000,86,01010110
9,00001001,38,00100110,47,00101111
56,00111000,126,01111110,182,10110110
14,00001110,21,00010101,35,00100011
97,01100001,76,01001100,173,10101101
74,01001010,18,00010010,92,01011100
114,01110010,42,00101010,156,10011100
29,00011101,108,01101100,137,10001001
97,01100001,94,01011110,191,10111111
52,00110100,25,00011001,77,01001101
3,00000011,84,01010100,87,01010111
3,00000011,71,01000111,74,01001010
96,01100000,118,01110110,214,11010110
114,01110010,60,00111100,174,10101110
37,00100101,31,00011111,68,01000100
7,00000111,78,01001110,85,01010101
114,01110010,104,01101000,218,11011010
99,01100011,40,00101000,139,10001011
55,00110111,67,01000011,122,01111010
57,00111001,2,00000010,59,00111011
108,01101100,43,00101011,151,10010111
69,01000101,85,01010101,154,10011010
106,01101010,33,00100001,139,10001011
4,00000100,124,01111100,128,10000000
75,01001011,122,01111010,197,11000101
35,00100011,52,00110100,87,01010111
54,00110110,60,00111100,114,01110010
63,00111111,79,01001111,142,10001110
78,01001110,65,01000001,143,10001111
63,00111111,93,01011101,156,10011100
70,01000110,41,00101001,111,01101111
17,00010001,29,00011101,46,00101110
103,01100111,35,00100011,138,10001010
111,01101111,58,00111010,169,10101001
121,01111001,13,00001101,134,10000110
87,01010111,46,00101110,133,10000101
87,01010111,25,00011001,112,01110000
43,00101011,15,00001111,58,00111010
71,01000111,89,01011001,160,10100000
16,00010000,44,00101100,60,00111100
61,00111101,49,00110001,110,01101110
9,00001001,69,01000101,78,01001110
6,00000110,31,00011111,37,00100101
56,00111000,50,00110010,106,01101010
121,01111001,39,00100111,160,10100000
102,01100110,26,00011010,128,10000000
96,01100000,49,00110001,145,10010001
101,01100101,0,00000000,101,01100101
90,01011010,77,01001101,167,10100111
24,00011000,65,01000001,89,01011001
60,00111100,96,01100000,156,10011100
105,01101001,34,00100010,139,10001011
47,00101111,24,00011000,71,01000111
11,00001011,81,01010001,92,01011100
111,01101111,44,00101100,155,10011011
97,01100001,65,01000001,162,10100010
93,01011101,44,00101100,137,10001001
3,00000011,127,01111111,130,10000010
107,01101011,118,01110110,225,11100001
83,01010011,57,00111001,140,10001100
9,00001001,35,00100011,44,00101100
93,01011101,65,01000001,158,10011110
105,01101001,34,00100010,139,10001011
6,00000110,96,01100000,102,01100110
8,00001000,110,01101110,118,01110110
108,01101100,65,01000001,173,10101101
7,00000111,87,01010111,94,01011110
115,01110011,112,01110000,227,11100011
71,01000111,13,00001101,84,01010100
8,00001000,127,01111111,135,10000111
83,01010011,79,01001111,162,10100010
33,00100001,10,00001010,43,00101011
26,00011010,16,00010000,42,00101010
96,01100000,58,00111010,154,10011010
44,00101100,124,01111100,168,10101000
30,00011110,126,01111110,156,10011100
69,01000101,1,00000001,70,01000110
51,00110011,45,00101101,96,01100000
56,00111000,30,00011110,86,01010110
121,01111001,81,01010001,202,11001010
44,00101100,86,01010110,130,10000010
121,01111001,63,00111111,184,10111000
38,00100110,41,00101001,79,01001111
54,00110110,79,01001111,133,10000101
67,01000011,4,00000100,71,01000111
78,01001110,5,00000101,83,01010011
96,01100000,46,00101110,142,10001110
5,00000101,68,01000100,73,01001001
24,00011000,13,00001101,37,00100101
116,01110100,15,00001111,131,10000011
49,00110001,99,01100011,148,10010100
96,01100000,94,01011110,190,10111110
30,00011110,120,01111000,150,10010110
49,00110001,9,00001001,58,00111010
97,01100001,21,00010101,118,01110110
49,00110001,64,01000000,113,01110001
97,01100001,103,01100111,200,11001000
12,00001100,119,01110111,131,10000011
17,00010001,50,00110010,67,01000011
74,01001010,98,01100010,172,10101100
58,00111010,43,00101011,101,01100101
11,00001011,110,01101110,121,01111001
87,01010111,19,00010011,106,01101010
121,01111001,12,00001100,133,10000101
117,01110101,110,01101110,227,11100011
54,00110110,110,01101110,164,10100100
20,00010100,43,00101011,63,00111111
46,00101110,115,01110011,161,10100001
39,00100111,43,00101011,82,01010010
92,01011100,46,00101110,138,10001010
63,00111111,107,01101011,170,10101010
13,00001101,26,00011010,39,00100111
52,00110100,58,00111010,110,01101110
64,01000000,78,01001110,142,10001110
67,01000011,0,00000000,67,01000011
54,00110110,36,00100100,90,01011010
69,01000101,81,01010001,150,10010110
92,01011100,16,00010000,108,01101100
64,01000000,106,01101010,170,10101010
80,01010000,52,00110100,132,10000100
25,00011001,112,01110000,137,10001001
89,01011001,44,00101100,133,10000101
81,01010001,41,00101001,122,01111010
95,01011111,6,00000110,101,01100101
82,01010010,50,00110010,132,10000100
106,01101010,123,01111011,229,11100101
24,00011000,71,01000111,95,01011111
42,00101010,75,01001011,117,01110101
102,01100110,107,01101011,209,11010001
94,01011110,32,00100000,126,01111110
104,01101000,101,01100101,205,11001101
127,01111111,26,00011010,153,10011001
127,01111111,44,00101100,171,10101011
117,01110101,81,01010001,198,11000110
79,01001111,104,01101000,183,10110111
93,01011101,22,00010110,115,01110011
99,01100011,113,01110001,212,11010100
13,00001101,47,00101111,60,00111100
106,01101010,35,00100011,141,10001101
50,00110010,18,00010010,68,01000100
59,00111011,114,01110010,173,10101101
121,01111001,37,00100101,158,10011110
33,00100001,109,01101101,142,10001110
21,00010101,70,01000110,91,01011011
78,01001110,71,01000111,149,10010101
12,00001100,66,01000010,78,01001110
3,00000011,58,00111010,61,00111101
41,00101001,50,00110010,91,01011011
6,00000110,60,00111100,66,01000010
9,00001001,75,01001011,84,01010100
1,00000001,112,01110000,113,01110001
97,01100001,68,01000100,165,10100101
41,00101001,110,01101110,151,10010111
33,00100001,111,01101111,144,10010000
35,00100011,113,01110001,148,10010100
43,00101011,75,01001011,118,01110110
56,00111000,122,01111010,178,10110010
11,00001011,71,01000111,82,01010010
7,00000111,51,00110011,58,00111010
111,01101111,9,00001001,120,01111000
45,00101101,1,00000001,46,00101110
33,00100001,103,01100111,136,10001000
5,00000101,24,00011000,29,00011101
91,01011011,109,01101101,200,11001000
32,00100000,94,01011110,126,01111110
33,00100001,64,01000000,97,01100001
73,01001001,70,01000110,143,10001111
4,00000100,48,00110000,52,00110100
57,00111001,120,01111000,177,10110001
70,01000110,73,01001001,143,10001111
116,01110100,3,00000011,119,01110111
107,01101011,113,01110001,220,11011100
67,01000011,64,01000000,131,10000011
53,00110101,110,01101110,163,10100011
62,00111110,94,01011110,156,10011100
99,01100011,85,01010101,184,10111000
45,00101101,75,01001011,120,01111000
121,01111001,51,00110011,172,10101100
48,00110000,99,01100011,147,10010011
41,00101001,110,01101110,151,10010111
94,01011110,113,01110001,207,11001111
46,00101110,124,01111100,170,10101010
18,00010010,68,01000100,86,01010110
62,00111110,31,00011111,93,01011101
99,01100011,122,01111010,221,11011101
26,00011010,127,01111111,153,10011001
61,00111101,111,01101111,172,10101100
86,01010110,122,01111010,208,11010000
25,00011001,29,00011101,54,00110110
33,00100001,91,01011011,124,01111100
123,01111011,89,01011001,212,11010100
68,01000100,116,01110100,184,10111000
54,00110110,0,00000000,54,00110110
121,01111001,8,00001000,129,10000001
103,01100111,46,00101110,149,10010101
50,00110010,73,01001001,123,01111011
0,00000000,12,00001100,12,00001100
80,01010000,6,00000110,86,01010110
58,00111010,35,00100011,93,01011101
12,00001100,38,00100110,50,00110010
27,00011011,53,00110101,80,01010000
125,01111101,96,01100000,221,11011101
106,01101010,15,00001111,121,01111001
20,00010100,51,00110011,71,01000111
34,00100010,105,01101001,139,10001011
41,00101001,127,01111111,168,10101000
125,01111101,78,01001110,203,11001011
101,01100101,4,00000100,105,01101001
6,00000110,61,00111101,67,01000011
53,00110101,29,00011101,82,01010010
59,00111011,55,00110111,114,01110010
100,01100100,54,00110110,154,10011010
114,01110010,37,00100101,151,10010111
123,01111011,100,01100100,223,11011111
84,01010100,67,01000011,151,10010111
24,00011000,37,00100101,61,00111101
91,01011011,11,00001011,102,01100110
76,01001100,119,01110111,195,11000011
48,00110000,24,00011000,72,01001000
92,01011100,41,00101001,133,10000101
116,01110100,21,00010101,137,10001001
60,00111100,123,01111011,183,10110111
61,00111101,43,00101011,104,01101000
30,00011110,9,00001001,39,00100111
58,00111010,96,01100000,154,10011010
5,00000101,57,00111001,62,00111110
109,01101101,113,01110001,222,11011110
70,01000110,80,01010000,150,10010110
112,01110000,114,01110010,226,11100010
99,01100011,76,01001100,175,10101111
119,01110111,55,00110111,174,10101110
94,01011110,10,00001010,104,01101000
60,00111100,111,01101111,171,10101011
114,01110010,20,00010100,134,10000110
35,00100011,9,00001001,44,00101100
61,00111101,10,00001010,71,01000111
29,00011101,5,00000101,34,00100010
18,00010010,56,00111000,74,01001010
101,01100101,26,00011010,127,01111111
113,01110001,17,00010001,130,10000010
61,00111101,22,00010110,83,01010011
106,01101010,42,00101010,148,10010100
26,00011010,124,01111100,150,10010110
70,01000110,16,00010000,86,01010110
50,00110010,28,00011100,78,01001110
59,00111011,40,00101000,99,01100011
57,00111001,94,01011110,151,10010111
70,01000110,115,01110011,185,10111001
127,01111111,103,01100111,230,11100110
92,01011100,38,00100110,130,10000010
62,00111110,126,01111110,188,10111100
29,00011101,6,00000110,35,00100011
7,00000111,12,00001100,19,00010011
53,00110101,47,00101111,100,01100100
71,01000111,25,00011001,96,01100000
96,01100000,55,00110111,151,10010111
112,01110000,124,01111100,236,11101100
93,01011101,126,01111110,219,11011011
32,00100000,113,01110001,145,10010001
77,01001101,52,00110100,129,10000001
47,00101111,12,00001100,59,00111011
102,01100110,18,00010010,120,01111000
19,00010011,40,00101000,59,00111011
19,00010011,62,00111110,81,01010001
23,00010111,25,00011001,48,00110000
75,01001011,50,00110010,125,01111101
32,00100000,110,01101110,142,10001110
56,00111000,34,00100010,90,01011010
92,01011100,15,00001111,107,01101011
102,01100110,115,01110011,217,11011001
57,00111001,106,01101010,163,10100011
95,01011111,73,01001001,168,10101000
62,00111110,115,01110011,177,10110001
109,01101101,77,01001101,186,10111010
58,00111010,47,00101111,105,01101001
92,01011100,65,01000001,157,10011101
117,01110101,117,01110101,234,11101010
4,00000100,45,00101101,49,00110001
0,00000000,59,00111011,59,00111011
108,01101100,10,00001010,118,01110110
62,00111110,112,01110000,174,10101110
108,01101100,15,00001111,123,01111011
89,01011001,88,01011000,177,10110001
71,01000111,65,01000001,136,10001000
11,00001011,106,01101010,117,01110101
117,01110101,114,01110010,231,11100111
14,00001110,83,01010011,97,01100001
5,00000101,36,00100100,41,00101001
95,01011111,105,01101001,200,11001000
93,01011101,55,00110111,148,10010100
86,01010110,88,01011000,174,10101110
33,00100001,74,01001010,107,01101011
109,01101101,104,01101000,213,11010101
42,00101010,87,01010111,129,10000001
46,00101110,74,01001010,120,01111000
38,00100110,122,01111010,160,10100000
4,00000100,48,00110000,52,00110100
102,01100110,55,00110111,157,10011101
16,00010000,120,01111000,136,10001000
96,01100000,65,01000001,161,10100001
65,01000001,51,00110011,116,01110100
118,01110110,8,00001000,126,01111110
6,00000110,81,01010001,87,01010111
27,00011011,124,01111100,151,10010111
40,00101000,119,01110111,159,10011111
68,01000100,56,00111000,124,01111100
32,00100000,50,00110010,82,01010010
96,01100000,100,01100100,196,11000100
22,00010110,117,01110101,139,10001011
91,01011011,67,01000011,158,10011110
100,01100100,6,00000110,106,01101010
32,00100000,81,01010001,113,01110001
122,01111010,42,00101010,164,10100100
43,00101011,22,00010110,65,01000001
79,01001111,67,01000011,146,10010010
32,00100000,71,01000111,103,01100111
45,00101101,113,01110001,158,10011110
127,01111111,67,01000011,194,11000010
82,01010010,53,00110101,135,10000111
126,01111110,71,01000111,197,11000101
27,00011011,0,00000000,27,00011011
124,01111100,123,01111011,247,11110111
37,00100101,96,01100000,133,10000101
59,00111011,57,00111001,116,01110100
40,00101000,56,00111000,96,01100000
1,00000001,99,01100011,100,01100100
59,00111011,91,01011011,150,10010110
69,01000101,73,01001001,142,10001110
63,00111111,14,00001110,77,01001101
111,01101111,92,01011100,203,11001011
1,00000001,119,01110111,120,01111000
59,00111011,16,00010000,75,01001011
15,00001111,80,01010000,95,01011111
53,00110101,98,01100010,151,10010111
32,00100000,123,01111011,155,10011011
38,00100110,68,01000100,106,01101010
35,00100011,87,01010111,122,01111010
123,01111011,31,00011111,154,10011010
127,01111111,75,01001011,202,11001010
57,00111001,112,01110000,169,10101001
41,00101001,36,00100100,77,01001101
22,00010110,11,00001011,33,00100001
22,00010110,110,01101110,132,10000100
114,01110010,68,01000100,182,10110110
71,01000111,113,01110001,184,10111000
86,01010110,103,01100111,189,10111101
50,00110010,15,00001111,65,01000001
28,00011100,122,01111010,150,10010110
66,01000010,52,00110100,118,01110110
30,00011110,20,00010100,50,00110010
32,00100000,103,01100111,135,10000111
81,01010001,75,01001011,156,10011100
24,00011000,90,01011010,114,01110010
26,00011010,92,01011100,118,01110110
43,00101011,107,01101011,150,10010110
43,00101011,60,00111100,103,01100111
122,01111010,43,00101011,165,10100101
107,01101011,59,00111011,166,10100110
12,00001100,120,01111000,132,10000100
109,01101101,79,01001111,188,10111100
32,00100000,66,01000010,98,01100010
51,00110011,108,01101100,159,10011111
57,00111001,118,01110110,175,10101111
105,01101001,40,00101000,145,10010001
107,01101011,0,00000000,107,01101011
39,00100111,100,01100100,139,10001011
63,00111111,23,00010111,86,01010110
92,01011100,113,01110001,205,11001101
34,00100010,93,01011101,127,01111111
73,01001001,47,00101111,120,01111000
77,01001101,121,01111001,198,11000110
117,01110101,112,01110000,229,11100101
41,00101001,24,00011000,65,01000001
43,00101011,51,00110011,94,01011110
120,01111000,98,01100010,218,11011010
34,00100010,96,01100000,130,10000010
16,00010000,104,01101000,120,01111000
114,01110010,112,01110000,226,11100010
41,00101001,21,00010101,62,00111110
58,00111010,114,01110010,172,10101100
40,00101000,59,00111011,99,01100011
94,01011110,4,00000100,98,01100010
90,01011010,44,00101100,134,10000110
88,01011000,78,01001110,166,10100110
42,00101010,77,01001101,119,01110111
15,00001111,102,01100110,117,01110101
20,00010100,41,00101001,61,00111101
19,00010011,22,00010110,41,00101001
89,01011001,98,01100010,187,10111011
37,00100101,90,01011010,127,01111111
83,01010011,44,00101100,127,01111111
84,01010100,36,00100100,120,01111000
69,01000101,76,01001100,145,10010001
58,00111010,83,01010011,141,10001101
59,00111011,33,00100001,92,01011100
24,00011000,125,01111101,149,10010101
89,01011001,88,01011000,177,10110001
50,00110010,70,01000110,120,01111000
113,01110001,107,01101011,220,11011100
54,00110110,116,01110100,170,10101010
5,00000101,49,00110001,54,00110110
22,00010110,63,00111111,85,01010101
96,01100000,121,01111001,217,11011001
104,01101000,61,00111101,165,10100101
124,01111100,90,01011010,214,11010110
103,01100111,11,00001011,114,01110010
123,01111011,77,01001101,200,11001000
83,01010011,36,00100100,119,01110111
112,01110000,98,01100010,210,11010010
30,00011110,87,01010111,117,01110101
25,00011001,40,00101000,65,01000001
34,00100010,64,01000000,98,01100010
12,00001100,109,01101101,121,01111001
119,01110111,61,00111101,180,10110100
20,00010100,39,00100111,59,00111011
50,00110010,110,01101110,160,10100000
110,01101110,124,01111100,234,11101010
53,00110101,60,00111100,113,01110001
52,00110100,43,00101011,95,01011111
94,01011110,84,01010100,178,10110010
56,00111000,8,00001000,64,01000000
21,00010101,40,00101000,61,00111101
105,01101001,48,00110000,153,10011001
0,00000000,85,01010101,85,01010101
97,01100001,89,01011001,186,10111010
9,00001001,14,00001110,23,00010111
28,00011100,26,00011010,54,00110110
33,00100001,74,01001010,107,01101011
105,01101001,16,00010000,121,01111001
10,00001010,0,00000000,10,00001010
68,01000100,105,01101001,173,10101101
20,00010100,68,01000100,88,01011000
54,00110110,41,00101001,95,01011111
46,00101110,90,01011010,136,10001000
105,01101001,50,00110010,155,10011011
91,01011011,77,01001101,168,10101000
27,00011011,9,00001001,36,00100100
82,01010010,123,01111011,205,11001101
89,01011001,110,01101110,199,11000111
21,00010101,2,00000010,23,00010111
42,00101010,12,00001100,54,00110110
19,00010011,41,00101001,60,00111100
87,01010111,117,01110101,204,11001100
4,00000100,12,00001100,16,00010000
70,01000110,93,01011101,163,10100011
34,00100010,36,00100100,70,01000110
80,01010000,15,00001111,95,01011111
90,01011010,112,01110000,202,11001010
63,00111111,112,01110000,175,10101111
104,01101000,13,00001101,117,01110101
97,01100001,79,01001111,176,10110000
36,00100100,118,01110110,154,10011010
2,00000010,19,00010011,21,00010101
113,01110001,3,00000011,116,01110100
6,00000110,28,00011100,34,00100010
48,00110000,78,01001110,126,01111110
93,01011101,22,00010110,115,01110011
63,00111111,50,00110010,113,01110001
18,00010010,0,00000000,18,00010010
38,00100110,119,01110111,157,10011101
23,00010111,123,01111011,146,10010010
67,01000011,75,01001011,142,10001110
88,01011000,0,00000000,88,01011000
109,01101101,117,01110101,226,11100010
77,01001101,17,00010001,94,01011110
120,01111000,112,01110000,232,11101000
32,00100000,42,00101010,74,01001010
38,00100110,126,01111110,164,10100100
27,00011011,38,00100110,65,01000001
86,01010110,75,01001011,161,10100001
29,00011101,59,00111011,88,01011000
60,00111100,121,01111001,181,10110101
66,01000010,67,01000011,133,10000101
95,01011111,13,00001101,108,01101100
104,01101000,88,01011000,192,11000000
91,01011011,39,00100111,130,10000010
110,01101110,38,00100110,148,10010100
104,01101000,93,01011101,197,11000101
3,00000011,106,01101010,109,01101101
65,01000001,68,01000100,133,10000101
97,01100001,66,01000010,163,10100011
66,01000010,119,01110111,185,10111001
61,00111101,86,01010110,147,10010011
0,00000000,33,00100001,33,00100001
14,00001110,64,01000000,78,01001110
49,00110001,121,01111001,170,10101010
11,00001011,123,01111011,134,10000110
17,00010001,5,00000101,22,00010110
93,01011101,31,00011111,124,01111100
107,01101011,48,00110000,155,10011011
100,01100100,19,00010011,119,01110111
37,00100101,119,01110111,156,10011100
49,00110001,8,00001000,57,00111001
79,01001111,43,00101011,122,01111010
64,01000000,29,00011101,93,01011101
120,01111000,118,01110110,238,11101110
112,01110000,107,01101011,219,11011011
13,00001101,105,01101001,118,01110110
120,01111000,46,00101110,166,10100110
62,00111110,7,00000111,69,01000101
21,00010101,43,00101011,64,01000000
110,01101110,119,01110111,229,11100101
107,01101011,0,00000000,107,01101011
82,01010010,115,01110011,197,11000101
19,00010011,62,00111110,81,01010001
25,00011001,102,01100110,127,01111111
67,01000011,15,00001111,82,01010010
87,01010111,40,00101000,127,01111111
100,01100100,116,01110100,216,11011000
84,01010100,25,00011001,109,01101101
46,00101110,26,00011010,72,01001000
1,00000001,67,01000011,68,01000100
64,01000000,88,01011000,152,10011000
49,00110001,47,00101111,96,01100000
104,01101000,33,00100001,137,10001001
17,00010001,100,01100100,117,01110101
64,01000000,16,00010000,80,01010000
50,00110010,20,00010100,70,01000110
56,00111000,49,00110001,105,01101001
97,01100001,51,00110011,148,10010100
43,00101011,58,00111010,101,01100101
56,00111000,19,00010011,75,01001011
26,00011010,117,01110101,143,10001111
16,00010000,39,00100111,55,00110111
31,00011111,81,01010001,112,01110000
79,01001111,24,00011000,103,01100111
86,01010110,83,01010011,169,10101001
14,00001110,124,01111100,138,10001010
23,00010111,103,01100111,126,01111110
102,01100110,105,01101001,207,11001111
61,00111101,83,01010011,144,10010000
17,00010001,24,00011000,41,00101001
5,00000101,31,00011111,36,00100100
19,00010011,96,01100000,115,01110011
43,00101011,96,01100000,139,10001011
108,01101100,44,00101100,152,10011000
25,00011001,57,00111001,82,01010010
105,01101001,31,00011111,136,10001000
51,00110011,22,00010110,73,01001001
122,01111010,46,00101110,168,10101000
20,00010100,48,00110000,68,01000100
40,00101000,122,01111010,162,10100010
114,01110010,24,00011000,138,10001010
6,00000110,116,01110100,122,01111010
102,01100110,104,01101000,206,11001110
60,00111100,98,01100010,158,10011110
43,00101011,35,00100011,78,01001110
43,00101011,49,00110001,92,01011100
121,01111001,105,01101001,226,11100010
71,01000111,93,01011101,164,10100100
96,01100000,95,01011111,191,10111111
70,01000110,38,00100110,108,01101100
108,01101100,42,00101010,150,10010110
49,00110001,44,00101100,93,01011101
65,01000001,79,01001111,144,10010000
83,01010011,8,00001000,91,01011011
62,00111110,118,01110110,180,10110100
55,00110111,112,01110000,167,10100111
116,01110100,116,01110100,232,11101000
58,00111010,68,01000100,126,01111110
36,00100100,64,01000000,100,01100100
6,00000110,120,01111000,126,01111110
56,00111000,44,00101100,100,01100100
108,01101100,43,00101011,151,10010111
18,00010010,126,01111110,144,10010000
11,00001011,105,01101001,116,01110100
72,01001000,37,00100101,109,01101101
87,01010111,89,01011001,176,10110000
3,00000011,13,00001101,16,00010000
65,01000001,111,01101111,176,10110000
14,00001110,91,01011011,105,01101001
19,00010011,125,01111101,144,10010000
63,00111111,99,01100011,162,10100010
20,00010100,126,01111110,146,10010010
62,00111110,101,01100101,163,10100011
2,00000010,91,01011011,93,01011101
19,00010011,41,00101001,60,00111100
91,01011011,61,00111101,152,10011000
112,01110000,91,01011011,203,11001011
82,01010010,30,00011110,112,01110000
45,00101101,121,01111001,166,10100110
108,01101100,105,01101001,213,11010101
120,01111000,112,01110000,232,11101000
85,01010101,94,01011110,179,10110011
40,00101000,47,00101111,87,01010111
16,00010000,116,01110100,132,10000100
62,00111110,21,00010101,83,01010011
11,00001011,110,01101110,121,01111001
83,01010011,109,01101101,192,11000000
17,00010001,124,01111100,141,10001101
72,01001000,63,00111111,135,10000111
65,01000001,102,01100110,167,10100111
13,00001101,74,01001010,87,01010111
60,00111100,78,01001110,138,10001010
46,00101110,103,01100111,149,10010101
81,01010001,76,01001100,157,10011101
91,01011011,114,01110010,205,11001101
94,01011110,23,00010111,117,01110101
32,00100000,31,00011111,63,00111111
6,00000110,88,01011000,94,01011110
33,00100001,81,01010001,114,01110010
63,00111111,87,01010111,150,10010110
0,00000000,106,01101010,106,01101010
69,01000101,34,00100010,103,01100111
92,01011100,11,00001011,103,01100111
106,01101010,88,01011000,194,11000010
77,01001101,58,00111010,135,10000111
64,01000000,80,01010000,144,10010000
80,01010000,0,00000000,80,01010000
63,00111111,86,01010110,149,10010101
112,01110000,102,01100110,214,11010110
19,00010011,0,00000000,19,00010011
28,00011100,40,00101000,68,01000100
119,01110111,4,00000100,123,01111011
77,01001101,40,00101000,117,01110101
100,01100100,23,00010111,123,01111011
28,00011100,35,00100011,63,00111111
0,00000000,38,00100110,38,00100110
8,00001000,7,00000111,15,00001111
45,00101101,9,00001001,54,00110110
31,00011111,38,00100110,69,01000101
89,01011001,11,00001011,100,01100100
116,01110100,44,00101100,160,10100000
18,00010010,116,01110100,134,10000110
124,01111100,26,00011010,150,10010110
37,00100101,81,01010001,118,01110110
91,01011011,103,01100111,194,11000010
109,01101101,109,01101101,218,11011010
71,01000111,41,00101001,112,01110000
59,00111011,121,01111001,180,10110100
111,01101111,87,01010111,198,11000110
81,01010001,15,00001111,96,01100000
35,00100011,75,01001011,110,01101110
107,01101011,24,00011000,131,10000011
16,00010000,77,01001101,93,01011101
82,01010010,109,01101101,191,10111111
64,01000000,3,00000011,67,01000011
29,00011101,49,00110001,78,01001110
6,00000110,111,01101111,117,01110101
44,00101100,37,00100101,81,01010001
64,01000000,95,01011111,159,10011111
65,01000001,99,01100011,164,10100100
18,00010010,84,01010100,102,01100110
66,01000010,7,00000111,73,01001001
56,00111000,100,01100100,156,10011100
40,00101000,7,00000111,47,00101111
67,01000011,12,00001100,79,01001111
114,01110010,7,00000111,121,01111001
72,01001000,119,01110111,191,10111111
4,00000100,114,01110010,118,01110110
33,00100001,66,01000010,99,01100011
108,01101100,18,00010010,126,01111110
98,01100010,112,01110000,210,11010010
8,00001000,17,00010001,25,00011001
32,00100000,0,00000000,32,00100000
11,00001011,25,00011001,36,00100100
66,01000010,69,01000101,135,10000111
93,01011101,48,00110000,141,10001101
15,00001111,75,01001011,90,01011010
39,00100111,38,00100110,77,01001101
49,00110001,5,00000101,54,00110110
42,00101010,31,00011111,73,01001001
51,00110011,92,01011100,143,10001111
116,01110100,71,01000111,187,10111011
20,00010100,40,00101000,60,00111100
93,01011101,29,00011101,122,01111010
94,01011110,109,01101101,203,11001011
56,00111000,63,00111111,119,01110111
21,00010101,26,00011010,47,00101111
63,00111111,52,00110100,115,01110011
67,01000011,89,01011001,156,10011100
70,01000110,23,00010111,93,01011101
33,00100001,68,01000100,101,01100101
76,01001100,106,01101010,182,10110110
74,01001010,38,00100110,112,01110000
61,00111101,90,01011010,151,10010111
51,00110011,103,01100111,154,10011010
104,01101000,44,00101100,148,10010100
4,00000100,78,01001110,82,01010010
37,00100101,54,00110110,91,01011011
55,00110111,77,01001101,132,10000100
17,00010001,106,01101010,123,01111011
92,01011100,76,01001100,168,10101000
39,00100111,28,00011100,67,01000011
119,01110111,77,01001101,196,11000100
65,01000001,99,01100011,164,10100100
109,01101101,41,00101001,150,10010110
86,01010110,124,01111100,210,11010010
20,00010100,24,00011000,44,00101100
120,01111000,87,01010111,207,11001111
102,01100110,75,01001011,177,10110001
25,00011001,15,00001111,40,00101000
112,01110000,37,00100101,149,10010101
24,00011000,81,01010001,105,01101001
73,01001001,48,00110000,121,01111001
3,00000011,57,00111001,60,00111100
50,00110010,37,00100101,87,01010111
15,00001111,55,00110111,70,01000110
73,01001001,22,00010110,95,01011111
75,01001011,17,00010001,92,01011100
66,01000010,72,01001000,138,10001010
97,01100001,52,00110100,149,10010101
95,01011111,78,01001110,173,10101101
0,00000000,70,01000110,70,01000110
89,01011001,95,01011111,184,10111000
31,00011111,21,00010101,52,00110100
114,01110010,39,00100111,153,10011001
28,00011100,55,00110111,83,01010011
6,00000110,89,01011001,95,01011111
34,00100010,79,01001111,113,01110001
64,01000000,118,01110110,182,10110110
116,01110100,47,00101111,163,10100011
104,01101000,27,00011011,131,10000011
89,01011001,107,01101011,196,11000100
23,00010111,37,00100101,60,00111100
14,00001110,83,01010011,97,01100001
84,01010100,100,01100100,184,10111000
43,00101011,1,00000001,44,00101100
33,00100001,86,01010110,119,01110111
6,00000110,123,01111011,129,10000001
35,00100011,32,00100000,67,01000011
27,00011011,107,01101011,134,10000110
71,01000111,51,00110011,122,01111010
25,00011001,95,01011111,120,01111000
112,01110000,120,01111000,232,11101000
62,00111110,127,01111111,189,10111101
86,01010110,49,00110001,135,10000111
21,00010101,97,01100001,118,01110110
111,01101111,55,00110111,166,10100110
108,01101100,92,01011100,200,11001000
115,01110011,111,01101111,226,11100010
38,00100110,123,01111011,161,10100001
32,00100000,41,00101001,73,01001001
44,00101100,69,01000101,113,01110001
24,00011000,7,00000111,31,00011111
90,01011010,56,00111000,146,10010010
116,01110100,80,01010000,196,11000100
10,00001010,45,00101101,55,00110111
97,01100001,117,01110101,214,11010110
90,01011010,117,01110101,207,11001111
24,00011000,12,00001100,36,00100100
115,01110011,92,01011100,207,11001111
28,00011100,22,00010110,50,00110010
116,01110100,94,01011110,210,11010010
29,00011101,112,01110000,141,10001101
108,01101100,99,01100011,207,11001111
4,00000100,41,00101001,45,00101101
68,01000100,67,01000011,135,10000111
98,01100010,39,00100111,137,10001001
84,01010100,43,00101011,127,01111111
28,00011100,29,00011101,57,00111001
111,01101111,4,00000100,115,01110011
111,01101111,41,00101001,152,10011000
16,00010000,100,01100100,116,01110100
126,01111110,60,00111100,186,10111010
64,01000000,61,00111101,125,01111101
56,00111000,74,01001010,130,10000010
7,00000111,77,01001101,84,01010100
68,01000100,45,00101101,113,01110001
30,00011110,5,00000101,35,00100011
1,00000001,83,01010011,84,01010100
43,00101011,119,01110111,162,10100010
23,00010111,96,01100000,119,01110111
96,01100000,76,01001100,172,10101100
29,00011101,73,01001001,102,01100110
8,00001000,113,01110001,121,01111001
121,01111001,81,01010001,202,11001010
90,01011010,90,01011010,180,10110100
42,00101010,44,00101100,86,01010110
106,01101010,70,01000110,176,10110000
5,00000101,29,00011101,34,00100010
90,01011010,48,00110000,138,10001010
111,01101111,7,00000111,118,01110110
56,00111000,126,01111110,182,10110110
3,00000011,25,00011001,28,00011100
37,00100101,50,00110010,87,01010111
80,01010000,73,01001001,153,10011001
17,00010001,70,01000110,87,01010111
112,01110000,56,00111000,168,10101000
70,01000110,86,01010110,156,10011100
79,01001111,74,01001010,153,10011001
43,00101011,75,01001011,118,01110110
75,01001011,9,00001001,84,01010100
121,01111001,62,00111110,183,10110111
76,01001100,25,00011001,101,01100101
78,01001110,8,00001000,86,01010110
32,00100000,31,00011111,63,00111111
77,01001101,45,00101101,122,01111010
9,00001001,24,00011000,33,00100001
22,00010110,54,00110110,76,01001100
89,01011001,55,00110111,144,10010000
45,00101101,87,01010111,132,10000100
98,01100010,67,01000011,165,10100101
87,01010111,106,01101010,193,11000001
49,00110001,54,00110110,103,01100111
22,00010110,89,01011001,111,01101111
6,00000110,75,01001011,81,01010001
55,00110111,51,00110011,106,01101010
109,01101101,3,00000011,112,01110000
55,00110111,46,00101110,101,01100101
78,01001110,18,00010010,96,01100000
12,00001100,78,01001110,90,01011010
42,00101010,72,01001000,114,01110010
35,00100011,126,01111110,161,10100001
60,00111100,69,01000101,129,10000001
81,01010001,48,00110000,129,10000001
39,00100111,19,00010011,58,00111010
96,01100000,96,01100000,192,11000000
114,01110010,76,01001100,190,10111110
95,01011111,77,01001101,172,10101100
82,01010010,74,01001010,156,10011100
24,00011000,82,01010010,106,01101010
123,01111011,102,01100110,225,11100001
79,01001111,37,00100101,116,01110100
57,00111001,111,01101111,168,10101000
86,01010110,60,00111100,146,10010010
101,01100101,34,00100010,135,10000111
113,01110001,60,00111100,173,10101101
77,01001101,74,01001010,151,10010111
6,00000110,78,01001110,84,01010100
6,00000110,10,00001010,16,00010000
46,00101110,75,01001011,121,01111001
113,01110001,110,01101110,223,11011111
84,01010100,28,00011100,112,01110000
92,01011100,58,00111010,150,10010110
42,00101010,82,01010010,124,01111100
125,01111101,12,00001100,137,10001001
74,01001010,95,01011111,169,10101001
18,00010010,12,00001100,30,00011110
124,01111100,117,01110101,241,11110001
86,01010110,27,00011011,113,01110001
73,01001001,114,01110010,187,10111011
21,00010101,32,00100000,53,00110101
19,00010011,4,00000100,23,00010111
43,00101011,115,01110011,158,10011110
93,01011101,13,00001101,106,01101010
6,00000110,37,00100101,43,00101011
44,00101100,40,00101000,84,01010100
8,00001000,121,01111001,129,10000001
84,01010100,105,01101001,189,10111101
93,01011101,38,00100110,131,10000011
127,01111111,22,00010110,149,10010101
78,01001110,85,01010101,163,10100011
36,00100100,5,00000101,41,00101001
121,01111001,22,00010110,143,10001111
52,00110100,61,00111101,113,01110001
55,00110111,0,00000000,55,00110111
53,00110101,94,01011110,147,10010011
69,01000101,91,01011011,160,10100000
33,00100001,66,01000010,99,01100011
107,01101011,23,00010111,130,10000010
125,01111101,98,01100010,223,11011111
120,01111000,63,00111111,183,10110111
124,01111100,4,00000100,128,10000000
86,01010110,54,00110110,140,10001100
62,00111110,24,00011000,86,01010110
10,00001010,71,01000111,81,01010001
25,00011001,34,00100010,59,00111011
92,01011100,123,01111011,215,11010111
95,01011111,110,01101110,205,11001101
41,00101001,113,01110001,154,10011010
86,01010110,57,00111001,143,10001111
60,00111100,9,00001001,69,01000101
35,00100011,114,01110010,149,10010101
3,00000011,9,00001001,12,00001100
106,01101010,3,00000011,109,01101101
77,01001101,119,01110111,196,11000100
111,01101111,3,00000011,114,01110010
100,01100100,66,01000010,166,10100110
40,00101000,47,00101111,87,01010111
116,01110100,75,01001011,191,10111111
97,01100001,125,01111101,222,11011110
45,00101101,29,00011101,74,01001010
0,00000000,60,00111100,60,00111100
38,00100110,88,01011000,126,01111110
80,01010000,54,00110110,134,10000110
1,00000001,51,00110011,52,00110100
1,00000001,31,00011111,32,00100000
9,00001001,33,00100001,42,00101010
30,00011110,27,00011011,57,00111001
27,00011011,55,00110111,82,01010010
48,00110000,60,00111100,108,01101100
94,01011110,15,00001111,109,01101101
72,01001000,70,01000110,142,10001110
34,00100010,70,01000110,104,01101000
105,01101001,105,01101001,210,11010010
112,01110000,7,00000111,119,01110111
64,01000000,55,00110111,119,01110111
91,01011011,2,00000010,93,01011101
123,01111011,68,01000100,191,10111111
29,00011101,70,01000110,99,01100011
24,00011000,77,01001101,101,01100101
122,01111010,63,00111111,185,10111001
106,01101010,111,01101111,217,11011001
74,01001010,55,00110111,129,10000001
49,00110001,0,00000000,49,00110001
70,01000110,121,01111001,191,10111111
93,01011101,50,00110010,143,10001111
35,00100011,112,01110000,147,10010011
38,00100110,65,01000001,103,01100111
58,00111010,41,00101001,99,01100011
65,01000001,96,01100000,161,10100001
99,01100011,47,00101111,146,10010010
47,00101111,99,01100011,146,10010010
36,00100100,75,01001011,111,01101111
68,01000100,101,01100101,169,10101001
4,00000100,75,01001011,79,01001111
106,01101010,33,00100001,139,10001011
5,00000101,16,00010000,21,00010101
63,00111111,126,01111110,189,10111101
102,01100110,70,01000110,172,10101100
36,00100100,50,00110010,86,01010110
62,00111110,30,00011110,92,01011100
56,00111000,23,00010111,79,01001111
76,01001100,99,01100011,175,10101111
26,00011010,40,00101000,66,01000010
12,00001100,41,00101001,53,00110101
122,01111010,85,01010101,207,11001111
81,01010001,6,00000110,87,01010111
95,01011111,60,00111100,155,10011011
84,01010100,106,01101010,190,10111110
62,00111110,46,00101110,108,01101100
10,00001010,29,00011101,39,00100111
123,01111011,76,01001100,199,11000111
13,00001101,59,00111011,72,01001000
1,00000001,34,00100010,35,00100011
24,00011000,108,01101100,132,10000100
6,00000110,41,00101001,47,00101111
74,01001010,85,01010101,159,10011111
109,01101101,106,01101010,215,11010111
6,00000110,77,01001101,83,01010011
116,01110100,118,01110110,234,11101010
41,00101001,40,00101000,81,01010001
6,00000110,118,01110110,124,01111100
6,00000110,81,01010001,87,01010111
4,00000100,87,01010111,91,01011011
54,00110110,43,00101011,97,01100001
74,01001010,16,00010000,90,01011010
30,00011110,118,01110110,148,10010100
17,00010001,57,00111001,74,01001010
73,01001001,50,00110010,123,01111011
62,00111110,39,00100111,101,01100101
47,00101111,91,01011011,138,10001010
103,01100111,89,01011001,192,11000000
36,00100100,76,01001100,112,01110000
72,01001000,56,00111000,128,10000000
20,00010100,65,01000001,85,01010101
89,01011001,49,00110001,138,10001010
116,01110100,94,01011110,210,11010010
4,00000100,12,00001100,16,00010000
101,01100101,110,01101110,211,11010011
74,01001010,29,00011101,103,01100111
53,00110101,53,00110101,106,01101010
8,00001000,35,00100011,43,00101011
34,00100010,13,00001101,47,00101111
115,01110011,120,01111000,235,11101011
54,00110110,83,01010011,137,10001001
42,00101010,33,00100001,75,01001011
122,01111010,72,01001000,194,11000010
19,00010011,119,01110111,138,10001010
92,01011100,22,00010110,114,01110010
74,01001010,17,00010001,91,01011011
35,00100011,26,00011010,61,00111101
4,00000100,59,00111011,63,00111111
58,00111010,59,00111011,117,01110101
35,00100011,70,01000110,105,01101001
126,01111110,75,01001011,201,11001001
81,01010001,9,00001001,90,01011010
85,01010101,10,00001010,95,01011111
72,01001000,119,01110111,191,10111111
24,00011000,92,01011100,116,01110100
74,01001010,79,01001111,153,10011001
30,00011110,14,00001110,44,00101100
67,01000011,28,00011100,95,01011111
39,00100111,23,00010111,62,00111110
20,00010100,51,00110011,71,01000111
82,01010010,34,00100010,116,01110100
122,01111010,58,00111010,180,10110100
102,01100110,109,01101101,211,11010011
15,00001111,77,01001101,92,01011100
92,01011100,29,00011101,121,01111001
49,00110001,56,00111000,105,01101001
91,01011011,46,00101110,137,10001001
92,01011100,126,01111110,218,11011010
116,01110100,42,00101010,158,10011110
115,01110011,100,01100100,215,11010111
78,01001110,125,01111101,203,11001011
5,00000101,58,00111010,63,00111111
122,01111010,57,00111001,179,10110011
86,01010110,105,01101001,191,10111111
1,00000001,103,01100111,104,01101000
87,01010111,55,00110111,142,10001110
53,00110101,108,01101100,161,10100001
90,01011010,39,00100111,129,10000001
69,01000101,112,01110000,181,10110101
80,01010000,3,00000011,83,01010011
104,01101000,88,01011000,192,11000000
33,00100001,14,00001110,47,00101111
40,00101000,50,00110010,90,01011010
14,00001110,20,00010100,34,00100010
116,01110100,31,00011111,147,10010011
57,00111001,39,00100111,96,01100000
0,00000000,1,00000001,1,00000001
67,01000011,59,00111011,126,01111110
46,00101110,116,01110100,162,10100010
121,01111001,19,00010011,140,10001100
90,01011010,80,01010000,170,10101010
23,00010111,79,01001111,102,01100110
98,01100010,16,00010000,114,01110010
21,00010101,98,01100010,119,01110111
31,00011111,106,01101010,137,10001001
100,01100100,63,00111111,163,10100011
52,00110100,111,01101111,163,10100011
24,00011000,66,01000010,90,01011010
62,00111110,75,01001011,137,10001001
19,00010011,88,01011000,107,01101011
15,00001111,45,00101101,60,00111100
70,01000110,69,01000101,139,10001011
126,01111110,22,00010110,148,10010100
52,00110100,83,01010011,135,10000111
106,01101010,104,01101000,210,11010010
52,00110100,69,01000101,121,01111001
13,00001101,82,01010010,95,01011111
67,01000011,32,00100000,99,01100011
62,00111110,101,01100101,163,10100011
73,01001001,35,00100011,108,01101100
34,00100010,51,00110011,85,01010101
52,00110100,35,00100011,87,01010111
88,01011000,93,01011101,181,10110101
7,00000111,118,01110110,125,01111101
36,00100100,117,01110101,153,10011001
63,00111111,104,01101000,167,10100111
107,01101011,18,00010010,125,01111101
42,00101010,6,00000110,48,00110000
63,00111111,1,00000001,64,01000000
127,01111111,83,01010011,210,11010010
11,00001011,108,01101100,119,01110111
55,00110111,118,01110110,173,10101101
7,00000111,106,01101010,113,01110001
87,01010111,87,01010111,174,10101110
45,00101101,114,01110010,159,10011111
38,00100110,73,01001001,111,01101111
63,00111111,48,00110000,111,01101111
56,00111000,10,00001010,66,01000010
105,01101001,84,01010100,189,10111101
39,00100111,48,00110000,87,01010111
105,01101001,109,01101101,214,11010110
119,01110111,90,01011010,209,11010001
13,00001101,55,00110111,68,01000100
103,01100111,95,01011111,198,11000110
45,00101101,113,01110001,158,10011110
111,01101111,18,00010010,129,10000001
39,00100111,99,01100011,138,10001010
110,01101110,49,00110001,159,10011111
91,01011011,53,00110101,144,10010000
63,00111111,46,00101110,109,01101101
17,00010001,94,01011110,111,01101111
64,01000000,113,01110001,177,10110001
51,00110011,121,01111001,172,10101100
42,00101010,42,00101010,84,01010100
22,00010110,126,01111110,148,10010100
97,01100001,123,01111011,220,11011100
8,00001000,92,01011100,100,01100100
97,01100001,69,01000101,166,10100110
82,01010010,36,00100100,118,01110110
63,00111111,49,00110001,112,01110000
4,00000100,74,01001010,78,01001110
65,01000001,11,00001011,76,01001100
119,01110111,13,00001101,132,10000100
94,01011110,98,01100010,192,11000000
38,00100110,113,01110001,151,10010111
8,00001000,27,00011011,35,00100011
2,00000010,104,01101000,106,01101010
99,01100011,93,01011101,192,11000000
121,01111001,63,00111111,184,10111000
29,00011101,73,01001001,102,01100110
72,01001000,21,00010101,93,01011101
24,00011000,6,00000110,30,00011110
106,01101010,63,00111111,169,10101001
106,01101010,86,01010110,192,11000000
90,01011010,26,00011010,116,01110100
55,00110111,39,00100111,94,01011110
88,01011000,53,00110101,141,10001101
49,00110001,36,00100100,85,01010101
123,01111011,106,01101010,229,11100101
91,01011011,105,01101001,196,11000100
37,00100101,40,00101000,77,01001101
66,01000010,54,00110110,120,01111000
44,00101100,121,01111001,165,10100101
38,00100110,88,01011000,126,01111110
122,01111010,106,01101010,228,11100100
70,01000110,87,01010111,157,10011101
50,00110010,49,00110001,99,01100011
104,01101000,49,00110001,153,10011001
115,01110011,123,01111011,238,11101110
116,01110100,116,01110100,232,11101000
88,01011000,99,01100011,187,10111011
86,01010110,97,01100001,183,10110111
3,00000011,34,00100010,37,00100101
59,00111011,41,00101001,100,01100100
82,01010010,48,00110000,130,10000010
96,01100000,91,01011011,187,10111011
46,00101110,93,01011101,139,10001011
116,01110100,81,01010001,197,11000101
121,01111001,124,01111100,245,11110101
9,00001001,107,01101011,116,01110100
122,01111010,40,00101000,162,10100010
11,00001011,75,01001011,86,01010110
70,01000110,82,01010010,152,10011000
37,00100101,77,01001101,114,01110010
108,01101100,3,00000011,111,01101111
51,00110011,14,00001110,65,01000001
3,00000011,81,01010001,84,01010100
77,01001101,13,00001101,90,01011010
4,00000100,59,00111011,63,00111111
98,01100010,12,00001100,110,01101110
123,01111011,32,00100000,155,10011011
114,01110010,38,00100110,152,10011000
102,01100110,6,00000110,108,01101100
107,01101011,26,00011010,133,10000101
42,00101010,38,00100110,80,01010000
0,00000000,37,00100101,37,00100101
1,00000001,108,01101100,109,01101101
12,00001100,26,00011010,38,00100110
64,01000000,80,01010000,144,10010000
113,01110001,17,00010001,130,10000010
12,00001100,37,00100101,49,00110001
120,01111000,107,01101011,227,11100011
55,00110111,27,00011011,82,01010010
84,01010100,108,01101100,192,11000000
35,00100011,3,00000011,38,00100110
32,00100000,105,01101001,137,10001001
12,00001100,95,01011111,107,01101011
40,00101000,82,01010010,122,01111010
45,00101101,82,01010010,127,01111111
89,01011001,110,01101110,199,11000111
46,00101110,60,00111100,106,01101010
50,00110010,56,00111000,106,01101010
45,00101101,108,01101100,153,10011001
50,00110010,90,01011010,140,10001100
56,00111000,28,00011100,84,01010100
45,00101101,95,01011111,140,10001100
125,01111101,127,01111111,252,11111100
75,01001011,73,01001001,148,10010100
77,01001101,112,01110000,189,10111101
12,00001100,16,00010000,28,00011100
96,01100000,74,01001010,170,10101010
50,00110010,105,01101001,155,10011011
92,01011100,111,01101111,203,11001011
59,00111011,87,01010111,146,10010010
115,01110011,33,00100001,148,10010100
98,01100010,12,00001100,110,01101110
22,00010110,27,00011011,49,00110001
106,01101010,16,00010000,122,01111010
47,00101111,113,01110001,160,10100000
60,00111100,79,01001111,139,10001011
52,00110100,34,00100010,86,01010110
53,00110101,65,01000001,118,01110110
8,00001000,40,00101000,48,00110000
70,01000110,87,01010111,157,10011101
69,01000101,41,00101001,110,01101110
3,00000011,43,00101011,46,00101110
120,01111000,24,00011000,144,10010000
64,01000000,120,01111000,184,10111000
18,00010010,127,01111111,145,10010001
11,00001011,81,01010001,92,01011100
99,01100011,109,01101101,208,11010000
44,00101100,123,01111011,167,10100111
85,01010101,35,00100011,120,01111000
96,01100000,46,00101110,142,10001110
104,01101000,40,00101000,144,10010000
126,01111110,78,01001110,204,11001100
27,00011011,97,01100001,124,01111100
29,00011101,103,01100111,132,10000100
15,00001111,0,00000000,15,00001111
107,01101011,112,01110000,219,11011011
34,00100010,6,00000110,40,00101000
70,01000110,18,00010010,88,01011000
89,01011001,123,01111011,212,11010100
69,01000101,104,01101000,173,10101101
74,01001010,87,01010111,161,10100001
80,01010000,53,00110101,133,10000101
7,00000111,20,00010100,27,00011011
82,01010010,80,01010000,162,10100010
22,00010110,47,00101111,69,01000101
85,01010101,72,01001000,157,10011101
65,01000001,105,01101001,170,10101010
56,00111000,24,00011000,80,01010000
105,01101001,52,00110100,157,10011101
127,01111111,117,01110101,244,11110100
13,00001101,111,01101111,124,01111100
19,00010011,45,00101101,64,01000000
41,00101001,39,00100111,80,01010000
80,01010000,22,00010110,102,01100110
108,01101100,78,01001110,186,10111010
3,00000011,9,00001001,12,00001100
51,00110011,95,01011111,146,10010010
111,01101111,23,00010111,134,10000110
53,00110101,124,01111100,177,10110001
41,00101001,81,01010001,122,01111010
102,01100110,105,01101001,207,11001111
32,00100000,35,00100011,67,01000011
51,00110011,3,00000011,54,00110110
11,00001011,52,00110100,63,00111111
19,00010011,123,01111011,142,10001110
34,00100010,7,00000111,41,00101001
41,00101001,37,00100101,78,01001110
85,01010101,87,01010111,172,10101100
61,00111101,10,00001010,71,01000111
15,00001111,49,00110001,64,01000000
74,01001010,111,01101111,185,10111001
71,01000111,106,01101010,177,10110001
50,00110010,55,00110111,105,01101001
51,00110011,59,00111011,110,01101110
123,01111011,18,00010010,141,10001101
102,01100110,26,00011010,128,10000000
38,00100110,114,01110010,152,10011000
63,00111111,58,00111010,121,01111001
28,00011100,126,01111110,154,10011010
19,00010011,81,01010001,100,01100100
61,00111101,93,01011101,154,10011010
45,00101101,71,01000111,116,01110100
87,01010111,32,00100000,119,01110111
37,00100101,81,01010001,118,01110110
30,00011110,21,00010101,51,00110011
96,01100000,37,00100101,133,10000101
84,01010100,47,00101111,131,10000011
37,00100101,17,00010001,54,00110110
90,01011010,24,00011000,114,01110010
22,00010110,11,00001011,33,00100001
52,00110100,87,01010111,139,10001011
106,01101010,32,00100000,138,10001010
25,00011001,9,00001001,34,00100010
75,01001011,10,00001010,85,01010101
114,01110010,85,01010101,199,11000111
24,00011000,64,01000000,88,01011000
113,01110001,5,00000101,118,01110110
101,01100101,105,01101001,206,11001110
11,00001011,44,00101100,55,00110111
60,00111100,74,01001010,134,10000110
106,01101010,14,00001110,120,01111000
76,01001100,107,01101011,183,10110111
11,00001011,121,01111001,132,10000100
79,01001111,26,00011010,105,01101001
94,01011110,125,01111101,219,11011011
127,01111111,90,01011010,217,11011001
70,01000110,43,00101011,113,01110001
6,00000110,98,01100010,104,01101000
56,00111000,72,01001000,128,10000000
104,01101000,52,00110100,156,10011100
45,00101101,11,00001011,56,00111000
15,00001111,122,01111010,137,10001001
42,00101010,21,00010101,63,00111111
67,01000011,35,00100011,102,01100110
35,00100011,38,00100110,73,01001001
55,00110111,120,01111000,175,10101111
70,01000110,27,00011011,97,01100001
100,01100100,104,01101000,204,11001100
50,00110010,56,00111000,106,01101010
72,01001000,41,00101001,113,01110001
16,00010000,5,00000101,21,00010101
19,00010011,73,01001001,92,01011100
59,00111011,2,00000010,61,00111101
126,01111110,56,00111000,182,10110110
82,01010010,68,01000100,150,10010110
44,00101100,120,01111000,164,10100100
86,01010110,19,00010011,105,01101001
121,01111001,125,01111101,246,11110110
31,00011111,43,00101011,74,01001010
39,00100111,48,00110000,87,01010111
7,00000111,95,01011111,102,01100110
76,01001100,2,00000010,78,01001110
118,01110110,19,00010011,137,10001001
56,00111000,81,01010001,137,10001001
100,01100100,32,00100000,132,10000100
54,00110110,76,01001100,130,10000010
16,00010000,120,01111000,136,10001000
63,00111111,40,00101000,103,01100111
24,00011000,6,00000110,30,00011110
34,00100010,107,01101011,141,10001101
103,01100111,63,00111111,166,10100110
65,01000001,110,01101110,175,10101111
78,01001110,32,00100000,110,01101110
34,00100010,121,01111001,155,10011011
68,01000100,122,01111010,190,10111110
17,00010001,103,01100111,120,01111000
74,01001010,40,00101000,114,01110010
77,01001101,43,00101011,120,01111000
84,01010100,92,01011100,176,10110000
64,01000000,58,00111010,122,01111010
21,00010101,97,01100001,118,01110110
35,00100011,106,01101010,141,10001101
82,01010010,47,00101111,129,10000001
91,01011011,25,00011001,116,01110100
85,01010101,78,01001110,163,10100011
16,00010000,58,00111010,74,01001010
7,00000111,88,01011000,95,01011111
89,01011001,46,00101110,135,10000111
126,01111110,95,01011111,221,11011101
125,01111101,84,01010100,209,11010001
61,00111101,20,00010100,81,01010001
91,01011011,48,00110000,139,10001011
20,00010100,16,00010000,36,00100100
33,00100001,117,01110101,150,10010110
45,00101101,89,01011001,134,10000110
124,01111100,6,00000110,130,10000010
127,01111111,112,01110000,239,11101111
72,01001000,21,00010101,93,01011101
38,00100110,5,00000101,43,00101011
8,00001000,73,01001001,81,01010001
8,00001000,27,00011011,35,00100011
114,01110010,50,00110010,164,10100100
69,01000101,115,01110011,184,10111000
24,00011000,58,00111010,82,01010010
69,01000101,71,01000111,140,10001100
49,00110001,123,01111011,172,10101100
52,00110100,79,01001111,131,10000011
69,01000101,93,01011101,162,10100010
110,01101110,46,00101110,156,10011100
21,00010101,53,00110101,74,01001010
11,00001011,61,00111101,72,01001000
81,01010001,75,01001011,156,10011100
112,01110000,5,00000101,117,01110101
98,01100010,92,01011100,190,10111110
104,01101000,54,00110110,158,10011110
114,01110010,25,00011001,139,10001011
121,01111001,120,01111000,241,11110001
10,00001010,54,00110110,64,01000000
8,00001000,61,00111101,69,01000101
70,01000110,8,00001000,78,01001110
62,00111110,79,01001111,141,10001101
66,01000010,58,00111010,124,01111100
7,00000111,25,00011001,32,00100000
50,00110010,71,01000111,121,01111001
2,00000010,97,01100001,99,01100011
8,00001000,88,01011000,96,01100000
52,00110100,24,00011000,76,01001100
115,01110011,26,00011010,141,10001101
30,00011110,23,00010111,53,00110101
89,01011001,9,00001001,98,01100010
72,01001000,63,00111111,135,10000111
83,01010011,112,01110000,195,11000011
66,01000010,45,00101101,111,01101111
86,01010110,127,01111111,213,11010101
115,01110011,36,00100100,151,10010111
35,00100011,35,00100011,70,01000110
81,01010001,127,01111111,208,11010000
54,00110110,27,00011011,81,01010001
7,00000111,105,01101001,112,01110000
58,00111010,73,01001001,131,10000011
54,00110110,58,00111010,112,01110000
114,01110010,35,00100011,149,10010101
60,00111100,58,00111010,118,01110110
13,00001101,52,00110100,65,01000001
67,01000011,89,01011001,156,10011100
127,01111111,41,00101001,168,10101000
82,01010010,18,00010010,100,01100100
23,00010111,17,00010001,40,00101000
103,01100111,26,00011010,129,10000001
40,00101000,52,00110100,92,01011100
55,00110111,34,00100010,89,01011001
33,00100001,71,01000111,104,01101000
43,00101011,12,00001100,55,00110111
1,00000001,91,01011011,92,01011100
111,01101111,126,01111110,237,11101101
9,00001001,87,01010111,96,01100000
106,01101010,90,01011010,196,11000100
125,01111101,22,00010110,147,10010011
20,00010100,27,00011011,47,00101111
44,00101100,88,01011000,132,10000100
40,00101000,77,01001101,117,01110101
119,01110111,5,00000101,124,01111100
113,01110001,88,01011000,201,11001001
32,00100000,62,00111110,94,01011110
104,01101000,90,01011010,194,11000010
93,01011101,72,01001000,165,10100101
33,00100001,29,00011101,62,00111110
121,01111001,81,01010001,202,11001010
122,01111010,25,00011001,147,10010011
90,01011010,120,01111000,210,11010010
53,00110101,23,00010111,76,01001100
127,01111111,0,00000000,127,01111111
22,00010110,11,00001011,33,00100001
75,01001011,33,00100001,108,01101100
53,00110101,1,00000001,54,00110110
57,00111001,4,00000100,61,00111101
58,00111010,24,00011000,82,01010010
65,01000001,25,00011001,90,01011010
82,01010010,69,01000101,151,10010111
15,00001111,54,00110110,69,01000101
80,01010000,81,01010001,161,10100001
25,00011001,86,01010110,111,01101111
84,01010100,33,00100001,117,01110101
106,01101010,66,01000010,172,10101100
2,00000010,88,01011000,90,01011010
62,00111110,96,01100000,158,10011110
61,00111101,71,01000111,132,10000100
49,00110001,27,00011011,76,01001100
88,01011000,77,01001101,165,10100101
47,00101111,12,00001100,59,00111011
81,01010001,15,00001111,96,01100000
9,00001001,45,00101101,54,00110110
5,00000101,115,01110011,120,01111000
61,00111101,17,00010001,78,01001110
104,01101000,45,00101101,149,10010101
104,01101000,87,01010111,191,10111111
63,00111111,69,01000101,132,10000100
57,00111001,120,01111000,177,10110001
23,00010111,4,00000100,27,00011011
124,01111100,111,01101111,235,11101011
117,01110101,125,01111101,242,11110010
79,01001111,59,00111011,138,10001010
0,00000000,118,01110110,118,01110110
74,01001010,25,00011001,99,01100011
2,00000010,43,00101011,45,00101101
124,01111100,51,00110011,175,10101111
113,01110001,115,01110011,228,11100100
0,00000000,56,00111000,56,00111000
79,01001111,40,00101000,119,01110111
112,01110000,123,01111011,235,11101011
115,01110011,120,01111000,235,11101011
94,01011110,9,00001001,103,01100111
8,00001000,111,01101111,119,01110111
108,01101100,83,01010011,191,10111111
74,01001010,100,01100100,174,10101110
55,00110111,100,01100100,155,10011011
66,01000010,105,01101001,171,10101011
49,00110001,82,01010010,131,10000011
99,01100011,117,01110101,216,11011000
105,01101001,79,01001111,184,10111000
24,00011000,105,01101001,129,10000001
54,00110110,113,01110001,167,10100111
10,00001010,89,01011001,99,01100011
116,01110100,122,01111010,238,11101110
64,01000000,124,01111100,188,10111100
120,01111000,59,00111011,179,10110011
29,00011101,28,00011100,57,00111001
5,00000101,126,01111110,131,10000011
15,00001111,104,01101000,119,01110111
78,01001110,84,01010100,162,10100010
29,00011101,75,01001011,104,01101000
51,00110011,103,01100111,154,10011010
45,00101101,111,01101111,156,10011100
9,00001001,56,00111000,65,01000001
3,00000011,27,00011011,30,00011110
86,01010110,26,00011010,112,01110000
13,00001101,98,01100010,111,01101111
44,00101100,26,00011010,70,01000110
0,00000000,81,01010001,81,01010001
113,01110001,104,01101000,217,11011001
40,00101000,96,01100000,136,10001000
106,01101010,55,00110111,161,10100001
31,00011111,120,01111000,151,10010111
93,01011101,100,01100100,193,11000001
39,00100111,28,00011100,67,01000011
1,00000001,90,01011010,91,01011011
14,00001110,87,01010111,101,01100101
123,01111011,81,01010001,204,11001100
36,00100100,12,00001100,48,00110000
47,00101111,13,00001101,60,00111100
104,01101000,15,00001111,119,01110111
61,00111101,119,01110111,180,10110100
15,00001111,77,01001101,92,01011100
2,00000010,115,01110011,117,01110101
74,01001010,50,00110010,124,01111100
76,01001100,62,00111110,138,10001010
42,00101010,16,00010000,58,00111010
66,01000010,80,01010000,146,10010010
85,01010101,33,00100001,118,01110110
110,01101110,29,00011101,139,10001011
60,00111100,31,00011111,91,01011011
13,00001101,4,00000100,17,00010001
81,01010001,58,00111010,139,10001011
5,00000101,59,00111011,64,01000000
104,01101000,117,01110101,221,11011101
8,00001000,5,00000101,13,00001101
116,01110100,55,00110111,171,10101011
103,01100111,99,01100011,202,11001010
77,01001101,101,01100101,178,10110010
108,01101100,20,00010100,128,10000000
114,01110010,115,01110011,229,11100101
117,01110101,12,00001100,129,10000001
15,00001111,14,00001110,29,00011101
117,01110101,102,01100110,219,11011011
45,00101101,4,00000100,49,00110001
48,00110000,3,00000011,51,00110011
41,00101001,98,01100010,139,10001011
70,01000110,79,01001111,149,10010101
64,01000000,86,01010110,150,10010110
92,01011100,71,01000111,163,10100011
51,00110011,29,00011101,80,01010000
52,00110100,82,01010010,134,10000110
123,01111011,60,00111100,183,10110111
29,00011101,34,00100010,63,00111111
70,01000110,110,01101110,180,10110100
50,00110010,113,01110001,163,10100011
81,01010001,100,01100100,181,10110101
51,00110011,12,00001100,63,00111111
98,01100010,51,00110011,149,10010101
54,00110110,120,01111000,174,10101110
1,00000001,93,01011101,94,01011110
72,01001000,104,01101000,176,10110000
71,01000111,62,00111110,133,10000101
90,01011010,120,01111000,210,11010010
126,01111110,42,00101010,168,10101000
102,01100110,85,01010101,187,10111011
87,01010111,71,01000111,158,10011110
73,01001001,97,01100001,170,10101010
83,01010011,125,01111101,208,11010000
100,01100100,88,01011000,188,10111100
64,01000000,96,01100000,160,10100000
73,01001001,59,00111011,132,10000100
43,00101011,111,01101111,154,10011010
113,01110001,62,00111110,175,10101111
29,00011101,99,01100011,128,10000000
61,00111101,36,00100100,97,01100001
73,01001001,109,01101101,182,10110110
56,00111000,48,00110000,104,01101000
42,00101010,24,00011000,66,01000010
87,01010111,125,01111101,212,11010100
65,01000001,76,01001100,141,10001101
33,00100001,58,00111010,91,01011011
111,01101111,2,00000010,113,01110001
104,01101000,125,01111101,229,11100101
42,00101010,38,00100110,80,01010000
99,01100011,107,01101011,206,11001110
55,00110111,15,00001111,70,01000110
95,01011111,21,00010101,116,01110100
27,00011011,20,00010100,47,00101111
68,01000100,99,01100011,167,10100111
62,00111110,36,00100100,98,01100010
109,01101101,72,01001000,181,10110101
104,01101000,101,01100101,205,11001101
20,00010100,82,01010010,102,01100110
51,00110011,120,01111000,171,10101011
41,00101001,40,00101000,81,01010001
78,01001110,115,01110011,193,11000001
27,00011011,55,00110111,82,01010010
42,00101010,33,00100001,75,01001011
87,01010111,6,00000110,93,01011101
100,01100100,7,00000111,107,01101011
18,00010010,12,00001100,30,00011110
36,00100100,25,00011001,61,00111101
24,00011000,127,01111111,151,10010111
60,00111100,96,01100000,156,10011100
23,00010111,68,01000100,91,01011011
49,00110001,103,01100111,152,10011000
55,00110111,113,01110001,168,10101000
72,01001000,18,00010010,90,01011010
81,01010001,50,00110010,131,10000011
30,00011110,21,00010101,51,00110011
23,00010111,39,00100111,62,00111110
95,01011111,26,00011010,121,01111001
65,01000001,45,00101101,110,01101110
47,00101111,81,01010001,128,10000000
127,01111111,67,01000011,194,11000010
14,00001110,103,01100111,117,01110101
69,01000101,37,00100101,106,01101010
96,01100000,47,00101111,143,10001111
75,01001011,2,00000010,77,01001101
6,00000110,55,00110111,61,00111101
63,00111111,122,01111010,185,10111001
93,01011101,72,01001000,165,10100101
22,00010110,93,01011101,115,01110011
103,01100111,80,01010000,183,10110111
126,01111110,40,00101000,166,10100110
87,01010111,51,00110011,138,10001010
87,01010111,89,01011001,176,10110000
114,01110010,98,01100010,212,11010100
48,00110000,105,01101001,153,10011001
83,01010011,94,01011110,177,10110001
105,01101001,123,01111011,228,11100100
65,01000001,25,00011001,90,01011010
8,00001000,93,01011101,101,01100101
75,01001011,124,01111100,199,11000111
3,00000011,100,01100100,103,01100111
121,01111001,37,00100101,158,10011110
127,01111111,12,00001100,139,10001011
25,00011001,35,00100011,60,00111100
101,01100101,115,01110011,216,11011000
104,01101000,52,00110100,156,10011100
68,01000100,67,01000011,135,10000111
9,00001001,99,01100011,108,01101100
3,00000011,127,01111111,130,10000010
8,00001000,121,01111001,129,10000001
123,01111011,43,00101011,166,10100110
113,01110001,53,00110101,166,10100110
119,01110111,7,00000111,126,01111110
101,01100101,101,01100101,202,11001010
20,00010100,57,00111001,77,01001101
4,00000100,55,00110111,59,00111011
60,00111100,63,00111111,123,01111011
60,00111100,49,00110001,109,01101101
52,00110100,80,01010000,132,10000100
98,01100010,18,00010010,116,01110100
9,00001001,79,01001111,88,01011000
23,00010111,9,00001001,32,00100000
104,01101000,86,01010110,190,10111110
32,00100000,36,00100100,68,01000100
103,01100111,96,01100000,199,11000111
29,00011101,52,00110100,81,01010001
62,00111110,76,01001100,138,10001010
93,01011101,104,01101000,197,11000101
109,01101101,83,01010011,192,11000000
126,01111110,24,00011000,150,10010110
35,00100011,75,01001011,110,01101110
82,01010010,14,00001110,96,01100000
48,00110000,109,01101101,157,10011101
96,01100000,3,00000011,99,01100011
91,01011011,116,01110100,207,11001111
24,00011000,104,01101000,128,10000000
87,01010111,45,00101101,132,10000100
13,00001101,56,00111000,69,01000101
61,00111101,125,01111101,186,10111010
61,00111101,24,00011000,85,01010101
69,01000101,73,01001001,142,10001110
24,00011000,124,01111100,148,10010100
112,01110000,67,01000011,179,10110011
50,00110010,20,00010100,70,01000110
113,01110001,115,01110011,228,11100100
45,00101101,8,00001000,53,00110101
52,00110100,31,00011111,83,01010011
57,00111001,118,01110110,175,10101111
35,00100011,68,01000100,103,01100111
45,00101101,120,01111000,165,10100101
111,01101111,6,00000110,117,01110101
85,01010101,85,01010101,170,10101010
123,01111011,65,01000001,188,10111100
63,00111111,65,01000001,128,10000000
14,00001110,78,01001110,92,01011100
103,01100111,22,00010110,125,01111101
30,00011110,34,00100010,64,01000000
106,01101010,115,01110011,221,11011101
99,01100011,99,01100011,198,11000110
49,00110001,83,01010011,132,10000100
116,01110100,76,01001100,192,11000000
5,00000101,29,00011101,34,00100010
66,01000010,110,01101110,176,10110000
124,01111100,114,01110010,238,11101110
76,01001100,75,01001011,151,10010111
29,00011101,33,00100001,62,00111110
106,01101010,27,00011011,133,10000101
83,01010011,52,00110100,135,10000111
22,00010110,34,00100010,56,00111000
5,00000101,50,00110010,55,00110111
122,01111010,45,00101101,167,10100111
108,01101100,106,01101010,214,11010110
112,01110000,5,00000101,117,01110101
122,01111010,124,01111100,246,11110110
100,01100100,1,00000001,101,01100101
31,00011111,73,01001001,104,01101000
42,00101010,61,00111101,103,01100111
108,01101100,37,00100101,145,10010001
22,00010110,2,00000010,24,00011000
16,00010000,93,01011101,109,01101101
119,01110111,79,01001111,198,11000110
22,00010110,107,01101011,129,10000001
18,00010010,8,00001000,26,00011010
18,00010010,112,01110000,130,10000010
81,01010001,103,01100111,184,10111000
78,01001110,29,00011101,107,01101011
121,01111001,105,01101001,226,11100010
119,01110111,20,00010100,139,10001011
125,01111101,121,01111001,246,11110110
87,01010111,114,01110010,201,11001001
28,00011100,67,01000011,95,01011111
122,01111010,120,01111000,242,11110010
113,01110001,93,01011101,206,11001110
62,00111110,4,00000100,66,01000010
114,01110010,89,01011001,203,11001011
79,01001111,109,01101101,188,10111100
79,01001111,84,01010100,163,10100011
20,00010100,21,00010101,41,00101001
68,01000100,64,01000000,132,10000100
58,00111010,31,00011111,89,01011001
11,00001011,78,01001110,89,01011001
11,00001011,69,01000101,80,01010000
65,01000001,118,01110110,183,10110111
8,00001000,5,00000101,13,00001101
96,01100000,115,01110011,211,11010011
119,01110111,63,00111111,182,10110110
78,01001110,124,01111100,202,11001010
125,01111101,48,00110000,173,10101101
104,01101000,52,00110100,156,10011100
70,01000110,101,01100101,171,10101011
44,00101100,87,01010111,131,10000011
123,01111011,57,00111001,180,10110100
46,00101110,111,01101111,157,10011101
91,01011011,7,00000111,98,01100010
70,01000110,33,00100001,103,01100111
20,00010100,66,01000010,86,01010110
84,01010100,75,01001011,159,10011111
50,00110010,27,00011011,77,01001101
93,01011101,97,01100001,190,10111110
83,01010011,106,01101010,189,10111101
55,00110111,99,01100011,154,10011010
124,01111100,26,00011010,150,10010110
113,01110001,35,00100011,148,10010100
36,00100100,42,00101010,78,01001110
13,00001101,97,01100001,110,01101110
119,01110111,33,00100001,152,10011000
13,00001101,85,01010101,98,01100010
73,01001001,61,00111101,134,10000110
124,01111100,84,01010100,208,11010000
32,00100000,94,01011110,126,01111110
100,01100100,1,00000001,101,01100101
85,01010101,6,00000110,91,01011011
82,01010010,82,01010010,164,10100100
12,00001100,92,01011100,104,01101000
111,01101111,8,00001000,119,01110111
62,00111110,10,00001010,72,01001000
63,00111111,125,01111101,188,10111100
49,00110001,32,00100000,81,01010001
49,00110001,90,01011010,139,10001011
122,01111010,43,00101011,165,10100101
114,01110010,71,01000111,185,10111001
127,01111111,68,01000100,195,11000011
37,00100101,87,01010111,124,01111100
20,00010100,65,01000001,85,01010101
97,01100001,102,01100110,199,11000111
44,00101100,82,01010010,126,01111110
21,00010101,61,00111101,82,01010010
125,01111101,13,00001101,138,10001010
127,01111111,6,00000110,133,10000101
13,00001101,45,00101101,58,00111010
90,01011010,9,00001001,99,01100011
26,00011010,67,01000011,93,01011101
92,01011100,97,01100001,189,10111101
114,01110010,33,00100001,147,10010011
64,01000000,55,00110111,119,01110111
84,01010100,83,01010011,167,10100111
22,00010110,23,00010111,45,00101101
94,01011110,6,00000110,100,01100100
42,00101010,64,01000000,106,01101010
121,01111001,109,01101101,230,11100110
0,00000000,100,01100100,100,01100100
73,01001001,20,00010100,93,01011101
10,00001010,17,00010001,27,00011011
104,01101000,84,01010100,188,10111100
99,01100011,89,01011001,188,10111100
85,01010101,14,00001110,99,01100011
0,00000000,34,00100010,34,00100010
12,00001100,121,01111001,133,10000101
19,00010011,24,00011000,43,00101011
63,00111111,120,01111000,183,10110111
16,00010000,119,01110111,135,10000111
40,00101000,36,00100100,76,01001100
85,01010101,90,01011010,175,10101111
94,01011110,22,00010110,116,01110100
82,01010010,82,01010010,164,10100100
87,01010111,90,01011010,177,10110001
95,01011111,67,01000011,162,10100010
14,00001110,96,01100000,110,01101110
76,01001100,92,01011100,168,10101000
10,00001010,127,01111111,137,10001001
26,00011010,98,01100010,124,01111100
97,01100001,91,01011011,188,10111100
111,01101111,41,00101001,152,10011000
26,00011010,10,00001010,36,00100100
28,00011100,117,01110101,145,10010001
109,01101101,44,00101100,153,10011001
70,01000110,103,01100111,173,10101101
63,00111111,5,00000101,68,01000100
1,00000001,57,00111001,58,00111010
61,00111101,33,00100001,94,01011110
64,01000000,63,00111111,127,01111111
30,00011110,92,01011100,122,01111010
64,01000000,68,01000100,132,10000100
7,00000111,0,00000000,7,00000111
10,00001010,103,01100111,113,01110001
46,00101110,89,01011001,135,10000111
117,01110101,109,01101101,226,11100010
69,01000101,18,00010010,87,01010111
90,01011010,19,00010011,109,01101101
111,01101111,81,01010001,192,11000000
34,00100010,108,01101100,142,10001110
29,00011101,28,00011100,57,00111001
0,00000000,126,01111110,126,01111110
1,00000001,61,00111101,62,00111110
125,01111101,58,00111010,183,10110111
93,01011101,107,01101011,200,11001000
113,01110001,20,00010100,133,10000101
85,01010101,123,01111011,208,11010000
44,00101100,100,01100100,144,10010000
114,01110010,70,01000110,184,10111000
103,01100111,63,00111111,166,10100110
69,01000101,8,00001000,77,01001101
27,00011011,117,01110101,144,10010000
111,01101111,99,01100011,210,11010010
63,00111111,92,01011100,155,10011011
10,00001010,46,00101110,56,00111000
106,01101010,6,00000110,112,01110000
89,01011001,2,00000010,91,01011011
52,00110100,91,01011011,143,10001111
27,00011011,39,00100111,66,01000010
64,01000000,66,01000010,130,10000010
125,01111101,0,00000000,125,01111101
16,00010000,117,01110101,133,10000101
53,00110101,23,00010111,76,01001100
103,01100111,40,00101000,143,10001111
68,01000100,86,01010110,154,10011010
126,01111110,95,01011111,221,11011101
121,01111001,73,01001001,194,11000010
3,00000011,73,01001001,76,01001100
37,00100101,31,00011111,68,01000100
31,00011111,58,00111010,89,01011001
25,00011001,87,01010111,112,01110000
112,01110000,53,00110101,165,10100101
90,01011010,51,00110011,141,10001101
47,00101111,81,01010001,128,10000000
124,01111100,72,01001000,196,11000100
43,00101011,106,01101010,149,10010101
122,01111010,63,00111111,185,10111001
114,01110010,41,00101001,155,10011011
64,01000000,102,01100110,166,10100110
12,00001100,4,00000100,16,00010000
44,00101100,48,00110000,92,01011100
104,01101000,22,00010110,126,01111110
66,01000010,107,01101011,173,10101101
102,01100110,6,00000110,108,01101100
53,00110101,12,00001100,65,01000001
41,00101001,83,01010011,124,01111100
69,01000101,62,00111110,131,10000011
37,00100101,7,00000111,44,00101100
6,00000110,1,00000001,7,00000111
103,01100111,114,01110010,217,11011001
102,01100110,107,01101011,209,11010001
40,00101000,72,01001000,112,01110000
127,01111111,57,00111001,184,10111000
89,01011001,50,00110010,139,10001011
113,01110001,8,00001000,121,01111001
112,01110000,108,01101100,220,11011100
102,01100110,56,00111000,158,10011110
101,01100101,16,00010000,117,01110101
110,01101110,15,00001111,125,01111101
126,01111110,118,01110110,244,11110100
2,00000010,63,00111111,65,01000001
45,00101101,4,00000100,49,00110001
120,01111000,121,01111001,241,11110001
6,00000110,52,00110100,58,00111010
110,01101110,73,01001001,183,10110111
1,00000001,58,00111010,59,00111011
33,00100001,33,00100001,66,01000010
38,00100110,35,00100011,73,01001001
12,00001100,95,01011111,107,01101011
81,01010001,104,01101000,185,10111001
105,01101001,89,01011001,194,11000010
106,01101010,77,01001101,183,10110111
10,00001010,60,00111100,70,01000110
58,00111010,17,00010001,75,01001011
48,00110000,55,00110111,103,01100111
73,01001001,55,00110111,128,10000000
82,01010010,23,00010111,105,01101001
83,01010011,22,00010110,105,01101001
17,00010001,83,01010011,100,01100100
56,00111000,78,01001110,134,10000110
120,01111000,58,00111010,178,10110010
87,01010111,76,01001100,163,10100011
117,01110101,98,01100010,215,11010111
27,00011011,113,01110001,140,10001100
32,00100000,21,00010101,53,00110101
11,00001011,76,01001100,87,01010111
121,01111001,109,01101101,230,11100110
106,01101010,57,00111001,163,10100011
116,01110100,18,00010010,134,10000110
76,01001100,107,01101011,183,10110111
11,00001011,37,00100101,48,00110000
8,00001000,53,00110101,61,00111101
56,00111000,67,01000011,123,01111011
28,00011100,122,01111010,150,10010110
29,00011101,84,01010100,113,01110001
60,00111100,45,00101101,105,01101001
125,01111101,13,00001101,138,10001010
15,00001111,78,01001110,93,01011101
118,01110110,50,00110010,168,10101000
109,01101101,85,01010101,194,11000010
86,01010110,63,00111111,149,10010101
102,01100110,25,00011001,127,01111111
43,00101011,112,01110000,155,10011011
88,01011000,115,01110011,203,11001011
75,01001011,22,00010110,97,01100001
61,00111101,112,01110000,173,10101101
100,01100100,94,01011110,194,11000010
12,00001100,114,01110010,126,01111110
92,01011100,108,01101100,200,11001000
121,01111001,73,01001001,194,11000010
80,01010000,122,01111010,202,11001010
126,01111110,104,01101000,230,11100110
79,01001111,108,01101100,187,10111011
32,00100000,82,01010010,114,01110010
103,01100111,21,00010101,124,01111100
78,01001110,72,01001000,150,10010110
28,00011100,21,00010101,49,00110001
16,00010000,97,01100001,113,01110001
118,01110110,65,01000001,183,10110111
54,00110110,122,01111010,176,10110000
54,00110110,96,01100000,150,10010110
39,00100111,77,01001101,116,01110100
45,00101101,110,01101110,155,10011011
12,00001100,55,00110111,67,01000011
40,00101000,107,01101011,147,10010011
45,00101101,37,00100101,82,01010010
80,01010000,69,01000101,149,10010101
6,00000110,50,00110010,56,00111000
125,01111101,3,00000011,128,10000000
13,00001101,60,00111100,73,01001001
89,01011001,68,01000100,157,10011101
46,00101110,114,01110010,160,10100000
93,01011101,37,00100101,130,10000010
74,01001010,116,01110100,190,10111110
85,01010101,4,00000100,89,01011001
6,00000110,27,00011011,33,00100001
64,01000000,47,00101111,111,01101111
11,00001011,56,00111000,67,01000011
43,00101011,122,01111010,165,10100101
91,01011011,21,00010101,112,01110000
1,00000001,48,00110000,49,00110001
119,01110111,64,01000000,183,10110111
4,00000100,75,01001011,79,01001111
52,00110100,4,00000100,56,00111000
12,00001100,58,00111010,70,01000110
10,00001010,4,00000100,14,00001110
26,00011010,4,00000100,30,00011110
14,00001110,2,00000010,16,00010000
7,00000111,26,00011010,33,00100001
99,01100011,6,00000110,105,01101001
106,01101010,60,00111100,166,10100110
122,01111010,3,00000011,125,01111101
27,00011011,14,00001110,41,00101001
25,00011001,103,01100111,128,10000000
35,00100011,121,01111001,156,10011100
75,01001011,74,01001010,149,10010101
32,00100000,89,01011001,121,01111001
72,01001000,109,01101101,181,10110101
91,01011011,113,01110001,204,11001100
4,00000100,95,01011111,99,01100011
69,01000101,70,01000110,139,10001011
56,00111000,113,01110001,169,10101001
4,00000100,94,01011110,98,01100010
102,01100110,82,01010010,184,10111000
65,01000001,106,01101010,171,10101011
113,01110001,53,00110101,166,10100110
22,00010110,112,01110000,134,10000110
118,01110110,54,00110110,172,10101100
35,00100011,113,01110001,148,10010100
64,01000000,107,01101011,171,10101011
4,00000100,8,00001000,12,00001100
108,01101100,33,00100001,141,10001101
82,01010010,51,00110011,133,10000101
1,00000001,58,00111010,59,00111011
34,00100010,60,00111100,94,01011110
108,01101100,31,00011111,139,10001011
74,01001010,66,01000010,140,10001100
29,00011101,40,00101000,69,01000101
110,01101110,81,01010001,191,10111111
31,00011111,7,00000111,38,00100110
53,00110101,0,00000000,53,00110101
72,01001000,2,00000010,74,01001010
4,00000100,26,00011010,30,00011110
65,01000001,98,01100010,163,10100011
66,01000010,84,01010100,150,10010110
57,00111001,90,01011010,147,10010011
9,00001001,87,01010111,96,01100000
117,01110101,93,01011101,210,11010010
82,01010010,126,01111110,208,11010000
60,00111100,73,01001001,133,10000101
57,00111001,45,00101101,102,01100110
44,00101100,40,00101000,84,01010100
2,00000010,54,00110110,56,00111000
118,01110110,66,01000010,184,10111000
114,01110010,22,00010110,136,10001000
38,00100110,88,01011000,126,01111110
8,00001000,119,01110111,127,01111111
75,01001011,96,01100000,171,10101011
61,00111101,119,01110111,180,10110100
73,01001001,47,00101111,120,01111000
15,00001111,70,01000110,85,01010101
75,01001011,62,00111110,137,10001001
0,00000000,121,01111001,121,01111001
5,00000101,85,01010101,90,01011010
54,00110110,87,01010111,141,10001101
7,00000111,126,01111110,133,10000101
26,00011010,43,00101011,69,01000101
67,01000011,4,00000100,71,01000111
73,01001001,36,00100100,109,01101101
116,01110100,11,00001011,127,01111111
127,01111111,115,01110011,242,11110010
65,01000001,8,00001000,73,01001001
74,01001010,74,01001010,148,10010100
5,00000101,112,01110000,117,01110101
74,01001010,15,00001111,89,01011001
104,01101000,24,00011000,128,10000000
58,00111010,65,01000001,123,01111011
103,01100111,24,00011000,127,01111111
119,01110111,20,00010100,139,10001011
79,01001111,77,01001101,156,10011100
88,01011000,25,00011001,113,01110001
107,01101011,33,00100001,140,10001100
117,01110101,99,01100011,216,11011000
79,01001111,75,01001011,154,10011010
4,00000100,59,00111011,63,00111111
124,01111100,114,01110010,238,11101110
39,00100111,4,00000100,43,00101011
108,01101100,3,00000011,111,01101111
23,00010111,119,01110111,142,10001110
28,00011100,105,01101001,133,10000101
77,01001101,68,01000100,145,10010001
28,00011100,18,00010010,46,00101110
101,01100101,115,01110011,216,11011000
126,01111110,114,01110010,240,11110000
108,01101100,109,01101101,217,11011001
8,00001000,74,01001010,82,01010010
119,01110111,36,00100100,155,10011011
90,01011010,6,00000110,96,01100000
37,00100101,124,01111100,161,10100001
5,00000101,119,01110111,124,01111100
75,01001011,60,00111100,135,10000111
43,00101011,126,01111110,169,10101001
47,00101111,59,00111011,106,01101010
114,01110010,11,00001011,125,01111101
116,01110100,3,00000011,119,01110111
0,00000000,46,00101110,46,00101110
39,00100111,54,00110110,93,01011101
49,00110001,15,00001111,64,01000000
94,01011110,119,01110111,213,11010101
43,00101011,95,01011111,138,10001010
91,01011011,32,00100000,123,01111011
85,01010101,108,01101100,193,11000001
94,01011110,59,00111011,153,10011001
61,00111101,0,00000000,61,00111101
79,01001111,65,01000001,144,10010000
4,00000100,28,00011100,32,00100000
17,00010001,53,00110101,70,01000110
100,01100100,50,00110010,150,10010110
63,00111111,6,00000110,69,01000101
15,00001111,108,01101100,123,01111011
80,01010000,74,01001010,154,10011010
79,01001111,54,00110110,133,10000101
16,00010000,67,01000011,83,01010011
63,00111111,69,01000101,132,10000100
15,00001111,105,01101001,120,01111000
120,01111000,108,01101100,228,11100100
12,00001100,57,00111001,69,01000101
25,00011001,80,01010000,105,01101001
118,01110110,13,00001101,131,10000011
78,01001110,35,00100011,113,01110001
48,00110000,73,01001001,121,01111001
103,01100111,11,00001011,114,01110010
92,01011100,116,01110100,208,11010000
90,01011010,9,00001001,99,01100011
11,00001011,82,01010010,93,01011101
98,01100010,36,00100100,134,10000110
114,01110010,100,01100100,214,11010110
110,01101110,34,00100010,144,10010000
78,01001110,23,00010111,101,01100101
108,01101100,28,00011100,136,10001000
12,00001100,36,00100100,48,00110000
17,00010001,27,00011011,44,00101100
122,01111010,63,00111111,185,10111001
81,01010001,105,01101001,186,10111010
95,01011111,89,01011001,184,10111000
34,00100010,110,01101110,144,10010000
73,01001001,93,01011101,166,10100110
45,00101101,60,00111100,105,01101001
83,01010011,109,01101101,192,11000000
11,00001011,98,01100010,109,01101101
107,01101011,15,00001111,122,01111010
34,00100010,126,01111110,160,10100000
13,00001101,45,00101101,58,00111010
11,00001011,108,01101100,119,01110111
88,01011000,15,00001111,103,01100111
97,01100001,101,01100101,198,11000110
126,01111110,11,00001011,137,10001001
93,01011101,103,01100111,196,11000100
113,01110001,70,01000110,183,10110111
65,01000001,79,01001111,144,10010000
33,00100001,117,01110101,150,10010110
0,00000000,86,01010110,86,01010110
109,01101101,57,00111001,166,10100110
123,01111011,105,01101001,228,11100100
66,01000010,47,00101111,113,01110001
64,01000000,89,01011001,153,10011001
95,01011111,108,01101100,203,11001011
34,00100010,8,00001000,42,00101010
101,01100101,81,01010001,182,10110110
106,01101010,114,01110010,220,11011100
11,00001011,59,00111011,70,01000110
27,00011011,119,01110111,146,10010010
71,01000111,8,00001000,79,01001111
98,01100010,108,01101100,206,11001110
126,01111110,66,01000010,192,11000000
99,01100011,65,01000001,164,10100100
59,00111011,10,00001010,69,01000101
64,01000000,66,01000010,130,10000010
118,01110110,65,01000001,183,10110111
4,00000100,32,00100000,36,00100100
58,00111010,84,01010100,142,10001110
117,01110101,21,00010101,138,10001010
107,01101011,25,00011001,132,10000100
34,00100010,75,01001011,109,01101101
22,00010110,1,00000001,23,00010111
99,01100011,11,00001011,110,01101110
66,01000010,113,01110001,179,10110011
63,00111111,18,00010010,81,01010001
100,01100100,86,01010110,186,10111010
62,00111110,116,01110100,178,10110010
120,01111000,10,00001010,130,10000010
44,00101100,74,01001010,118,01110110
14,00001110,25,00011001,39,00100111
12,00001100,125,01111101,137,10001001
31,00011111,49,00110001,80,01010000
61,00111101,94,01011110,155,10011011
82,01010010,5,00000101,87,01010111
97,01100001,110,01101110,207,11001111
9,00001001,98,01100010,107,01101011
91,01011011,45,00101101,136,10001000
39,00100111,102,01100110,141,10001101
46,00101110,104,01101000,150,10010110
57,00111001,38,00100110,95,01011111
56,00111000,84,01010100,140,10001100
65,01000001,111,01101111,176,10110000
79,01001111,38,00100110,117,01110101
97,01100001,118,01110110,215,11010111
36,00100100,39,00100111,75,01001011
31,00011111,48,00110000,79,01001111
119,01110111,35,00100011,154,10011010
122,01111010,106,01101010,228,11100100
36,00100100,8,00001000,44,00101100
11,00001011,92,01011100,103,01100111
8,00001000,33,00100001,41,00101001
41,00101001,3,00000011,44,00101100
40,00101000,23,00010111,63,00111111
59,00111011,64,01000000,123,01111011
0,00000000,81,01010001,81,01010001
104,01101000,81,01010001,185,10111001
43,00101011,57,00111001,100,01100100
57,00111001,15,00001111,72,01001000
2,00000010,9,00001001,11,00001011
12,00001100,63,00111111,75,01001011
104,01101000,80,01010000,184,10111000
49,00110001,78,01001110,127,01111111
81,01010001,96,01100000,177,10110001
104,01101000,10,00001010,114,01110010
99,01100011,73,01001001,172,10101100
67,01000011,125,01111101,192,11000000
78,01001110,127,01111111,205,11001101
80,01010000,67,01000011,147,10010011
75,01001011,48,00110000,123,01111011
87,01010111,43,00101011,130,10000010
88,01011000,116,01110100,204,11001100
23,00010111,1,00000001,24,00011000
5,00000101,91,01011011,96,01100000
8,00001000,82,01010010,90,01011010
41,00101001,16,00010000,57,00111001
21,00010101,27,00011011,48,00110000
127,01111111,90,01011010,217,11011001
12,00001100,13,00001101,25,00011001
108,01101100,1,00000001,109,01101101
23,00010111,61,00111101,84,01010100
46,00101110,72,01001000,118,01110110
75,01001011,85,01010101,160,10100000
37,00100101,89,01011001,126,01111110
16,00010000,30,00011110,46,00101110
45,00101101,121,01111001,166,10100110
101,01100101,20,00010100,121,01111001
40,00101000,57,00111001,97,01100001
64,01000000,57,00111001,121,01111001
65,01000001,28,00011100,93,01011101
95,01011111,62,00111110,157,10011101
123,01111011,27,00011011,150,10010110
106,01101010,6,00000110,112,01110000
78,01001110,65,01000001,143,10001111
89,01011001,71,01000111,160,10100000
64,01000000,77,01001101,141,10001101
113,01110001,33,00100001,146,10010010
125,01111101,30,00011110,155,10011011
59,00111011,32,00100000,91,01011011
44,00101100,111,01101111,155,10011011
57,00111001,125,01111101,182,10110110
105,01101001,81,01010001,186,10111010
125,01111101,80,01010000,205,11001101
80,01010000,105,01101001,185,10111001
41,00101001,112,01110000,153,10011001
52,00110100,5,00000101,57,00111001
48,00110000,72,01001000,120,01111000
51,00110011,116,01110100,167,10100111
98,01100010,34,00100010,132,10000100
108,01101100,115,01110011,223,11011111
111,01101111,5,00000101,116,01110100
51,00110011,48,00110000,99,01100011
73,01001001,35,00100011,108,01101100
8,00001000,28,00011100,36,00100100
11,00001011,117,01110101,128,10000000
122,01111010,47,00101111,169,10101001
22,00010110,120,01111000,142,10001110
15,00001111,87,01010111,102,01100110
3,00000011,79,01001111,82,01010010
41,00101001,73,01001001,114,01110010
91,01011011,41,00101001,132,10000100
44,00101100,7,00000111,51,00110011
65,01000001,120,01111000,185,10111001
105,01101001,59,00111011,164,10100100
87,01010111,109,01101101,196,11000100
108,01101100,125,01111101,233,11101001
95,01011111,91,01011011,186,10111010
127,01111111,26,00011010,153,10011001
9,00001001,24,00011000,33,00100001
99,01100011,81,01010001,180,10110100
73,01001001,0,00000000,73,01001001
82,01010010,87,01010111,169,10101001
81,01010001,106,01101010,187,10111011
91,01011011,25,00011001,116,01110100
39,00100111,14,00001110,53,00110101
76,01001100,51,00110011,127,01111111
105,01101001,107,01101011,212,11010100
25,00011001,95,01011111,120,01111000
21,00010101,25,00011001,46,00101110
7,00000111,59,00111011,66,01000010
1,00000001,88,01011000,89,01011001
111,01101111,92,01011100,203,11001011
7,00000111,46,00101110,53,00110101
112,01110000,101,01100101,213,11010101
77,01001101,52,00110100,129,10000001
24,00011000,42,00101010,66,01000010
50,00110010,31,00011111,81,01010001
40,00101000,2,00000010,42,00101010
43,00101011,73,01001001,116,01110100
114,01110010,40,00101000,154,10011010
27,00011011,51,00110011,78,01001110
14,00001110,42,00101010,56,00111000
104,01101000,108,01101100,212,11010100
28,00011100,73,01001001,101,01100101
94,01011110,19,00010011,113,01110001
30,00011110,17,00010001,47,00101111
32,00100000,107,01101011,139,10001011
67,01000011,80,01010000,147,10010011
10,00001010,0,00000000,10,00001010
60,00111100,127,01111111,187,10111011
12,00001100,67,01000011,79,01001111
67,01000011,75,01001011,142,10001110
27,00011011,38,00100110,65,01000001
88,01011000,127,01111111,215,11010111
58,00111010,86,01010110,144,10010000
66,01000010,16,00010000,82,01010010
122,01111010,23,00010111,145,10010001
16,00010000,71,01000111,87,01010111
61,00111101,86,01010110,147,10010011
100,01100100,99,01100011,199,11000111
120,01111000,28,00011100,148,10010100
125,01111101,73,01001001,198,11000110
2,00000010,95,01011111,97,01100001
79,01001111,35,00100011,114,01110010
72,01001000,106,01101010,178,10110010
83,01010011,103,01100111,186,10111010
93,01011101,44,00101100,137,10001001
104,01101000,28,00011100,132,10000100
22,00010110,65,01000001,87,01010111
51,00110011,117,01110101,168,10101000
113,01110001,75,01001011,188,10111100
12,00001100,126,01111110,138,10001010
23,00010111,117,01110101,140,10001100
21,00010101,29,00011101,50,00110010
108,01101100,46,00101110,154,10011010
45,00101101,9,00001001,54,00110110
68,01000100,45,00101101,113,01110001
39,00100111,28,00011100,67,01000011
30,00011110,7,00000111,37,00100101
111,01101111,33,00100001,144,10010000
37,00100101,6,00000110,43,00101011
106,01101010,30,00011110,136,10001000
30,00011110,58,00111010,88,01011000
67,01000011,35,00100011,102,01100110
33,00100001,123,01111011,156,10011100
111,01101111,55,00110111,166,10100110
40,00101000,9,00001001,49,00110001
86,01010110,56,00111000,142,10001110
126,01111110,109,01101101,235,11101011
87,01010111,9,00001001,96,01100000
12,00001100,12,00001100,24,00011000
49,00110001,94,01011110,143,10001111
60,00111100,46,00101110,106,01101010
17,00010001,54,00110110,71,01000111
77,01001101,96,01100000,173,10101101
65,01000001,37,00100101,102,01100110
74,01001010,104,01101000,178,10110010
2,00000010,27,00011011,29,00011101
71,01000111,117,01110101,188,10111100
124,01111100,85,01010101,209,11010001
83,01010011,81,01010001,164,10100100
124,01111100,70,01000110,194,11000010
84,01010100,69,01000101,153,10011001
42,00101010,86,01010110,128,10000000
2,00000010,102,01100110,104,01101000
80,01010000,52,00110100,132,10000100
125,01111101,123,01111011,248,11111000
52,00110100,1,00000001,53,00110101
55,00110111,32,00100000,87,01010111
81,01010001,125,01111101,206,11001110
31,00011111,40,00101000,71,01000111
34,00100010,58,00111010,92,01011100
98,01100010,39,00100111,137,10001001
74,01001010,93,01011101,167,10100111
22,00010110,29,00011101,51,00110011
92,01011100,68,01000100,160,10100000
58,00111010,98,01100010,156,10011100
111,01101111,27,00011011,138,10001010
78,01001110,7,00000111,85,01010101
68,01000100,37,00100101,105,01101001
0,00000000,34,00100010,34,00100010
88,01011000,100,01100100,188,10111100
5,00000101,88,01011000,93,01011101
51,00110011,89,01011001,140,10001100
52,00110100,58,00111010,110,01101110
16,00010000,57,00111001,73,01001001
29,00011101,47,00101111,76,01001100
115,01110011,90,01011010,205,11001101
121,01111001,60,00111100,181,10110101
67,01000011,85,01010101,152,10011000
33,00100001,103,01100111,136,10001000
124,01111100,108,01101100,232,11101000
106,01101010,18,00010010,124,01111100
39,00100111,17,00010001,56,00111000
64,01000000,102,01100110,166,10100110
106,01101010,117,01110101,223,11011111
84,01010100,101,01100101,185,10111001
92,01011100,84,01010100,176,10110000
6,00000110,46,00101110,52,00110100
111,01101111,43,00101011,154,10011010
122,01111010,107,01101011,229,11100101
61,00111101,125,01111101,186,10111010
79,01001111,78,01001110,157,10011101
101,01100101,43,00101011,144,10010000
25,00011001,44,00101100,69,01000101
109,01101101,117,01110101,226,11100010
52,00110100,107,01101011,159,10011111
122,01111010,116,01110100,238,11101110
58,00111010,9,00001001,67,01000011
54,00110110,65,01000001,119,01110111
52,00110100,55,00110111,107,01101011
19,00010011,65,01000001,84,01010100
70,01000110,3,00000011,73,01001001
5,00000101,110,01101110,115,01110011
114,01110010,52,00110100,166,10100110
93,01011101,77,01001101,170,10101010
12,00001100,72,01001000,84,01010100
52,00110100,68,01000100,120,01111000
84,01010100,0,00000000,84,01010100
13,00001101,74,01001010,87,01010111
89,01011001,122,01111010,211,11010011
78,01001110,103,01100111,181,10110101
2,00000010,39,00100111,41,00101001
62,00111110,119,01110111,181,10110101
89,01011001,36,00100100,125,01111101
53,00110101,9,00001001,62,00111110
75,01001011,122,01111010,197,11000101
121,01111001,125,01111101,246,11110110
76,01001100,2,00000010,78,01001110
60,00111100,15,00001111,75,01001011
89,01011001,114,01110010,203,11001011
52,00110100,31,00011111,83,01010011
43,00101011,2,00000010,45,00101101
98,01100010,15,00001111,113,01110001
1,00000001,42,00101010,43,00101011
89,01011001,120,01111000,209,11010001
49,00110001,39,00100111,88,01011000
52,00110100,27,00011011,79,01001111
98,01100010,64,01000000,162,10100010
99,01100011,5,00000101,104,01101000
19,00010011,71,01000111,90,01011010
121,01111001,75,01001011,196,11000100
44,00101100,2,00000010,46,00101110
35,00100011,72,01001000,107,01101011
5,00000101,110,01101110,115,01110011
72,01001000,121,01111001,193,11000001
30,00011110,25,00011001,55,00110111
125,01111101,11,00001011,136,10001000
108,01101100,29,00011101,137,10001001
23,00010111,29,00011101,52,00110100
30,00011110,36,00100100,66,01000010
126,01111110,59,00111011,185,10111001
98,01100010,34,00100010,132,10000100
78,01001110,126,01111110,204,11001100
97,01100001,4,00000100,101,01100101
102,01100110,86,01010110,188,10111100
58,00111010,3,00000011,61,00111101
62,00111110,60,00111100,122,01111010
58,00111010,102,01100110,160,10100000
64,01000000,109,01101101,173,10101101
114,01110010,96,01100000,210,11010010
125,01111101,18,00010010,143,10001111
117,01110101,26,00011010,143,10001111
59,00111011,17,00010001,76,01001100
64,01000000,11,00001011,75,01001011
107,01101011,91,01011011,198,11000110
81,01010001,92,01011100,173,10101101
75,01001011,8,00001000,83,01010011
71,01000111,73,01001001,144,10010000
105,01101001,48,00110000,153,10011001
62,00111110,76,01001100,138,10001010
108,01101100,4,00000100,112,01110000
4,00000100,121,01111001,125,01111101
126,01111110,75,01001011,201,11001001
18,00010010,117,01110101,135,10000111
112,01110000,72,01001000,184,10111000
85,01010101,61,00111101,146,10010010
90,01011010,69,01000101,159,10011111
15,00001111,82,01010010,97,01100001
122,01111010,81,01010001,203,11001011
16,00010000,48,00110000,64,01000000
72,01001000,120,01111000,192,11000000
3,00000011,45,00101101,48,00110000
69,01000101,56,00111000,125,01111101
91,01011011,70,01000110,161,10100001
82,01010010,101,01100101,183,10110111
94,01011110,117,01110101,211,11010011
5,00000101,66,01000010,71,01000111
114,01110010,31,00011111,145,10010001
122,01111010,55,00110111,177,10110001
33,00100001,50,00110010,83,01010011
55,00110111,21,00010101,76,01001100
40,00101000,124,01111100,164,10100100
64,01000000,74,01001010,138,10001010
100,01100100,72,01001000,172,10101100
93,01011101,122,01111010,215,11010111
114,01110010,46,00101110,160,10100000
57,00111001,12,00001100,69,01000101
95,01011111,35,00100011,130,10000010
48,00110000,95,01011111,143,10001111
84,01010100,68,01000100,152,10011000
49,00110001,90,01011010,139,10001011
103,01100111,93,01011101,196,11000100
21,00010101,94,01011110,115,01110011
84,01010100,101,01100101,185,10111001
93,01011101,36,00100100,129,10000001
124,01111100,28,00011100,152,10011000
57,00111001,27,00011011,84,01010100
97,01100001,101,01100101,198,11000110
50,00110010,42,00101010,92,01011100
40,00101000,67,01000011,107,01101011
41,00101001,119,01110111,160,10100000
20,00010100,23,00010111,43,00101011
118,01110110,66,01000010,184,10111000
101,01100101,16,00010000,117,01110101
79,01001111,89,01011001,168,10101000
104,01101000,108,01101100,212,11010100
116,01110100,10,00001010,126,01111110
105,01101001,69,01000101,174,10101110
40,00101000,72,01001000,112,01110000
92,01011100,113,01110001,205,11001101
102,01100110,42,00101010,144,10010000
124,01111100,17,00010001,141,10001101
116,01110100,68,01000100,184,10111000
119,01110111,81,01010001,200,11001000
34,00100010,57,00111001,91,01011011
120,01111000,101,01100101,221,11011101
121,01111001,88,01011000,209,11010001
101,01100101,55,00110111,156,10011100
14,00001110,15,00001111,29,00011101
28,00011100,13,00001101,41,00101001
59,00111011,84,01010100,143,10001111
118,01110110,116,01110100,234,11101010
74,01001010,126,01111110,200,11001000
27,00011011,53,00110101,80,01010000
66,01000010,68,01000100,134,10000110
64,01000000,31,00011111,95,01011111
91,01011011,97,01100001,188,10111100
113,01110001,6,00000110,119,01110111
5,00000101,32,00100000,37,00100101
97,01100001,117,01110101,214,11010110
104,01101000,63,00111111,167,10100111
76,01001100,115,01110011,191,10111111
99,01100011,73,01001001,172,10101100
41,00101001,110,01101110,151,10010111
76,01001100,123,01111011,199,11000111
8,00001000,27,00011011,35,00100011
71,01000111,12,00001100,83,01010011
107,01101011,89,01011001,196,11000100
77,01001101,99,01100011,176,10110000
21,00010101,64,01000000,85,01010101
67,01000011,115,01110011,182,10110110
58,00111010,64,01000000,122,01111010
52,00110100,91,01011011,143,10001111
50,00110010,51,00110011,101,01100101
32,00100000,34,00100010,66,01000010
79,01001111,118,01110110,197,11000101
41,00101001,87,01010111,128,10000000
26,00011010,123,01111011,149,10010101
89,01011001,102,01100110,191,10111111
78,01001110,37,00100101,115,01110011
40,00101000,21,00010101,61,00111101
61,00111101,46,00101110,107,01101011
58,00111010,69,01000101,127,01111111
112,01110000,26,00011010,138,10001010
52,00110100,101,01100101,153,10011001
58,00111010,44,00101100,102,01100110
17,00010001,122,01111010,139,10001011
104,01101000,75,01001011,179,10110011
116,01110100,79,01001111,195,11000011
103,01100111,96,01100000,199,11000111
61,00111101,76,01001100,137,10001001
24,00011000,13,00001101,37,00100101
112,01110000,19,00010011,131,10000011
76,01001100,87,01010111,163,10100011
83,01010011,84,01010100,167,10100111
93,01011101,34,00100010,127,01111111
68,01000100,59,00111011,127,01111111
43,00101011,14,00001110,57,00111001
35,00100011,62,00111110,97,01100001
46,00101110,78,01001110,124,01111100
38,00100110,36,00100100,74,01001010
127,01111111,29,00011101,156,10011100
96,01100000,96,01100000,192,11000000
101,01100101,15,00001111,116,01110100
83,01010011,100,01100100,183,10110111
25,00011001,55,00110111,80,01010000
62,00111110,103,01100111,165,10100101
120,01111000,93,01011101,213,11010101
30,00011110,117,01110101,147,10010011
5,00000101,68,01000100,73,01001001
90,01011010,11,00001011,101,01100101
33,00100001,60,00111100,93,01011101
87,01010111,33,00100001,120,01111000
95,01011111,61,00111101,156,10011100
18,00010010,77,01001101,95,01011111
18,00010010,79,01001111,97,01100001
25,00011001,84,01010100,109,01101101
87,01010111,116,01110100,203,11001011
76,01001100,123,01111011,199,11000111
32,00100000,38,00100110,70,01000110
20,00010100,98,01100010,118,01110110
114,01110010,77,01001101,191,10111111
24,00011000,47,00101111,71,01000111
58,00111010,106,01101010,164,10100100
109,01101101,34,00100010,143,10001111
55,00110111,14,00001110,69,01000101
102,01100110,114,01110010,216,11011000
60,00111100,106,01101010,166,10100110
47,00101111,99,01100011,146,10010010
9,00001001,78,01001110,87,01010111
16,00010000,46,00101110,62,00111110
34,00100010,117,01110101,151,10010111
8,00001000,97,01100001,105,01101001
84,01010100,97,01100001,181,10110101
95,01011111,57,00111001,152,10011000
31,00011111,10,00001010,41,00101001
14,00001110,46,00101110,60,00111100
103,01100111,10,00001010,113,01110001
72,01001000,92,01011100,164,10100100
65,01000001,121,01111001,186,10111010
25,00011001,112,01110000,137,10001001
123,01111011,42,00101010,165,10100101
46,00101110,115,01110011,161,10100001
39,00100111,113,01110001,152,10011000
21,00010101,63,00111111,84,01010100
53,00110101,70,01000110,123,01111011
69,01000101,62,00111110,131,10000011
54,00110110,81,01010001,135,10000111
57,00111001,97,01100001,154,10011010
23,00010111,85,01010101,108,01101100
83,01010011,112,01110000,195,11000011
53,00110101,111,01101111,164,10100100
37,00100101,91,01011011,128,10000000
76,01001100,98,01100010,174,10101110
121,01111001,19,00010011,140,10001100
80,01010000,22,00010110,102,01100110
122,01111010,124,01111100,246,11110110
89,01011001,3,00000011,92,01011100
69,01000101,101,01100101,170,10101010
67,01000011,122,01111010,189,10111101
42,00101010,122,01111010,164,10100100
65,01000001,9,00001001,74,01001010
120,01111000,18,00010010,138,10001010
119,01110111,40,00101000,159,10011111
13,00001101,43,00101011,56,00111000
69,01000101,66,01000010,135,10000111
114,01110010,87,01010111,201,11001001
87,01010111,127,01111111,214,11010110
26,00011010,80,01010000,106,01101010
41,00101001,0,00000000,41,00101001
20,00010100,81,01010001,101,01100101
114,01110010,2,00000010,116,01110100
104,01101000,3,00000011,107,01101011
70,01000110,93,01011101,163,10100011
35,00100011,104,01101000,139,10001011
49,00110001,100,01100100,149,10010101
117,01110101,47,00101111,164,10100100
107,01101011,20,00010100,127,01111111
15,00001111,70,01000110,85,01010101
46,00101110,44,00101100,90,01011010
95,01011111,55,00110111,150,10010110
34,00100010,120,01111000,154,10011010
68,01000100,8,00001000,76,01001100
5,00000101,118,01110110,123,01111011
34,00100010,42,00101010,76,01001100
50,00110010,50,00110010,100,01100100
94,01011110,100,01100100,194,11000010
86,01010110,98,01100010,184,10111000
16,00010000,59,00111011,75,01001011
70,01000110,110,01101110,180,10110100
88,01011000,28,00011100,116,01110100
48,00110000,12,00001100,60,00111100
26,00011010,113,01110001,139,10001011
119,01110111,40,00101000,159,10011111
116,01110100,127,01111111,243,11110011
25,00011001,87,01010111,112,01110000
1,00000001,118,01110110,119,01110111
93,01011101,35,00100011,128,10000000
69,01000101,33,00100001,102,01100110
126,01111110,54,00110110,180,10110100
93,01011101,88,01011000,181,10110101
4,00000100,70,01000110,74,01001010
114,01110010,1,00000001,115,01110011
82,01010010,2,00000010,84,01010100
71,01000111,90,01011010,161,10100001
69,01000101,97,01100001,166,10100110
105,01101001,48,00110000,153,10011001
84,01010100,96,01100000,180,10110100
26,00011010,38,00100110,64,01000000
19,00010011,33,00100001,52,00110100
63,00111111,98,01100010,161,10100001
103,01100111,39,00100111,142,10001110
76,01001100,0,00000000,76,01001100
108,01101100,3,00000011,111,01101111
69,01000101,46,00101110,115,01110011
68,01000100,88,01011000,156,10011100
125,01111101,7,00000111,132,10000100
106,01101010,61,00111101,167,10100111
84,01010100,14,00001110,98,01100010
16,00010000,63,00111111,79,01001111
18,00010010,38,00100110,56,00111000
89,01011001,58,00111010,147,10010011
114,01110010,82,01010010,196,11000100
110,01101110,39,00100111,149,10010101
98,01100010,95,01011111,193,11000001
79,01001111,62,00111110,141,10001101
5,00000101,35,00100011,40,00101000
66,01000010,27,00011011,93,01011101
3,00000011,108,01101100,111,01101111
56,00111000,25,00011001,81,01010001
40,00101000,104,01101000,144,10010000
106,01101010,46,00101110,152,10011000
112,01110000,116,01110100,228,11100100
7,00000111,79,01001111,86,01010110
26,00011010,21,00010101,47,00101111
39,00100111,91,01011011,130,10000010
77,01001101,21,00010101,98,01100010
104,01101000,125,01111101,229,11100101
123,01111011,45,00101101,168,10101000
95,01011111,85,01010101,180,10110100
65,01000001,88,01011000,153,10011001
82,01010010,30,00011110,112,01110000
98,01100010,61,00111101,159,10011111
29,00011101,86,01010110,115,01110011
2,00000010,20,00010100,22,00010110
22,00010110,112,01110000,134,10000110
20,00010100,64,01000000,84,01010100
79,01001111,21,00010101,100,01100100
9,00001001,85,01010101,94,01011110
108,01101100,19,00010011,127,01111111
70,01000110,40,00101000,110,01101110
3,00000011,13,00001101,16,00010000
81,01010001,85,01010101,166,10100110
90,01011010,107,01101011,197,11000101
14,00001110,43,00101011,57,00111001
96,01100000,124,01111100,220,11011100
106,01101010,48,00110000,154,10011010
27,00011011,51,00110011,78,01001110
98,01100010,111,01101111,209,11010001
60,00111100,90,01011010,150,10010110
16,00010000,26,00011010,42,00101010
15,00001111,25,00011001,40,00101000
59,00111011,24,00011000,83,01010011
63,00111111,124,01111100,187,10111011
43,00101011,52,00110100,95,01011111
18,00010010,84,01010100,102,01100110
98,01100010,1,00000001,99,01100011
117,01110101,39,00100111,156,10011100
77,01001101,97,01100001,174,10101110
101,01100101,97,01100001,198,11000110
101,01100101,55,00110111,156,10011100
84,01010100,2,00000010,86,01010110
21,00010101,89,01011001,110,01101110
41,00101001,95,01011111,136,10001000
124,01111100,6,00000110,130,10000010
28,00011100,100,01100100,128,10000000
62,00111110,52,00110100,114,01110010
41,00101001,44,00101100,85,01010101
99,01100011,4,00000100,103,01100111
83,01010011,95,01011111,178,10110010
56,00111000,100,01100100,156,10011100
108,01101100,55,00110111,163,10100011
121,01111001,122,01111010,243,11110011
106,01101010,116,01110100,222,11011110
72,01001000,119,01110111,191,10111111
38,00100110,75,01001011,113,01110001
25,00011001,100,01100100,125,01111101
42,00101010,2,00000010,44,00101100
75,01001011,100,01100100,175,10101111
51,00110011,39,00100111,90,01011010
21,00010101,85,01010101,106,01101010
56,00111000,90,01011010,146,10010010
114,01110010,30,00011110,144,10010000
45,00101101,85,01010101,130,10000010
96,01100000,26,00011010,122,01111010
67,01000011,38,00100110,105,01101001
89,01011001,113,01110001,202,11001010
92,01011100,53,00110101,145,10010001
100,01100100,36,00100100,136,10001000
47,00101111,97,01100001,144,10010000
95,01011111,63,00111111,158,10011110
95,01011111,24,00011000,119,01110111
113,01110001,21,00010101,134,10000110
82,01010010,94,01011110,176,10110000
127,01111111,65,01000001,192,11000000
105,01101001,74,01001010,179,10110011
58,00111010,19,00010011,77,01001101
90,01011010,104,01101000,194,11000010
39,00100111,65,01000001,104,01101000
4,00000100,0,00000000,4,00000100
119,01110111,39,00100111,158,10011110
81,01010001,99,01100011,180,10110100
56,00111000,91,01011011,147,10010011
113,01110001,63,00111111,176,10110000
102,01100110,93,01011101,195,11000011
29,00011101,40,00101000,69,01000101
104,01101000,122,01111010,226,11100010
109,01101101,15,00001111,124,01111100
100,01100100,91,01011011,191,10111111
11,00001011,126,01111110,137,10001001
18,00010010,73,01001001,91,01011011
52,00110100,106,01101010,158,10011110
113,01110001,19,00010011,132,10000100
0,00000000,38,00100110,38,00100110
109,01101101,15,00001111,124,01111100
89,01011001,8,00001000,97,01100001
95,01011111,122,01111010,217,11011001
60,00111100,103,01100111,163,10100011
48,00110000,53,00110101,101,01100101
74,01001010,79,01001111,153,10011001
96,01100000,115,01110011,211,11010011
10,00001010,35,00100011,45,00101101
13,00001101,40,00101000,53,00110101
112,01110000,80,01010000,192,11000000
70,01000110,73,01001001,143,10001111
116,01110100,52,00110100,168,10101000
28,00011100,100,01100100,128,10000000
100,01100100,100,01100100,200,11001000
70,01000110,1,00000001,71,01000111
69,01000101,27,00011011,96,01100000
95,01011111,66,01000010,161,10100001
33,00100001,51,00110011,84,01010100
12,00001100,34,00100010,46,00101110
66,01000010,66,01000010,132,10000100
33,00100001,43,00101011,76,01001100
8,00001000,78,01001110,86,01010110
106,01101010,54,00110110,160,10100000
0,00000000,43,00101011,43,00101011
51,00110011,99,01100011,150,10010110
65,01000001,44,00101100,109,01101101
18,00010010,38,00100110,56,00111000
45,00101101,81,01010001,126,01111110
16,00010000,28,00011100,44,00101100
77,01001101,62,00111110,139,10001011
125,01111101,17,00010001,142,10001110
77,01001101,16,00010000,93,01011101
92,01011100,42,00101010,134,10000110
47,00101111,51,00110011,98,01100010
113,01110001,42,00101010,155,10011011
118,01110110,47,00101111,165,10100101
30,00011110,31,00011111,61,00111101
11,00001011,25,00011001,36,00100100
13,00001101,49,00110001,62,00111110
1,00000001,116,01110100,117,01110101
35,00100011,18,00010010,53,00110101
90,01011010,117,01110101,207,11001111
111,01101111,83,01010011,194,11000010
114,01110010,99,01100011,213,11010101
10,00001010,36,00100100,46,00101110
111,01101111,47,00101111,158,10011110
13,00001101,28,00011100,41,00101001
22,00010110,26,00011010,48,00110000
101,01100101,124,01111100,225,11100001
61,00111101,96,01100000,157,10011101
125,01111101,76,01001100,201,11001001
8,00001000,52,00110100,60,00111100
3,00000011,111,01101111,114,01110010
12,00001100,11,00001011,23,00010111
19,00010011,119,01110111,138,10001010
26,00011010,41,00101001,67,01000011
98,01100010,43,00101011,141,10001101
70,01000110,53,00110101,123,01111011
73,01001001,35,00100011,108,01101100
33,00100001,68,01000100,101,01100101
115,01110011,104,01101000,219,11011011
71,01000111,32,00100000,103,01100111
117,01110101,96,01100000,213,11010101
83,01010011,50,00110010,133,10000101
31,00011111,114,01110010,145,10010001
44,00101100,58,00111010,102,01100110
105,01101001,77,01001101,182,10110110
75,01001011,52,00110100,127,01111111
54,00110110,32,00100000,86,01010110
84,01010100,6,00000110,90,01011010
37,00100101,15,00001111,52,00110100
51,00110011,55,00110111,106,01101010
58,00111010,76,01001100,134,10000110
127,01111111,125,01111101,252,11111100
12,00001100,58,00111010,70,01000110
100,01100100,118,01110110,218,11011010
106,01101010,62,00111110,168,10101000
126,01111110,80,01010000,206,11001110
62,00111110,32,00100000,94,01011110
79,01001111,92,01011100,171,10101011
9,00001001,64,01000000,73,01001001
127,01111111,3,00000011,130,10000010
110,01101110,31,00011111,141,10001101
53,00110101,122,01111010,175,10101111
44,00101100,99,01100011,143,10001111
58,00111010,61,00111101,119,01110111
114,01110010,64,01000000,178,10110010
15,00001111,36,00100100,51,00110011
44,00101100,63,00111111,107,01101011
61,00111101,77,01001101,138,10001010
102,01100110,66,01000010,168,10101000
66,01000010,26,00011010,92,01011100
1,00000001,52,00110100,53,00110101
114,01110010,116,01110100,230,11100110
47,00101111,53,00110101,100,01100100
69,01000101,71,01000111,140,10001100
120,01111000,58,00111010,178,10110010
73,01001001,55,00110111,128,10000000
107,01101011,102,01100110,209,11010001
110,01101110,91,01011011,201,11001001
41,00101001,124,01111100,165,10100101
67,01000011,101,01100101,168,10101000
57,00111001,85,01010101,142,10001110
97,01100001,72,01001000,169,10101001
12,00001100,100,01100100,112,01110000
33,00100001,73,01001001,106,01101010
48,00110000,63,00111111,111,01101111
80,01010000,89,01011001,169,10101001
106,01101010,12,00001100,118,01110110
83,01010011,2,00000010,85,01010101
44,00101100,105,01101001,149,10010101
105,01101001,113,01110001,218,11011010
27,00011011,74,01001010,101,01100101
110,01101110,11,00001011,121,01111001
79,01001111,101,01100101,180,10110100
108,01101100,21,00010101,129,10000001
107,01101011,56,00111000,163,10100011
107,01101011,95,01011111,202,11001010
65,01000001,106,01101010,171,10101011
47,00101111,83,01010011,130,10000010
88,01011000,90,01011010,178,10110010
14,00001110,95,01011111,109,01101101
27,00011011,7,00000111,34,00100010
73,01001001,23,00010111,96,01100000
82,01010010,78,01001110,160,10100000
98,01100010,54,00110110,152,10011000
14,00001110,63,00111111,77,01001101
9,00001001,8,00001000,17,00010001
26,00011010,99,01100011,125,01111101
62,00111110,94,01011110,156,10011100
112,01110000,12,00001100,124,01111100
98,01100010,59,00111011,157,10011101
22,00010110,80,01010000,102,01100110
119,01110111,60,00111100,179,10110011
33,00100001,17,00010001,50,00110010
73,01001001,23,00010111,96,01100000
52,00110100,56,00111000,108,01101100
96,01100000,60,00111100,156,10011100
103,01100111,107,01101011,210,11010010
90,01011010,91,01011011,181,10110101
121,01111001,22,00010110,143,10001111
32,00100000,89,01011001,121,01111001
121,01111001,70,01000110,191,10111111
106,01101010,57,00111001,163,10100011
90,01011010,100,01100100,190,10111110
66,01000010,107,01101011,173,10101101
97,01100001,87,01010111,184,10111000
117,01110101,103,01100111,220,11011100
80,01010000,85,01010101,165,10100101
124,01111100,74,01001010,198,11000110
57,00111001,25,00011001,82,01010010
18,00010010,83,01010011,101,01100101
99,01100011,106,01101010,205,11001101
103,01100111,11,00001011,114,01110010
18,00010010,13,00001101,31,00011111
120,01111000,46,00101110,166,10100110
92,01011100,70,01000110,162,10100010
84,01010100,126,01111110,210,11010010
72,01001000,84,01010100,156,10011100
99,01100011,11,00001011,110,01101110
99,01100011,42,00101010,141,10001101
7,00000111,112,01110000,119,01110111
78,01001110,80,01010000,158,10011110
108,01101100,17,00010001,125,01111101
57,00111001,107,01101011,164,10100100
69,01000101,30,00011110,99,01100011
40,00101000,49,00110001,89,01011001
93,01011101,26,00011010,119,01110111
102,01100110,17,00010001,119,01110111
25,00011001,32,00100000,57,00111001
20,00010100,112,01110000,132,10000100
28,00011100,57,00111001,85,01010101
101,01100101,59,00111011,160,10100000
103,01100111,65,01000001,168,10101000
27,00011011,26,00011010,53,00110101
0,00000000,64,01000000,64,01000000
5,00000101,109,01101101,114,01110010
3,00000011,27,00011011,30,00011110
74,01001010,115,01110011,189,10111101
16,00010000,40,00101000,56,00111000
79,01001111,31,00011111,110,01101110
39,00100111,61,00111101,100,01100100
3,00000011,102,01100110,105,01101001
123,01111011,92,01011100,215,11010111
67,01000011,70,01000110,137,10001001
46,00101110,79,01001111,125,01111101
88,01011000,17,00010001,105,01101001
123,01111011,119,01110111,242,11110010
8,00001000,4,00000100,12,00001100
70,01000110,62,00111110,132,10000100
103,01100111,49,00110001,152,10011000
71,01000111,85,01010101,156,10011100
76,01001100,48,00110000,124,01111100
88,01011000,48,00110000,136,10001000
116,01110100,117,01110101,233,11101001
96,01100000,27,00011011,123,01111011
58,00111010,41,00101001,99,01100011
14,00001110,106,01101010,120,01111000
94,01011110,100,01100100,194,11000010
56,00111000,58,00111010,114,01110010
123,01111011,76,01001100,199,11000111
102,01100110,109,01101101,211,11010011
52,00110100,107,01101011,159,10011111
113,01110001,4,00000100,117,01110101
11,00001011,88,01011000,99,01100011
40,00101000,44,00101100,84,01010100
29,00011101,58,00111010,87,01010111
20,00010100,97,01100001,117,01110101
84,01010100,127,01111111,211,11010011
28,00011100,73,01001001,101,01100101
58,00111010,48,00110000,106,01101010
56,00111000,35,00100011,91,01011011
61,00111101,37,00100101,98,01100010
54,00110110,56,00111000,110,01101110
41,00101001,110,01101110,151,10010111
14,00001110,32,00100000,46,00101110
0,00000000,95,01011111,95,01011111
9,00001001,123,01111011,132,10000100
56,00111000,83,01010011,139,10001011
32,00100000,44,00101100,76,01001100
125,01111101,87,01010111,212,11010100
77,01001101,73,01001001,150,10010110
118,01110110,106,01101010,224,11100000
0,00000000,43,00101011,43,00101011
99,01100011,117,01110101,216,11011000
88,01011000,78,01001110,166,10100110
80,01010000,47,00101111,127,01111111
111,01101111,2,00000010,113,01110001
82,01010010,2,00000010,84,01010100
102,01100110,70,01000110,172,10101100
121,01111001,106,01101010,227,11100011
22,00010110,34,00100010,56,00111000
39,00100111,101,01100101,140,10001100
44,00101100,35,00100011,79,01001111
11,00001011,120,01111000,131,10000011
37,00100101,72,01001000,109,01101101
43,00101011,102,01100110,145,10010001
126,01111110,89,01011001,215,11010111
30,00011110,122,01111010,152,10011000
0,00000000,96,01100000,96,01100000
77,01001101,20,00010100,97,01100001
100,01100100,39,00100111,139,10001011
117,01110101,49,00110001,166,10100110
99,01100011,20,00010100,119,01110111
48,00110000,23,00010111,71,01000111
63,00111111,33,00100001,96,01100000
6,00000110,90,01011010,96,01100000
106,01101010,123,01111011,229,11100101
19,00010011,36,00100100,55,00110111
69,01000101,32,00100000,101,01100101
30,00011110,79,01001111,109,01101101
114,01110010,40,00101000,154,10011010
60,00111100,42,00101010,102,01100110
84,01010100,69,01000101,153,10011001
16,00010000,34,00100010,50,00110010
24,00011000,12,00001100,36,00100100
34,00100010,3,00000011,37,00100101
125,01111101,62,00111110,187,10111011
105,01101001,35,00100011,140,10001100
21,00010101,74,01001010,95,01011111
20,00010100,33,00100001,53,00110101
98,01100010,36,00100100,134,10000110
28,00011100,13,00001101,41,00101001
110,01101110,126,01111110,236,11101100
24,00011000,68,01000100,92,01011100
24,00011000,112,01110000,136,10001000
121,01111001,117,01110101,238,11101110
75,01001011,76,01001100,151,10010111
40,00101000,78,01001110,118,01110110
105,01101001,70,01000110,175,10101111
54,00110110,62,00111110,116,01110100
66,01000010,30,00011110,96,01100000
52,00110100,82,01010010,134,10000110
52,00110100,106,01101010,158,10011110
6,00000110,116,01110100,122,01111010
51,00110011,12,00001100,63,00111111
18,00010010,51,00110011,69,01000101
86,01010110,87,01010111,173,10101101
30,00011110,76,01001100,106,01101010
114,01110010,19,00010011,133,10000101
23,00010111,103,01100111,126,01111110
12,00001100,100,01100100,112,01110000
9,00001001,6,00000110,15,00001111
86,01010110,39,00100111,125,01111101
4,00000100,98,01100010,102,01100110
5,00000101,56,00111000,61,00111101
59,00111011,55,00110111,114,01110010
6,00000110,109,01101101,115,01110011
49,00110001,69,01000101,118,01110110
4,00000100,123,01111011,127,01111111
104,01101000,75,01001011,179,10110011
112,01110000,35,00100011,147,10010011
37,00100101,112,01110000,149,10010101
75,01001011,122,01111010,197,11000101
55,00110111,15,00001111,70,01000110
71,01000111,48,00110000,119,01110111
123,01111011,85,01010101,208,11010000
13,00001101,21,00010101,34,00100010
98,01100010,72,01001000,170,10101010
78,01001110,126,01111110,204,11001100
91,01011011,101,01100101,192,11000000
114,01110010,60,00111100,174,10101110
65,01000001,18,00010010,83,01010011
113,01110001,34,00100010,147,10010011
60,00111100,114,01110010,174,10101110
122,01111010,14,00001110,136,10001000
20,00010100,77,01001101,97,01100001
108,01101100,117,01110101,225,11100001
122,01111010,73,01001001,195,11000011
126,01111110,56,00111000,182,10110110
108,01101100,36,00100100,144,10010000
61,00111101,11,00001011,72,01001000
29,00011101,21,00010101,50,00110010
73,01001001,108,01101100,181,10110101
29,00011101,61,00111101,90,01011010
47,00101111,91,01011011,138,10001010
63,00111111,61,00111101,124,01111100
64,01000000,52,00110100,116,01110100
63,00111111,65,01000001,128,10000000
102,01100110,92,01011100,194,11000010
77,01001101,82,01010010,159,10011111
73,01001001,18,00010010,91,01011011
48,00110000,95,01011111,143,10001111
98,01100010,126,01111110,224,11100000
114,01110010,31,00011111,145,10010001
58,00111010,102,01100110,160,10100000
117,01110101,78,01001110,195,11000011
41,00101001,48,00110000,89,01011001
11,00001011,37,00100101,48,00110000
23,00010111,59,00111011,82,01010010
47,00101111,23,00010111,70,01000110
18,00010010,3,00000011,21,00010101
47,00101111,12,00001100,59,00111011
5,00000101,8,00001000,13,00001101
121,01111001,126,01111110,247,11110111
110,01101110,50,00110010,160,10100000
6,00000110,20,00010100,26,00011010
43,00101011,53,00110101,96,01100000
46,00101110,96,01100000,142,10001110
43,00101011,40,00101000,83,01010011
122,01111010,109,01101101,231,11100111
20,00010100,120,01111000,140,10001100
53,00110101,4,00000100,57,00111001
1,00000001,68,01000100,69,01000101
78,01001110,48,00110000,126,01111110
16,00010000,81,01010001,97,01100001
16,00010000,13,00001101,29,00011101
120,01111000,98,01100010,218,11011010
112,01110000,10,00001010,122,01111010
93,01011101,33,00100001,126,01111110
30,00011110,39,00100111,69,01000101
14,00001110,13,00001101,27,00011011
9,00001001,38,00100110,47,00101111
89,01011001,3,00000011,92,01011100
41,00101001,51,00110011,92,01011100
48,00110000,116,01110100,164,10100100
68,01000100,40,00101000,108,01101100
68,01000100,115,01110011,183,10110111
41,00101001,42,00101010,83,01010011
60,00111100,70,01000110,130,10000010
59,00111011,60,00111100,119,01110111
64,01000000,19,00010011,83,01010011
33,00100001,8,00001000,41,00101001
57,00111001,63,00111111,120,01111000
71,01000111,105,01101001,176,10110000
15,00001111,38,00100110,53,00110101
12,00001100,78,01001110,90,01011010
60,00111100,111,01101111,171,10101011
3,00000011,90,01011010,93,01011101
12,00001100,81,01010001,93,01011101
34,00100010,92,01011100,126,01111110
69,01000101,66,01000010,135,10000111
88,01011000,65,01000001,153,10011001
110,01101110,15,00001111,125,01111101
29,00011101,97,01100001,126,01111110
47,00101111,73,01001001,120,01111000
62,00111110,48,00110000,110,01101110
42,00101010,54,00110110,96,01100000
55,00110111,3,00000011,58,00111010
111,01101111,37,00100101,148,10010100
76,01001100,88,01011000,164,10100100
117,01110101,47,00101111,164,10100100
52,00110100,46,00101110,98,01100010
102,01100110,42,00101010,144,10010000
31,00011111,10,00001010,41,00101001
35,00100011,65,01000001,100,01100100
117,01110101,34,00100010,151,10010111
66,01000010,119,01110111,185,10111001
84,01010100,1,00000001,85,01010101
81,01010001,109,01101101,190,10111110
100,01100100,1,00000001,101,01100101
84,01010100,115,01110011,199,11000111
37,00100101,31,00011111,68,01000100
11,00001011,99,01100011,110,01101110
116,01110100,82,01010010,198,11000110
79,01001111,88,01011000,167,10100111
111,01101111,42,00101010,153,10011001
90,01011010,82,01010010,172,10101100
93,01011101,16,00010000,109,01101101
89,01011001,34,00100010,123,01111011
81,01010001,59,00111011,140,10001100
53,00110101,66,01000010,119,01110111
69,01000101,28,00011100,97,01100001
121,01111001,45,00101101,166,10100110
101,01100101,43,00101011,144,10010000
126,01111110,46,00101110,172,10101100
11,00001011,57,00111001,68,01000100
12,00001100,20,00010100,32,00100000
72,01001000,73,01001001,145,10010001
82,01010010,127,01111111,209,11010001
31,00011111,122,01111010,153,10011001
36,00100100,30,00011110,66,01000010
51,00110011,61,00111101,112,01110000
113,01110001,122,01111010,235,11101011
117,01110101,72,01001000,189,10111101
25,00011001,110,01101110,135,10000111
88,01011000,109,01101101,197,11000101
94,01011110,66,01000010,160,10100000
23,00010111,126,01111110,149,10010101
68,01000100,35,00100011,103,01100111
9,00001001,91,01011011,100,01100100
32,00100000,5,00000101,37,00100101
17,00010001,33,00100001,50,00110010
42,00101010,30,00011110,72,01001000
109,01101101,108,01101100,217,11011001
24,00011000,102,01100110,126,01111110
19,00010011,126,01111110,145,10010001
31,00011111,114,01110010,145,10010001
22,00010110,18,00010010,40,00101000
42,00101010,82,01010010,124,01111100
111,01101111,56,00111000,167,10100111
8,00001000,54,00110110,62,00111110
120,01111000,27,00011011,147,10010011
3,00000011,84,01010100,87,01010111
22,00010110,122,01111010,144,10010000
95,01011111,94,01011110,189,10111101
122,01111010,110,01101110,232,11101000
108,01101100,36,00100100,144,10010000
65,01000001,113,01110001,178,10110010
72,01001000,100,01100100,172,10101100
62,00111110,59,00111011,121,01111001
106,01101010,71,01000111,177,10110001
45,00101101,25,00011001,70,01000110
56,00111000,123,01111011,179,10110011
69,01000101,111,01101111,180,10110100
15,00001111,17,00010001,32,00100000
90,01011010,78,01001110,168,10101000
28,00011100,118,01110110,146,10010010
124,01111100,54,00110110,178,10110010
64,01000000,49,00110001,113,01110001
101,01100101,10,00001010,111,01101111
27,00011011,30,00011110,57,00111001
89,01011001,41,00101001,130,10000010
20,00010100,107,01101011,127,01111111
69,01000101,91,01011011,160,10100000
68,01000100,50,00110010,118,01110110
67,01000011,91,01011011,158,10011110
112,01110000,23,00010111,135,10000111
16,00010000,112,01110000,128,10000000
85,01010101,63,00111111,148,10010100
80,01010000,93,01011101,173,10101101
102,01100110,46,00101110,148,10010100
117,01110101,91,01011011,208,11010000
74,01001010,43,00101011,117,01110101
67,01000011,115,01110011,182,10110110
16,00010000,43,00101011,59,00111011
44,00101100,86,01010110,130,10000010
13,00001101,30,00011110,43,00101011
72,01001000,96,01100000,168,10101000
61,00111101,107,01101011,168,10101000
67,01000011,39,00100111,106,01101010
81,01010001,5,00000101,86,01010110
39,00100111,100,01100100,139,10001011
40,00101000,63,00111111,103,01100111
102,01100110,38,00100110,140,10001100
97,01100001,65,01000001,162,10100010
10,00001010,87,01010111,97,01100001
72,01001000,63,00111111,135,10000111
120,01111000,106,01101010,226,11100010
93,01011101,55,00110111,148,10010100
116,01110100,76,01001100,192,11000000
68,01000100,0,00000000,68,01000100
72,01001000,42,00101010,114,01110010
18,00010010,43,00101011,61,00111101
86,01010110,26,00011010,112,01110000
14,00001110,20,00010100,34,00100010
5,00000101,65,01000001,70,01000110
19,00010011,110,01101110,129,10000001
4,00000100,4,00000100,8,00001000
57,00111001,126,01111110,183,10110111
124,01111100,36,00100100,160,10100000
39,00100111,103,01100111,142,10001110
56,00111000,78,01001110,134,10000110
122,01111010,124,01111100,246,11110110
98,01100010,84,01010100,182,10110110
29,00011101,4,00000100,33,00100001
70,01000110,21,00010101,91,01011011
56,00111000,67,01000011,123,01111011
123,01111011,76,01001100,199,11000111
121,01111001,61,00111101,182,10110110
13,00001101,31,00011111,44,00101100
57,00111001,25,00011001,82,01010010
16,00010000,45,00101101,61,00111101
101,01100101,33,00100001,134,10000110
23,00010111,117,01110101,140,10001100
69,01000101,64,01000000,133,10000101
81,01010001,44,00101100,125,01111101
120,01111000,20,00010100,140,10001100
99,01100011,89,01011001,188,10111100
78,01001110,91,01011011,169,10101001
21,00010101,112,01110000,133,10000101
10,00001010,70,01000110,80,01010000
105,01101001,12,00001100,117,01110101
45,00101101,113,01110001,158,10011110
40,00101000,60,00111100,100,01100100
34,00100010,1,00000001,35,00100011
48,00110000,34,00100010,82,01010010
63,00111111,69,01000101,132,10000100
78,01001110,14,00001110,92,01011100
74,01001010,40,00101000,114,01110010
70,01000110,32,00100000,102,01100110
5,00000101,13,00001101,18,00010010
119,01110111,13,00001101,132,10000100
45,00101101,116,01110100,161,10100001
32,00100000,27,00011011,59,00111011
38,00100110,106,01101010,144,10010000
25,00011001,26,00011010,51,00110011
34,00100010,127,01111111,161,10100001
1,00000001,116,01110100,117,01110101
65,01000001,48,00110000,113,01110001
79,01001111,9,00001001,88,01011000
72,01001000,38,00100110,110,01101110
2,00000010,108,01101100,110,01101110
41,00101001,53,00110101,94,01011110
87,01010111,115,01110011,202,11001010
86,01010110,8,00001000,94,01011110
127,01111111,10,00001010,137,10001001
61,00111101,23,00010111,84,01010100
75,01001011,26,00011010,101,01100101
97,01100001,124,01111100,221,11011101
8,00001000,115,01110011,123,01111011
72,01001000,108,01101100,180,10110100
54,00110110,63,00111111,117,01110101
45,00101101,3,00000011,48,00110000
21,00010101,26,00011010,47,00101111
42,00101010,114,01110010,156,10011100
63,00111111,43,00101011,106,01101010
91,01011011,83,01010011,174,10101110
56,00111000,15,00001111,71,01000111
30,00011110,85,01010101,115,01110011
125,01111101,118,01110110,243,11110011
12,00001100,126,01111110,138,10001010
35,00100011,41,00101001,76,01001100
63,00111111,97,01100001,160,10100000
89,01011001,91,01011011,180,10110100
61,00111101,125,01111101,186,10111010
25,00011001,28,00011100,53,00110101
15,00001111,43,00101011,58,00111010
31,00011111,49,00110001,80,01010000
29,00011101,59,00111011,88,01011000
92,01011100,50,00110010,142,10001110
77,01001101,112,01110000,189,10111101
55,00110111,79,01001111,134,10000110
31,00011111,24,00011000,55,00110111
36,00100100,119,01110111,155,10011011
40,00101000,80,01010000,120,01111000
114,01110010,70,01000110,184,10111000
61,00111101,17,00010001,78,01001110
108,01101100,80,01010000,188,10111100
39,00100111,120,01111000,159,10011111
31,00011111,15,00001111,46,00101110
62,00111110,69,01000101,131,10000011
65,01000001,38,00100110,103,01100111
52,00110100,66,01000010,118,01110110
79,01001111,90,01011010,169,10101001
28,00011100,109,01101101,137,10001001
101,01100101,13,00001101,114,01110010
59,00111011,72,01001000,131,10000011
92,01011100,63,00111111,155,10011011
63,00111111,25,00011001,88,01011000
72,01001000,110,01101110,182,10110110
99,01100011,95,01011111,194,11000010
111,01101111,74,01001010,185,10111001
55,00110111,116,01110100,171,10101011
48,00110000,120,01111000,168,10101000
8,00001000,32,00100000,40,00101000
31,00011111,7,00000111,38,00100110
123,01111011,79,01001111,202,11001010
64,01000000,35,00100011,99,01100011
26,00011010,91,01011011,117,01110101
121,01111001,110,01101110,231,11100111
107,01101011,119,01110111,226,11100010
53,00110101,11,00001011,64,01000000
3,00000011,82,01010010,85,01010101
101,01100101,53,00110101,154,10011010
1,00000001,83,01010011,84,01010100
50,00110010,110,01101110,160,10100000
89,01011001,7,00000111,96,01100000
110,01101110,74,01001010,184,10111000
64,01000000,1,00000001,65,01000001
18,00010010,29,00011101,47,00101111
34,00100010,105,01101001,139,10001011
98,01100010,13,00001101,111,01101111
25,00011001,69,01000101,94,01011110
100,01100100,58,00111010,158,10011110
109,01101101,22,00010110,131,10000011
46,00101110,36,00100100,82,01010010
27,00011011,41,00101001,68,01000100
91,01011011,103,01100111,194,11000010
89,01011001,97,01100001,186,10111010
53,00110101,86,01010110,139,10001011
30,00011110,44,00101100,74,01001010
116,01110100,14,00001110,130,10000010
105,01101001,1,00000001,106,01101010
4,00000100,110,01101110,114,01110010
22,00010110,66,01000010,88,01011000
79,01001111,60,00111100,139,10001011
86,01010110,26,00011010,112,01110000
127,01111111,108,01101100,235,11101011
2,00000010,104,01101000,106,01101010
63,00111111,18,00010010,81,01010001
92,01011100,43,00101011,135,10000111
109,01101101,83,01010011,192,11000000
63,00111111,118,01110110,181,10110101
115,01110011,107,01101011,222,11011110
53,00110101,94,01011110,147,10010011
95,01011111,101,01100101,196,11000100
113,01110001,72,01001000,185,10111001
116,01110100,9,00001001,125,01111101
106,01101010,98,01100010,204,11001100
43,00101011,46,00101110,89,01011001
29,00011101,120,01111000,149,10010101
83,01010011,1,00000001,84,01010100
115,01110011,9,00001001,124,01111100
24,00011000,62,00111110,86,01010110
94,01011110,65,01000001,159,10011111
48,00110000,46,00101110,94,01011110
105,01101001,100,01100100,205,11001101
22,00010110,127,01111111,149,10010101
12,00001100,62,00111110,74,01001010
51,00110011,111,01101111,162,10100010
102,01100110,67,01000011,169,10101001
40,00101000,107,01101011,147,10010011
56,00111000,109,01101101,165,10100101
50,00110010,57,00111001,107,01101011
70,01000110,0,00000000,70,01000110
59,00111011,30,00011110,89,01011001
91,01011011,113,01110001,204,11001100
73,01001001,35,00100011,108,01101100
29,00011101,30,00011110,59,00111011
99,01100011,117,01110101,216,11011000
112,01110000,47,00101111,159,10011111
30,00011110,21,00010101,51,00110011
20,00010100,82,01010010,102,01100110
93,01011101,6,00000110,99,01100011
85,01010101,66,01000010,151,10010111
22,00010110,47,00101111,69,01000101
47,00101111,118,01110110,165,10100101
25,00011001,112,01110000,137,10001001
93,01011101,27,00011011,120,01111000
97,01100001,11,00001011,108,01101100
95,01011111,77,01001101,172,10101100
26,00011010,118,01110110,144,10010000
68,01000100,88,01011000,156,10011100
52,00110100,59,00111011,111,01101111
64,01000000,47,00101111,111,01101111
93,01011101,105,01101001,198,11000110
32,00100000,68,01000100,100,01100100
113,01110001,64,01000000,177,10110001
54,00110110,104,01101000,158,10011110
90,01011010,23,00010111,113,01110001
65,01000001,110,01101110,175,10101111
28,00011100,73,01001001,101,01100101
55,00110111,63,00111111,118,01110110
123,01111011,70,01000110,193,11000001
33,00100001,125,01111101,158,10011110
34,00100010,106,01101010,140,10001100
34,00100010,80,01010000,114,01110010
72,01001000,75,01001011,147,10010011
0,00000000,29,00011101,29,00011101
115,01110011,47,00101111,162,10100010
46,00101110,99,01100011,145,10010001
48,00110000,18,00010010,66,01000010
97,01100001,24,00011000,121,01111001
85,01010101,104,01101000,189,10111101
117,01110101,117,01110101,234,11101010
78,01001110,17,00010001,95,01011111
2,00000010,105,01101001,107,01101011
41,00101001,117,01110101,158,10011110
35,00100011,65,01000001,100,01100100
70,01000110,106,01101010,176,10110000
61,00111101,35,00100011,96,01100000
95,01011111,115,01110011,210,11010010
52,00110100,60,00111100,112,01110000
13,00001101,54,00110110,67,01000011
109,01101101,60,00111100,169,10101001
6,00000110,81,01010001,87,01010111
47,00101111,105,01101001,152,10011000
82,01010010,117,01110101,199,11000111
64,01000000,92,01011100,156,10011100
19,00010011,102,01100110,121,01111001
60,00111100,32,00100000,92,01011100
16,00010000,41,00101001,57,00111001
57,00111001,39,00100111,96,01100000
28,00011100,73,01001001,101,01100101
11,00001011,59,00111011,70,01000110
75,01001011,79,01001111,154,10011010
121,01111001,7,00000111,128,10000000
39,00100111,37,00100101,76,01001100
7,00000111,64,01000000,71,01000111
8,00001000,120,01111000,128,10000000
0,00000000,48,00110000,48,00110000
41,00101001,34,00100010,75,01001011
124,01111100,37,00100101,161,10100001
96,01100000,13,00001101,109,01101101
5,00000101,78,01001110,83,01010011
61,00111101,98,01100010,159,10011111
29,00011101,57,00111001,86,01010110
2,00000010,106,01101010,108,01101100
38,00100110,93,01011101,131,10000011
3,00000011,1,00000001,4,00000100
30,00011110,25,00011001,55,00110111
60,00111100,99,01100011,159,10011111
87,01010111,126,01111110,213,11010101
14,00001110,106,01101010,120,01111000
90,01011010,35,00100011,125,01111101
126,01111110,107,01101011,233,11101001
11,00001011,31,00011111,42,00101010
59,00111011,84,01010100,143,10001111
106,01101010,50,00110010,156,10011100
70,01000110,77,01001101,147,10010011
76,01001100,75,01001011,151,10010111
54,00110110,8,00001000,62,00111110
1,00000001,47,00101111,48,00110000
47,00101111,100,01100100,147,10010011
65,01000001,90,01011010,155,10011011
55,00110111,105,01101001,160,10100000
19,00010011,71,01000111,90,01011010
102,01100110,36,00100100,138,10001010
114,01110010,71,01000111,185,10111001
29,00011101,83,01010011,112,01110000
39,00100111,51,00110011,90,01011010
43,00101011,30,00011110,73,01001001
85,01010101,26,00011010,111,01101111
23,00010111,6,00000110,29,00011101
8,00001000,102,01100110,110,01101110
113,01110001,54,00110110,167,10100111
60,00111100,89,01011001,149,10010101
78,01001110,91,01011011,169,10101001
65,01000001,7,00000111,72,01001000
112,01110000,102,01100110,214,11010110
87,01010111,30,00011110,117,01110101
13,00001101,112,01110000,125,01111101
109,01101101,7,00000111,116,01110100
21,00010101,114,01110010,135,10000111
105,01101001,50,00110010,155,10011011
84,01010100,13,00001101,97,01100001
3,00000011,108,01101100,111,01101111
102,01100110,77,01001101,179,10110011
61,00111101,84,01010100,145,10010001
115,01110011,21,00010101,136,10001000
42,00101010,47,00101111,89,01011001
86,01010110,71,01000111,157,10011101
35,00100011,26,00011010,61,00111101
88,01011000,125,01111101,213,11010101
73,01001001,123,01111011,196,11000100
78,01001110,116,01110100,194,11000010
13,00001101,76,01001100,89,01011001
29,00011101,64,01000000,93,01011101
102,01100110,53,00110101,155,10011011
44,00101100,79,01001111,123,01111011
122,01111010,72,01001000,194,11000010
102,01100110,16,00010000,118,01110110
33,00100001,3,00000011,36,00100100
54,00110110,12,00001100,66,01000010
14,00001110,35,00100011,49,00110001
11,00001011,60,00111100,71,01000111
100,01100100,111,01101111,211,11010011
1,00000001,65,01000001,66,01000010
63,00111111,29,00011101,92,01011100
64,01000000,48,00110000,112,01110000
20,00010100,114,01110010,134,10000110
39,00100111,34,00100010,73,01001001
58,00111010,61,00111101,119,01110111
108,01101100,71,01000111,179,10110011
98,01100010,34,00100010,132,10000100
33,00100001,45,00101101,78,01001110
45,00101101,10,00001010,55,00110111
94,01011110,31,00011111,125,01111101
7,00000111,118,01110110,125,01111101
62,00111110,2,00000010,64,01000000
55,00110111,34,00100010,89,01011001
98,01100010,97,01100001,195,11000011
59,00111011,36,00100100,95,01011111
9,00001001,14,00001110,23,00010111
81,01010001,71,01000111,152,10011000
61,00111101,116,01110100,177,10110001
54,00110110,36,00100100,90,01011010
4,00000100,44,00101100,48,00110000
10,00001010,35,00100011,45,00101101
36,00100100,59,00111011,95,01011111
68,01000100,67,01000011,135,10000111
106,01101010,47,00101111,153,10011001
112,01110000,99,01100011,211,11010011
85,01010101,41,00101001,126,01111110
100,01100100,41,00101001,141,10001101
0,00000000,101,01100101,101,01100101
36,00100100,67,01000011,103,01100111
105,01101001,95,01011111,200,11001000
45,00101101,37,00100101,82,01010010
126,01111110,81,01010001,207,11001111
39,00100111,117,01110101,156,10011100
89,01011001,60,00111100,149,10010101
36,00100100,44,00101100,80,01010000
125,01111101,31,00011111,156,10011100
93,01011101,1,00000001,94,01011110
58,00111010,114,01110010,172,10101100
14,00001110,47,00101111,61,00111101
31,00011111,42,00101010,73,01001001
66,01000010,104,01101000,170,10101010
115,01110011,41,00101001,156,10011100
35,00100011,89,01011001,124,01111100
60,00111100,93,01011101,153,10011001
98,01100010,70,01000110,168,10101000
58,00111010,124,01111100,182,10110110
76,01001100,83,01010011,159,10011111
106,01101010,15,00001111,121,01111001
116,01110100,112,01110000,228,11100100
0,00000000,125,01111101,125,01111101
91,01011011,78,01001110,169,10101001
90,01011010,59,00111011,149,10010101
72,01001000,102,01100110,174,10101110
61,00111101,84,01010100,145,10010001
120,01111000,104,01101000,224,11100000
98,01100010,39,00100111,137,10001001
85,01010101,122,01111010,207,11001111
62,00111110,34,00100010,96,01100000
122,01111010,73,01001001,195,11000011
28,00011100,102,01100110,130,10000010
71,01000111,39,00100111,110,01101110
101,01100101,26,00011010,127,01111111
52,00110100,111,01101111,163,10100011
126,01111110,43,00101011,169,10101001
27,00011011,11,00001011,38,00100110
106,01101010,94,01011110,200,11001000
98,01100010,22,00010110,120,01111000
42,00101010,77,01001101,119,01110111
102,01100110,21,00010101,123,01111011
92,01011100,64,01000000,156,10011100
34,00100010,33,00100001,67,01000011
96,01100000,93,01011101,189,10111101
100,01100100,35,00100011,135,10000111
12,00001100,16,00010000,28,00011100
20,00010100,98,01100010,118,01110110
8,00001000,90,01011010,98,01100010
107,01101011,112,01110000,219,11011011
46,00101110,37,00100101,83,01010011
67,01000011,31,00011111,98,01100010
87,01010111,68,01000100,155,10011011
103,01100111,13,00001101,116,01110100
103,01100111,4,00000100,107,01101011
4,00000100,87,01010111,91,01011011
76,01001100,61,00111101,137,10001001
3,00000011,88,01011000,91,01011011
67,01000011,62,00111110,129,10000001
78,01001110,9,00001001,87,01010111
40,00101000,20,00010100,60,00111100
26,00011010,91,01011011,117,01110101
125,01111101,79,01001111,204,11001100
99,01100011,28,00011100,127,01111111
51,00110011,76,01001100,127,01111111
68,01000100,20,00010100,88,01011000
91,01011011,40,00101000,131,10000011
56,00111000,70,01000110,126,01111110
68,01000100,56,00111000,124,01111100
14,00001110,82,01010010,96,01100000
117,01110101,107,01101011,224,11100000
20,00010100,38,00100110,58,00111010
4,00000100,67,01000011,71,01000111
24,00011000,75,01001011,99,01100011
55,00110111,89,01011001,144,10010000
30,00011110,70,01000110,100,01100100
119,01110111,12,00001100,131,10000011
64,01000000,12,00001100,76,01001100
97,01100001,118,01110110,215,11010111
33,00100001,8,00001000,41,00101001
67,01000011,101,01100101,168,10101000
9,00001001,97,01100001,106,01101010
119,01110111,7,00000111,126,01111110
17,00010001,62,00111110,79,01001111
10,00001010,98,01100010,108,01101100
121,01111001,1,00000001,122,01111010
110,01101110,61,00111101,171,10101011
110,01101110,69,01000101,179,10110011
28,00011100,88,01011000,116,01110100
42,00101010,71,01000111,113,01110001
104,01101000,15,00001111,119,01110111
87,01010111,76,01001100,163,10100011
36,00100100,46,00101110,82,01010010
98,01100010,108,01101100,206,11001110
16,00010000,119,01110111,135,10000111
36,00100100,53,00110101,89,01011001
111,01101111,85,01010101,196,11000100
19,00010011,11,00001011,30,00011110
6,00000110,75,01001011,81,01010001
110,01101110,37,00100101,147,10010011
56,00111000,8,00001000,64,01000000
122,01111010,85,01010101,207,11001111
6,00000110,99,01100011,105,01101001
101,01100101,28,00011100,129,10000001
44,00101100,48,00110000,92,01011100
47,00101111,101,01100101,148,10010100
109,01101101,83,01010011,192,11000000
111,01101111,76,01001100,187,10111011
34,00100010,62,00111110,96,01100000
103,01100111,74,01001010,177,10110001
42,00101010,88,01011000,130,10000010
60,00111100,3,00000011,63,00111111
24,00011000,125,01111101,149,10010101
90,01011010,5,00000101,95,01011111
39,00100111,89,01011001,128,10000000
38,00100110,46,00101110,84,01010100
63,00111111,10,00001010,73,01001001
43,00101011,8,00001000,51,00110011
77,01001101,35,00100011,112,01110000
120,01111000,65,01000001,185,10111001
1,00000001,39,00100111,40,00101000
51,00110011,118,01110110,169,10101001
38,00100110,21,00010101,59,00111011
99,01100011,107,01101011,206,11001110
76,01001100,20,00010100,96,01100000
36,00100100,45,00101101,81,01010001
117,01110101,44,00101100,161,10100001
88,01011000,32,00100000,120,01111000
22,00010110,24,00011000,46,00101110
89,01011001,86,01010110,175,10101111
66,01000010,51,00110011,117,01110101
37,00100101,58,00111010,95,01011111
32,00100000,74,01001010,106,01101010
12,00001100,50,00110010,62,00111110
101,01100101,123,01111011,224,11100000
92,01011100,38,00100110,130,10000010
67,01000011,14,00001110,81,01010001
57,00111001,18,00010010,75,01001011
90,01011010,104,01101000,194,11000010
48,00110000,75,01001011,123,01111011
53,00110101,47,00101111,100,01100100
51,00110011,55,00110111,106,01101010
59,00111011,40,00101000,99,01100011
75,01001011,96,01100000,171,10101011
60,00111100,19,00010011,79,01001111
59,00111011,77,01001101,136,10001000
126,01111110,97,01100001,223,11011111
91,01011011,81,01010001,172,10101100
34,00100010,110,01101110,144,10010000
126,01111110,69,01000101,195,11000011
97,01100001,87,01010111,184,10111000
26,00011010,119,01110111,145,10010001
102,01100110,9,00001001,111,01101111
62,00111110,50,00110010,112,01110000
28,00011100,60,00111100,88,01011000
32,00100000,68,01000100,100,01100100
33,00100001,21,00010101,54,00110110
82,01010010,39,00100111,121,01111001
103,01100111,127,01111111,230,11100110
91,01011011,68,01000100,159,10011111
16,00010000,9,00001001,25,00011001
7,00000111,90,01011010,97,01100001
32,00100000,72,01001000,104,01101000
19,00010011,118,01110110,137,10001001
32,00100000,53,00110101,85,01010101
14,00001110,108,01101100,122,01111010
105,01101001,48,00110000,153,10011001
34,00100010,29,00011101,63,00111111
115,01110011,53,00110101,168,10101000
113,01110001,46,00101110,159,10011111
19,00010011,115,01110011,134,10000110
27,00011011,94,01011110,121,01111001
82,01010010,6,00000110,88,01011000
88,01011000,59,00111011,147,10010011
68,01000100,84,01010100,152,10011000
47,00101111,77,01001101,124,01111100
78,01001110,79,01001111,157,10011101
39,00100111,108,01101100,147,10010011
15,00001111,76,01001100,91,01011011
100,01100100,53,00110101,153,10011001
48,00110000,41,00101001,89,01011001
27,00011011,67,01000011,94,01011110
85,01010101,47,00101111,132,10000100
10,00001010,49,00110001,59,00111011
76,01001100,8,00001000,84,01010100
54,00110110,43,00101011,97,01100001
13,00001101,117,01110101,130,10000010
20,00010100,3,00000011,23,00010111
71,01000111,29,00011101,100,01100100
75,01001011,104,01101000,179,10110011
35,00100011,85,01010101,120,01111000
81,01010001,64,01000000,145,10010001
30,00011110,113,01110001,143,10001111
26,00011010,87,01010111,113,01110001
117,01110101,46,00101110,163,10100011
23,00010111,107,01101011,130,10000010
108,01101100,1,00000001,109,01101101
64,01000000,66,01000010,130,10000010
43,00101011,50,00110010,93,01011101
89,01011001,13,00001101,102,01100110
62,00111110,44,00101100,106,01101010
62,00111110,11,00001011,73,01001001
114,01110010,105,01101001,219,11011011
85,01010101,31,00011111,116,01110100
124,01111100,69,01000101,193,11000001
52,00110100,87,01010111,139,10001011
60,00111100,123,01111011,183,10110111
18,00010010,16,00010000,34,00100010
97,01100001,102,01100110,199,11000111
124,01111100,106,01101010,230,11100110
7,00000111,42,00101010,49,00110001
66,01000010,62,00111110,128,10000000
40,00101000,0,00000000,40,00101000
17,00010001,66,01000010,83,01010011
116,01110100,113,01110001,229,11100101
29,00011101,21,00010101,50,00110010
13,00001101,116,01110100,129,10000001
94,01011110,80,01010000,174,10101110
74,01001010,41,00101001,115,01110011
84,01010100,11,00001011,95,01011111
40,00101000,15,00001111,55,00110111
121,01111001,37,00100101,158,10011110
57,00111001,42,00101010,99,01100011
71,01000111,105,01101001,176,10110000
114,01110010,13,00001101,127,01111111
90,01011010,29,00011101,119,01110111
104,01101000,70,01000110,174,10101110
96,01100000,90,01011010,186,10111010
63,00111111,17,00010001,80,01010000
118,01110110,22,00010110,140,10001100
116,01110100,54,00110110,170,10101010
58,00111010,55,00110111,113,01110001
47,00101111,4,00000100,51,00110011
95,01011111,46,00101110,141,10001101
32,00100000,107,01101011,139,10001011
68,01000100,27,00011011,95,01011111
67,01000011,12,00001100,79,01001111
117,01110101,1,00000001,118,01110110
114,01110010,10,00001010,124,01111100
57,00111001,49,00110001,106,01101010
44,00101100,64,01000000,108,01101100
39,00100111,69,01000101,108,01101100
63,00111111,72,01001000,135,10000111
123,01111011,17,00010001,140,10001100
23,00010111,60,00111100,83,01010011
30,00011110,91,01011011,121,01111001
46,00101110,122,01111010,168,10101000
80,01010000,2,00000010,82,01010010
109,01101101,99,01100011,208,11010000
35,00100011,34,00100010,69,01000101
46,00101110,52,00110100,98,01100010
59,00111011,67,01000011,126,01111110
109,01101101,64,01000000,173,10101101
106,01101010,62,00111110,168,10101000
53,00110101,57,00111001,110,01101110
115,01110011,67,01000011,182,10110110
106,01101010,24,00011000,130,10000010
112,01110000,36,00100100,148,10010100
69,01000101,69,01000101,138,10001010
113,01110001,78,01001110,191,10111111
94,01011110,64,01000000,158,10011110
60,00111100,91,01011011,151,10010111
24,00011000,77,01001101,101,01100101
2,00000010,101,01100101,103,01100111
76,01001100,31,00011111,107,01101011
115,01110011,110,01101110,225,11100001
58,00111010,4,00000100,62,00111110
37,00100101,41,00101001,78,01001110
103,01100111,117,01110101,220,11011100
20,00010100,48,00110000,68,01000100
37,00100101,111,01101111,148,10010100
48,00110000,33,00100001,81,01010001
21,00010101,51,00110011,72,01001000
126,01111110,119,01110111,245,11110101
126,01111110,70,01000110,196,11000100
117,01110101,0,00000000,117,01110101
64,01000000,8,00001000,72,01001000
89,01011001,98,01100010,187,10111011
58,00111010,84,01010100,142,10001110
76,01001100,6,00000110,82,01010010
103,01100111,57,00111001,160,10100000
98,01100010,68,01000100,166,10100110
12,00001100,22,00010110,34,00100010
59,00111011,53,00110101,112,01110000
118,01110110,70,01000110,188,10111100
104,01101000,103,01100111,207,11001111
75,01001011,78,01001110,153,10011001
37,00100101,49,00110001,86,01010110
7,00000111,3,00000011,10,00001010
1,00000001,74,01001010,75,01001011
79,01001111,87,01010111,166,10100110
107,01101011,70,01000110,177,10110001
28,00011100,62,00111110,90,01011010
53,00110101,35,00100011,88,01011000
79,01001111,76,01001100,155,10011011
116,01110100,115,01110011,231,11100111
4,00000100,101,01100101,105,01101001
68,01000100,24,00011000,92,01011100
17,00010001,89,01011001,106,01101010
110,01101110,30,00011110,140,10001100
9,00001001,27,00011011,36,00100100
83,01010011,76,01001100,159,10011111
46,00101110,69,01000101,115,01110011
35,00100011,65,01000001,100,01100100
47,00101111,87,01010111,134,10000110
67,01000011,49,00110001,116,01110100
102,01100110,121,01111001,223,11011111
6,00000110,44,00101100,50,00110010
127,01111111,40,00101000,167,10100111
90,01011010,95,01011111,185,10111001
119,01110111,86,01010110,205,11001101
105,01101001,97,01100001,202,11001010
106,01101010,67,01000011,173,10101101
30,00011110,11,00001011,41,00101001
83,01010011,28,00011100,111,01101111
64,01000000,27,00011011,91,01011011
110,01101110,3,00000011,113,01110001
60,00111100,59,00111011,119,01110111
60,00111100,116,01110100,176,10110000
106,01101010,17,00010001,123,01111011
123,01111011,93,01011101,216,11011000
60,00111100,57,00111001,117,01110101
71,01000111,52,00110100,123,01111011
20,00010100,73,01001001,93,01011101
97,01100001,75,01001011,172,10101100
75,01001011,61,00111101,136,10001000
2,00000010,91,01011011,93,01011101
4,00000100,29,00011101,33,00100001
117,01110101,54,00110110,171,10101011
65,01000001,27,00011011,92,01011100
31,00011111,67,01000011,98,01100010
12,00001100,127,01111111,139,10001011
43,00101011,61,00111101,104,01101000
62,00111110,98,01100010,160,10100000
95,01011111,25,00011001,120,01111000
126,01111110,76,01001100,202,11001010
112,01110000,52,00110100,164,10100100
90,01011010,18,00010010,108,01101100
52,00110100,65,01000001,117,01110101
100,01100100,54,00110110,154,10011010
35,00100011,67,01000011,102,01100110
102,01100110,21,00010101,123,01111011
41,00101001,88,01011000,129,10000001
70,01000110,5,00000101,75,01001011
20,00010100,109,01101101,129,10000001
98,01100010,105,01101001,203,11001011
13,00001101,0,00000000,13,00001101
117,01110101,66,01000010,183,10110111
26,00011010,36,00100100,62,00111110
23,00010111,78,01001110,101,01100101
19,00010011,74,01001010,93,01011101
19,00010011,58,00111010,77,01001101
20,00010100,56,00111000,76,01001100
97,01100001,33,00100001,130,10000010
66,01000010,104,01101000,170,10101010
50,00110010,54,00110110,104,01101000
85,01010101,103,01100111,188,10111100
96,01100000,96,01100000,192,11000000
58,00111010,124,01111100,182,10110110
66,01000010,32,00100000,98,01100010
28,00011100,61,00111101,89,01011001
40,00101000,17,00010001,57,00111001
26,00011010,97,01100001,123,01111011
0,00000000,73,01001001,73,01001001
25,00011001,18,00010010,43,00101011
118,01110110,76,01001100,194,11000010
114,01110010,68,01000100,182,10110110
82,01010010,3,00000011,85,01010101
108,01101100,68,01000100,176,10110000
14,00001110,86,01010110,100,01100100
12,00001100,115,01110011,127,01111111
74,01001010,82,01010010,156,10011100
122,01111010,53,00110101,175,10101111
110,01101110,118,01110110,228,11100100
57,00111001,33,00100001,90,01011010
70,01000110,1,00000001,71,01000111
78,01001110,127,01111111,205,11001101
45,00101101,59,00111011,104,01101000
126,01111110,70,01000110,196,11000100
51,00110011,39,00100111,90,01011010
45,00101101,37,00100101,82,01010010
17,00010001,18,00010010,35,00100011
43,00101011,63,00111111,106,01101010
107,01101011,53,00110101,160,10100000
80,01010000,53,00110101,133,10000101
118,01110110,12,00001100,130,10000010
45,00101101,72,01001000,117,01110101
127,01111111,127,01111111,254,11111110
126,01111110,25,00011001,151,10010111
50,00110010,78,01001110,128,10000000
70,01000110,12,00001100,82,01010010
91,01011011,127,01111111,218,11011010
118,01110110,71,01000111,189,10111101
117,01110101,107,01101011,224,11100000
22,00010110,12,00001100,34,00100010
64,01000000,95,01011111,159,10011111
69,01000101,116,01110100,185,10111001
82,01010010,109,01101101,191,10111111
4,00000100,114,01110010,118,01110110
84,01010100,97,01100001,181,10110101
110,01101110,84,01010100,194,11000010
98,01100010,24,00011000,122,01111010
92,01011100,76,01001100,168,10101000
94,01011110,34,00100010,128,10000000
65,01000001,21,00010101,86,01010110
35,00100011,96,01100000,131,10000011
104,01101000,28,00011100,132,10000100
1,00000001,91,01011011,92,01011100
86,01010110,70,01000110,156,10011100
43,00101011,64,01000000,107,01101011
35,00100011,9,00001001,44,00101100
3,00000011,12,00001100,15,00001111
46,00101110,7,00000111,53,00110101
54,00110110,53,00110101,107,01101011
112,01110000,124,01111100,236,11101100
17,00010001,109,01101101,126,01111110
28,00011100,126,01111110,154,10011010
56,00111000,25,00011001,81,01010001
52,00110100,4,00000100,56,00111000
80,01010000,105,01101001,185,10111001
4,00000100,112,01110000,116,01110100
122,01111010,38,00100110,160,10100000
24,00011000,102,01100110,126,01111110
14,00001110,26,00011010,40,00101000
113,01110001,112,01110000,225,11100001
76,01001100,45,00101101,121,01111001
102,01100110,42,00101010,144,10010000
52,00110100,99,01100011,151,10010111
95,01011111,91,01011011,186,10111010
95,01011111,88,01011000,183,10110111
94,01011110,104,01101000,198,11000110
16,00010000,39,00100111,55,00110111
59,00111011,108,01101100,167,10100111
13,00001101,125,01111101,138,10001010
19,00010011,94,01011110,113,01110001
24,00011000,46,00101110,70,01000110
28,00011100,125,01111101,153,10011001
77,01001101,3,00000011,80,01010000
96,01100000,45,00101101,141,10001101
38,00100110,60,00111100,98,01100010
100,01100100,124,01111100,224,11100000
31,00011111,102,01100110,133,10000101
16,00010000,75,01001011,91,01011011
39,00100111,91,01011011,130,10000010
82,01010010,50,00110010,132,10000100
88,01011000,68,01000100,156,10011100
94,01011110,110,01101110,204,11001100
121,01111001,32,00100000,153,10011001
32,00100000,101,01100101,133,10000101
45,00101101,123,01111011,168,10101000
124,01111100,69,01000101,193,11000001
8,00001000,127,01111111,135,10000111
105,01101001,40,00101000,145,10010001
58,00111010,16,00010000,74,01001010
14,00001110,97,01100001,111,01101111
106,01101010,85,01010101,191,10111111
39,00100111,92,01011100,131,10000011
65,01000001,121,01111001,186,10111010
108,01101100,15,00001111,123,01111011
36,00100100,102,01100110,138,10001010
87,01010111,86,01010110,173,10101101
122,01111010,37,00100101,159,10011111
50,00110010,74,01001010,124,01111100
54,00110110,44,00101100,98,01100010
87,01010111,122,01111010,209,11010001
105,01101001,28,00011100,133,10000101
17,00010001,85,01010101,102,01100110
108,01101100,25,00011001,133,10000101
21,00010101,95,01011111,116,01110100
72,01001000,38,00100110,110,01101110
37,00100101,93,01011101,130,10000010
102,01100110,11,00001011,113,01110001
89,01011001,125,01111101,214,11010110
105,01101001,11,00001011,116,01110100
62,00111110,5,00000101,67,01000011
70,01000110,125,01111101,195,11000011
61,00111101,63,00111111,124,01111100
74,01001010,66,01000010,140,10001100
18,00010010,26,00011010,44,00101100
102,01100110,97,01100001,199,11000111
94,01011110,35,00100011,129,10000001
39,00100111,113,01110001,152,10011000
11,00001011,1,00000001,12,00001100
85,01010101,83,01010011,168,10101000
64,01000000,77,01001101,141,10001101
10,00001010,86,01010110,96,01100000
103,01100111,19,00010011,122,01111010
109,01101101,84,01010100,193,11000001
4,00000100,13,00001101,17,00010001
101,01100101,59,00111011,160,10100000
41,00101001,37,00100101,78,01001110
88,01011000,75,01001011,163,10100011
55,00110111,58,00111010,113,01110001
26,00011010,116,01110100,142,10001110
65,01000001,40,00101000,105,01101001
39,00100111,108,01101100,147,10010011
63,00111111,73,01001001,136,10001000
40,00101000,49,00110001,89,01011001
23,00010111,126,01111110,149,10010101
18,00010010,105,01101001,123,01111011
33,00100001,102,01100110,135,10000111
52,00110100,101,01100101,153,10011001
76,01001100,34,00100010,110,01101110
123,01111011,3,00000011,126,01111110
36,00100100,40,00101000,76,01001100
7,00000111,126,01111110,133,10000101
16,00010000,79,01001111,95,01011111
47,00101111,113,01110001,160,10100000
66,01000010,41,00101001,107,01101011
12,00001100,72,01001000,84,01010100
121,01111001,115,01110011,236,11101100
21,00010101,54,00110110,75,01001011
33,00100001,44,00101100,77,01001101
19,00010011,115,01110011,134,10000110
120,01111000,89,01011001,209,11010001
98,01100010,81,01010001,179,10110011
30,00011110,122,01111010,152,10011000
46,00101110,32,00100000,78,01001110
115,01110011,100,01100100,215,11010111
84,01010100,100,01100100,184,10111000
25,00011001,79,01001111,104,01101000
28,00011100,72,01001000,100,01100100
120,01111000,105,01101001,225,11100001
30,00011110,103,01100111,133,10000101
119,01110111,46,00101110,165,10100101
112,01110000,100,01100100,212,11010100
46,00101110,76,01001100,122,01111010
88,01011000,51,00110011,139,10001011
55,00110111,19,00010011,74,01001010
56,00111000,75,01001011,131,10000011
38,00100110,39,00100111,77,01001101
98,01100010,81,01010001,179,10110011
103,01100111,30,00011110,133,10000101
24,00011000,17,00010001,41,00101001
27,00011011,31,00011111,58,00111010
41,00101001,31,00011111,72,01001000
8,00001000,65,01000001,73,01001001
83,01010011,112,01110000,195,11000011
78,01001110,65,01000001,143,10001111
97,01100001,47,00101111,144,10010000
52,00110100,116,01110100,168,10101000
45,00101101,86,01010110,131,10000011
78,01001110,9,00001001,87,01010111
13,00001101,95,01011111,108,01101100
20,00010100,37,00100101,57,00111001
36,00100100,11,00001011,47,00101111
59,00111011,73,01001001,132,10000100
48,00110000,82,01010010,130,10000010
104,01101000,69,01000101,173,10101101
66,01000010,2,00000010,68,01000100
19,00010011,26,00011010,45,00101101
50,00110010,112,01110000,162,10100010
100,01100100,8,00001000,108,01101100
107,01101011,6,00000110,113,01110001
62,00111110,77,01001101,139,10001011
18,00010010,68,01000100,86,01010110
66,01000010,114,01110010,180,10110100
42,00101010,73,01001001,115,01110011
118,01110110,78,01001110,196,11000100
12,00001100,107,01101011,119,01110111
51,00110011,10,00001010,61,00111101
37,00100101,31,00011111,68,01000100
89,01011001,99,01100011,188,10111100
16,00010000,71,01000111,87,01010111
102,01100110,119,01110111,221,11011101
43,00101011,13,00001101,56,00111000
51,00110011,38,00100110,89,01011001
37,00100101,107,01101011,144,10010000
37,00100101,3,00000011,40,00101000
47,00101111,124,01111100,171,10101011
63,00111111,115,01110011,178,10110010
105,01101001,102,01100110,207,11001111
68,01000100,125,01111101,193,11000001
85,01010101,43,00101011,128,10000000
90,01011010,58,00111010,148,10010100
48,00110000,46,00101110,94,01011110
45,00101101,49,00110001,94,01011110
30,00011110,108,01101100,138,10001010
85,01010101,21,00010101,106,01101010
58,00111010,40,00101000,98,01100010
32,00100000,94,01011110,126,01111110
85,01010101,98,01100010,183,10110111
31,00011111,45,00101101,76,01001100
109,01101101,69,01000101,178,10110010
111,01101111,4,00000100,115,01110011
33,00100001,82,01010010,115,01110011
62,00111110,106,01101010,168,10101000
6,00000110,83,01010011,89,01011001
6,00000110,119,01110111,125,01111101
117,01110101,121,01111001,238,11101110
51,00110011,43,00101011,94,01011110
102,01100110,75,01001011,177,10110001
121,01111001,102,01100110,223,11011111
46,00101110,54,00110110,100,01100100
106,01101010,90,01011010,196,11000100
7,00000111,28,00011100,35,00100011
25,00011001,83,01010011,108,01101100
52,00110100,23,00010111,75,01001011
47,00101111,94,01011110,141,10001101
123,01111011,37,00100101,160,10100000
103,01100111,59,00111011,162,10100010
52,00110100,99,01100011,151,10010111
83,01010011,15,00001111,98,01100010
101,01100101,8,00001000,109,01101101
43,00101011,83,01010011,126,01111110
117,01110101,101,01100101,218,11011010
55,00110111,56,00111000,111,01101111
117,01110101,38,00100110,155,10011011
73,01001001,54,00110110,127,01111111
105,01101001,86,01010110,191,10111111
102,01100110,94,01011110,196,11000100
16,00010000,50,00110010,66,01000010
120,01111000,126,01111110,246,11110110
118,01110110,105,01101001,223,11011111
11,00001011,20,00010100,31,00011111
56,00111000,38,00100110,94,01011110
51,00110011,109,01101101,160,10100000
63,00111111,59,00111011,122,01111010
84,01010100,16,00010000,100,01100100
105,01101001,73,01001001,178,10110010
79,01001111,3,00000011,82,01010010
34,00100010,110,01101110,144,10010000
99,01100011,46,00101110,145,10010001
110,01101110,33,00100001,143,10001111
45,00101101,112,01110000,157,10011101
95,01011111,73,01001001,168,10101000
20,00010100,19,00010011,39,00100111
109,01101101,102,01100110,211,11010011
80,01010000,85,01010101,165,10100101
9,00001001,98,01100010,107,01101011
38,00100110,4,00000100,42,00101010
109,01101101,115,01110011,224,11100000
8,00001000,49,00110001,57,00111001
125,01111101,2,00000010,127,01111111
57,00111001,74,01001010,131,10000011
26,00011010,92,01011100,118,01110110
20,00010100,23,00010111,43,00101011
37,00100101,103,01100111,140,10001100
124,01111100,5,00000101,129,10000001
49,00110001,6,00000110,55,00110111
9,00001001,21,00010101,30,00011110
36,00100100,99,01100011,135,10000111
40,00101000,36,00100100,76,01001100
17,00010001,6,00000110,23,00010111
74,01001010,11,00001011,85,01010101
91,01011011,20,00010100,111,01101111
118,01110110,101,01100101,219,11011011
35,00100011,109,01101101,144,10010000
116,01110100,40,00101000,156,10011100
116,01110100,43,00101011,159,10011111
69,01000101,26,00011010,95,01011111
1,00000001,18,00010010,19,00010011
103,01100111,113,01110001,216,11011000
80,01010000,13,00001101,93,01011101
92,01011100,5,00000101,97,01100001
73,01001001,101,01100101,174,10101110
21,00010101,16,00010000,37,00100101
107,01101011,42,00101010,149,10010101
116,01110100,77,01001101,193,11000001
6,00000110,82,01010010,88,01011000
3,00000011,78,01001110,81,01010001
38,00100110,8,00001000,46,00101110
111,01101111,6,00000110,117,01110101
23,00010111,15,00001111,38,00100110
40,00101000,86,01010110,126,01111110
120,01111000,86,01010110,206,11001110
109,01101101,2,00000010,111,01101111
43,00101011,55,00110111,98,01100010
111,01101111,48,00110000,159,10011111
73,01001001,23,00010111,96,01100000
88,01011000,41,00101001,129,10000001
10,00001010,52,00110100,62,00111110
73,01001001,32,00100000,105,01101001
112,01110000,103,01100111,215,11010111
123,01111011,89,01011001,212,11010100
59,00111011,36,00100100,95,01011111
79,01001111,69,01000101,148,10010100
100,01100100,2,00000010,102,01100110
14,00001110,89,01011001,103,01100111
97,01100001,59,00111011,156,10011100
121,01111001,85,01010101,206,11001110
105,01101001,74,01001010,179,10110011
49,00110001,75,01001011,124,01111100
114,01110010,116,01110100,230,11100110
127,01111111,27,00011011,154,10011010
13,00001101,44,00101100,57,00111001
2,00000010,39,00100111,41,00101001
20,00010100,99,01100011,119,01110111
73,01001001,2,00000010,75,01001011
122,01111010,80,01010000,202,11001010
61,00111101,67,01000011,128,10000000
49,00110001,70,01000110,119,01110111
24,00011000,9,00001001,33,00100001
8,00001000,56,00111000,64,01000000
86,01010110,41,00101001,127,01111111
45,00101101,81,01010001,126,01111110
59,00111011,113,01110001,172,10101100
26,00011010,32,00100000,58,00111010
94,01011110,19,00010011,113,01110001
110,01101110,37,00100101,147,10010011
81,01010001,53,00110101,134,10000110
66,01000010,26,00011010,92,01011100
49,00110001,53,00110101,102,01100110
10,00001010,26,00011010,36,00100100
98,01100010,33,00100001,131,10000011
95,01011111,4,00000100,99,01100011
94,01011110,36,00100100,130,10000010
116,01110100,58,00111010,174,10101110
31,00011111,100,01100100,131,10000011
65,01000001,115,01110011,180,10110100
81,01010001,18,00010010,99,01100011
63,00111111,19,00010011,82,01010010
90,01011010,56,00111000,146,10010010
69,01000101,17,00010001,86,01010110
116,01110100,123,01111011,239,11101111
13,00001101,26,00011010,39,00100111
1,00000001,21,00010101,22,00010110
105,01101001,59,00111011,164,10100100
96,01100000,51,00110011,147,10010011
69,01000101,80,01010000,149,10010101
15,00001111,36,00100100,51,00110011
71,01000111,68,01000100,139,10001011
27,00011011,2,00000010,29,00011101
113,01110001,7,00000111,120,01111000
76,01001100,78,01001110,154,10011010
73,01001001,3,00000011,76,01001100
70,01000110,45,00101101,115,01110011
48,00110000,106,01101010,154,10011010
88,01011000,29,00011101,117,01110101
103,01100111,127,01111111,230,11100110
123,01111011,53,00110101,176,10110000
37,00100101,107,01101011,144,10010000
0,00000000,77,01001101,77,01001101
69,01000101,68,01000100,137,10001001
49,00110001,87,01010111,136,10001000
29,00011101,9,00001001,38,00100110
17,00010001,51,00110011,68,01000100
26,00011010,98,01100010,124,01111100
36,00100100,113,01110001,149,10010101
13,00001101,107,01101011,120,01111000
109,01101101,39,00100111,148,10010100
122,01111010,34,00100010,156,10011100
115,01110011,38,00100110,153,10011001
6,00000110,7,00000111,13,00001101
22,00010110,14,00001110,36,00100100
89,01011001,97,01100001,186,10111010
31,00011111,52,00110100,83,01010011
44,00101100,71,01000111,115,01110011
64,01000000,80,01010000,144,10010000
2,00000010,64,01000000,66,01000010
20,00010100,80,01010000,100,01100100
57,00111001,36,00100100,93,01011101
56,00111000,72,01001000,128,10000000
16,00010000,73,01001001,89,01011001
114,01110010,28,00011100,142,10001110
69,01000101,77,01001101,146,10010010
104,01101000,43,00101011,147,10010011
89,01011001,3,00000011,92,01011100
52,00110100,64,01000000,116,01110100
31,00011111,98,01100010,129,10000001
70,01000110,11,00001011,81,01010001
86,01010110,31,00011111,117,01110101
119,01110111,84,01010100,203,11001011
73,01001001,108,01101100,181,10110101
38,00100110,42,00101010,80,01010000
20,00010100,5,00000101,25,00011001
61,00111101,74,01001010,135,10000111
15,00001111,4,00000100,19,00010011
16,00010000,57,00111001,73,01001001
53,00110101,116,01110100,169,10101001
39,00100111,52,00110100,91,01011011
73,01001001,91,01011011,164,10100100
24,00011000,98,01100010,122,01111010
91,01011011,90,01011010,181,10110101
6,00000110,65,01000001,71,01000111
39,00100111,97,01100001,136,10001000
84,01010100,83,01010011,167,10100111
83,01010011,72,01001000,155,10011011
48,00110000,5,00000101,53,00110101
17,00010001,34,00100010,51,00110011
3,00000011,119,01110111,122,01111010
74,01001010,75,01001011,149,10010101
105,01101001,28,00011100,133,10000101
11,00001011,107,01101011,118,01110110
66,01000010,91,01011011,157,10011101
108,01101100,42,00101010,150,10010110
11,00001011,22,00010110,33,00100001
96,01100000,46,00101110,142,10001110
50,00110010,6,00000110,56,00111000
44,00101100,57,00111001,101,01100101
88,01011000,101,01100101,189,10111101
70,01000110,118,01110110,188,10111100
21,00010101,108,01101100,129,10000001
51,00110011,44,00101100,95,01011111
94,01011110,16,00010000,110,01101110
106,01101010,83,01010011,189,10111101
84,01010100,19,00010011,103,01100111
104,01101000,124,01111100,228,11100100
42,00101010,73,01001001,115,01110011
22,00010110,56,00111000,78,01001110
1,00000001,83,01010011,84,01010100
81,01010001,12,00001100,93,01011101
18,00010010,24,00011000,42,00101010
71,01000111,90,01011010,161,10100001
5,00000101,114,01110010,119,01110111
0,00000000,46,00101110,46,00101110
81,01010001,107,01101011,188,10111100
51,00110011,41,00101001,92,01011100
125,01111101,105,01101001,230,11100110
99,01100011,111,01101111,210,11010010
126,01111110,12,00001100,138,10001010
35,00100011,79,01001111,114,01110010
60,00111100,113,01110001,173,10101101
64,01000000,93,01011101,157,10011101
125,01111101,90,01011010,215,11010111
30,00011110,68,01000100,98,01100010
75,01001011,86,01010110,161,10100001
104,01101000,38,00100110,142,10001110
51,00110011,19,00010011,70,01000110
84,01010100,70,01000110,154,10011010
65,01000001,74,01001010,139,10001011
23,00010111,100,01100100,123,01111011
49,00110001,30,00011110,79,01001111
46,00101110,50,00110010,96,01100000
0,00000000,32,00100000,32,00100000
77,01001101,110,01101110,187,10111011
74,01001010,77,01001101,151,10010111
52,00110100,101,01100101,153,10011001
58,00111010,89,01011001,147,10010011
11,00001011,113,01110001,124,01111100
107,01101011,20,00010100,127,01111111
21,00010101,125,01111101,146,10010010
46,00101110,25,00011001,71,01000111
8,00001000,31,00011111,39,00100111
95,01011111,110,01101110,205,11001101
119,01110111,5,00000101,124,01111100
40,00101000,123,01111011,163,10100011
111,01101111,96,01100000,207,11001111
30,00011110,13,00001101,43,00101011
24,00011000,123,01111011,147,10010011
87,01010111,120,01111000,207,11001111
80,01010000,60,00111100,140,10001100
19,00010011,41,00101001,60,00111100
75,01001011,125,01111101,200,11001000
16,00010000,95,01011111,111,01101111
120,01111000,111,01101111,231,11100111
75,01001011,101,01100101,176,10110000
110,01101110,47,00101111,157,10011101
0,00000000,72,01001000,72,01001000
19,00010011,3,00000011,22,00010110
52,00110100,0,00000000,52,00110100
53,00110101,36,00100100,89,01011001
7,00000111,108,01101100,115,01110011
73,01001001,18,00010010,91,01011011
106,01101010,100,01100100,206,11001110
119,01110111,43,00101011,162,10100010
121,01111001,116,01110100,237,11101101
68,01000100,100,01100100,168,10101000
6,00000110,116,01110100,122,01111010
30,00011110,53,00110101,83,01010011
6,00000110,15,00001111,21,00010101
38,00100110,81,01010001,119,01110111
0,00000000,71,01000111,71,01000111
79,01001111,26,00011010,105,01101001
119,01110111,58,00111010,177,10110001
27,00011011,120,01111000,147,10010011
49,00110001,37,00100101,86,01010110
23,00010111,99,01100011,122,01111010
81,01010001,103,01100111,184,10111000
101,01100101,13,00001101,114,01110010
95,01011111,100,01100100,195,11000011
46,00101110,106,01101010,152,10011000
28,00011100,110,01101110,138,10001010
2,00000010,80,01010000,82,01010010
32,00100000,102,01100110,134,10000110
126,01111110,32,00100000,158,10011110
25,00011001,55,00110111,80,01010000
99,01100011,104,01101000,203,11001011
75,01001011,19,00010011,94,01011110
47,00101111,69,01000101,116,01110100
83,01010011,117,01110101,200,11001000
124,01111100,33,00100001,157,10011101
78,01001110,122,01111010,200,11001000
123,01111011,15,00001111,138,10001010
106,01101010,77,01001101,183,10110111
21,00010101,18,00010010,39,00100111
114,01110010,87,01010111,201,11001001
67,01000011,88,01011000,155,10011011
4,00000100,106,01101010,110,01101110
33,00100001,120,01111000,153,10011001
93,01011101,84,01010100,177,10110001
118,01110110,7,00000111,125,01111101
123,01111011,70,01000110,193,11000001
98,01100010,92,01011100,190,10111110
26,00011010,28,00011100,54,00110110
6,00000110,22,00010110,28,00011100
86,01010110,44,00101100,130,10000010
68,01000100,103,01100111,171,10101011
30,00011110,98,01100010,128,10000000
33,00100001,48,00110000,81,01010001
104,01101000,30,00011110,134,10000110
48,00110000,84,01010100,132,10000100
3,00000011,50,00110010,53,00110101
111,01101111,81,01010001,192,11000000
45,00101101,28,00011100,73,01001001
119,01110111,20,00010100,139,10001011
18,00010010,56,00111000,74,01001010
81,01010001,98,01100010,179,10110011
49,00110001,51,00110011,100,01100100
32,00100000,0,00000000,32,00100000
35,00100011,25,00011001,60,00111100
42,00101010,82,01010010,124,01111100
50,00110010,46,00101110,96,01100000
25,00011001,87,01010111,112,01110000
67,01000011,70,01000110,137,10001001
78,01001110,1,00000001,79,01001111
48,00110000,20,00010100,68,01000100
76,01001100,44,00101100,120,01111000
107,01101011,90,01011010,197,11000101
72,01001000,53,00110101,125,01111101
71,01000111,3,00000011,74,01001010
15,00001111,101,01100101,116,01110100
105,01101001,8,00001000,113,01110001
61,00111101,21,00010101,82,01010010
79,01001111,79,01001111,158,10011110
34,00100010,122,01111010,156,10011100
114,01110010,55,00110111,169,10101001
72,01001000,15,00001111,87,01010111
31,00011111,1,00000001,32,00100000
111,01101111,32,00100000,143,10001111
125,01111101,73,01001001,198,11000110
30,00011110,15,00001111,45,00101101
8,00001000,11,00001011,19,00010011
68,01000100,44,00101100,112,01110000
35,00100011,46,00101110,81,01010001
32,00100000,97,01100001,129,10000001
62,00111110,23,00010111,85,01010101
12,00001100,77,01001101,89,01011001
112,01110000,54,00110110,166,10100110
4,00000100,72,01001000,76,01001100
18,00010010,75,01001011,93,01011101
0,00000000,41,00101001,41,00101001
29,00011101,80,01010000,109,01101101
1,00000001,10,00001010,11,00001011
120,01111000,33,00100001,153,10011001
120,01111000,41,00101001,161,10100001
63,00111111,90,01011010,153,10011001
46,00101110,30,00011110,76,01001100
43,00101011,21,00010101,64,01000000
31,00011111,49,00110001,80,01010000
12,00001100,36,00100100,48,00110000
73,01001001,119,01110111,192,11000000
21,00010101,109,01101101,130,10000010
50,00110010,102,01100110,152,10011000
40,00101000,72,01001000,112,01110000
10,00001010,47,00101111,57,00111001
33,00100001,2,00000010,35,00100011
126,01111110,13,00001101,139,10001011
49,00110001,29,00011101,78,01001110
81,01010001,18,00010010,99,01100011
81,01010001,91,01011011,172,10101100
64,01000000,43,00101011,107,01101011
122,01111010,104,01101000,226,11100010
9,00001001,65,01000001,74,01001010
73,01001001,32,00100000,105,01101001
116,01110100,94,01011110,210,11010010
21,00010101,100,01100100,121,01111001
107,01101011,80,01010000,187,10111011
77,01001101,100,01100100,177,10110001
0,00000000,102,01100110,102,01100110
103,01100111,38,00100110,141,10001101
18,00010010,66,01000010,84,01010100
101,01100101,49,00110001,150,10010110
58,00111010,8,00001000,66,01000010
78,01001110,36,00100100,114,01110010
42,00101010,21,00010101,63,00111111
61,00111101,105,01101001,166,10100110
96,01100000,81,01010001,177,10110001
8,00001000,12,00001100,20,00010100
19,00010011,66,01000010,85,01010101
84,01010100,74,01001010,158,10011110
115,01110011,21,00010101,136,10001000
113,01110001,76,01001100,189,10111101
66,01000010,44,00101100,110,01101110
116,01110100,99,01100011,215,11010111
44,00101100,33,00100001,77,01001101
55,00110111,32,00100000,87,01010111
27,00011011,47,00101111,74,01001010
40,00101000,102,01100110,142,10001110
119,01110111,20,00010100,139,10001011
65,01000001,41,00101001,106,01101010
124,01111100,66,01000010,190,10111110
84,01010100,93,01011101,177,10110001
41,00101001,5,00000101,46,00101110
3,00000011,43,00101011,46,00101110
105,01101001,48,00110000,153,10011001
97,01100001,78,01001110,175,10101111
33,00100001,86,01010110,119,01110111
49,00110001,9,00001001,58,00111010
119,01110111,32,00100000,151,10010111
85,01010101,36,00100100,121,01111001
54,00110110,45,00101101,99,01100011
56,00111000,67,01000011,123,01111011
101,01100101,49,00110001,150,10010110
121,01111001,14,00001110,135,10000111
118,01110110,97,01100001,215,11010111
14,00001110,118,01110110,132,10000100
71,01000111,87,01010111,158,10011110
67,01000011,2,00000010,69,01000101
42,00101010,41,00101001,83,01010011
102,01100110,40,00101000,142,10001110
20,00010100,95,01011111,115,01110011
19,00010011,80,01010000,99,01100011
32,00100000,109,01101101,141,10001101
26,00011010,73,01001001,99,01100011
6,00000110,126,01111110,132,10000100
71,01000111,10,00001010,81,01010001
38,00100110,40,00101000,78,01001110
92,01011100,28,00011100,120,01111000
8,00001000,6,00000110,14,00001110
5,00000101,80,01010000,85,01010101
93,01011101,106,01101010,199,11000111
26,00011010,13,00001101,39,00100111
54,00110110,67,01000011,121,01111001
116,01110100,78,01001110,194,11000010
56,00111000,17,00010001,73,01001001
76,01001100,126,01111110,202,11001010
123,01111011,67,01000011,190,10111110
66,01000010,18,00010010,84,01010100
91,01011011,103,01100111,194,11000010
100,01100100,18,00010010,118,01110110
28,00011100,49,00110001,77,01001101
67,01000011,14,00001110,81,01010001
51,00110011,69,01000101,120,01111000
111,01101111,20,00010100,131,10000011
9,00001001,3,00000011,12,00001100
41,00101001,78,01001110,119,01110111
103,01100111,98,01100010,201,11001001
123,01111011,27,00011011,150,10010110
3,00000011,23,00010111,26,00011010
118,01110110,121,01111001,239,11101111
83,01010011,61,00111101,144,10010000
106,01101010,27,00011011,133,10000101
11,00001011,113,01110001,124,01111100
23,00010111,73,01001001,96,01100000
55,00110111,82,01010010,137,10001001
116,01110100,120,01111000,236,11101100
75,01001011,115,01110011,190,10111110
48,00110000,23,00010111,71,01000111
94,01011110,7,00000111,101,01100101
63,00111111,30,00011110,93,01011101
32,00100000,48,00110000,80,01010000
84,01010100,27,00011011,111,01101111
0,00000000,126,01111110,126,01111110
62,00111110,90,01011010,152,10011000
74,01001010,58,00111010,132,10000100
94,01011110,90,01011010,184,10111000
11,00001011,97,01100001,108,01101100
112,01110000,99,01100011,211,11010011
49,00110001,27,00011011,76,01001100
8,00001000,75,01001011,83,01010011
91,01011011,56,00111000,147,10010011
72,01001000,20,00010100,92,01011100
67,01000011,80,01010000,147,10010011
72,01001000,97,01100001,169,10101001
124,01111100,18,00010010,142,10001110
79,01001111,110,01101110,189,10111101
97,01100001,98,01100010,195,11000011
102,01100110,80,01010000,182,10110110
113,01110001,111,01101111,224,11100000
55,00110111,124,01111100,179,10110011
22,00010110,72,01001000,94,01011110
49,00110001,94,01011110,143,10001111
12,00001100,71,01000111,83,01010011
21,00010101,99,01100011,120,01111000
50,00110010,53,00110101,103,01100111
33,00100001,65,01000001,98,01100010
26,00011010,25,00011001,51,00110011
103,01100111,50,00110010,153,10011001
14,00001110,85,01010101,99,01100011
1,00000001,16,00010000,17,00010001
41,00101001,106,01101010,147,10010011
55,00110111,26,00011010,81,01010001
81,01010001,101,01100101,182,10110110
32,00100000,53,00110101,85,01010101
87,01010111,89,01011001,176,10110000
3,00000011,106,01101010,109,01101101
106,01101010,48,00110000,154,10011010
9,00001001,34,00100010,43,00101011
28,00011100,57,00111001,85,01010101
117,01110101,95,01011111,212,11010100
98,01100010,101,01100101,199,11000111
88,01011000,102,01100110,190,10111110
81,01010001,55,00110111,136,10001000
20,00010100,51,00110011,71,01000111
31,00011111,19,00010011,50,00110010
72,01001000,88,01011000,160,10100000
49,00110001,27,00011011,76,01001100
55,00110111,113,01110001,168,10101000
59,00111011,2,00000010,61,00111101
5,00000101,39,00100111,44,00101100
6,00000110,1,00000001,7,00000111
54,00110110,80,01010000,134,10000110
60,00111100,126,01111110,186,10111010
44,00101100,68,01000100,112,01110000
107,01101011,4,00000100,111,01101111
21,00010101,73,01001001,94,01011110
120,01111000,95,01011111,215,11010111
36,00100100,7,00000111,43,00101011
53,00110101,126,01111110,179,10110011
36,00100100,73,01001001,109,01101101
84,01010100,26,00011010,110,01101110
89,01011001,20,00010100,109,01101101
107,01101011,88,01011000,195,11000011
100,01100100,97,01100001,197,11000101
61,00111101,107,01101011,168,10101000
11,00001011,56,00111000,67,01000011
23,00010111,105,01101001,128,10000000
120,01111000,26,00011010,146,10010010
41,00101001,25,00011001,66,01000010
123,01111011,67,01000011,190,10111110
6,00000110,10,00001010,16,00010000
105,01101001,39,00100111,144,10010000
92,01011100,120,01111000,212,11010100
43,00101011,40,00101000,83,01010011
64,01000000,8,00001000,72,01001000
72,01001000,43,00101011,115,01110011
97,01100001,73,01001001,170,10101010
40,00101000,73,01001001,113,01110001
32,00100000,116,01110100,148,10010100
79,01001111,12,00001100,91,01011011
15,00001111,90,01011010,105,01101001
68,01000100,116,01110100,184,10111000
49,00110001,40,00101000,89,01011001
12,00001100,10,00001010,22,00010110
21,00010101,110,01101110,131,10000011
115,01110011,70,01000110,185,10111001
48,00110000,114,01110010,162,10100010
69,01000101,17,00010001,86,01010110
81,01010001,87,01010111,168,10101000
10,00001010,47,00101111,57,00111001
50,00110010,31,00011111,81,01010001
96,01100000,4,00000100,100,01100100
117,01110101,105,01101001,222,11011110
125,01111101,127,01111111,252,11111100
71,01000111,49,00110001,120,01111000
43,00101011,14,00001110,57,00111001
27,00011011,31,00011111,58,00111010
119,01110111,6,00000110,125,01111101
87,01010111,24,00011000,111,01101111
37,00100101,51,00110011,88,01011000
81,01010001,86,01010110,167,10100111
7,00000111,91,01011011,98,01100010
60,00111100,24,00011000,84,01010100
32,00100000,56,00111000,88,01011000
36,00100100,16,00010000,52,00110100
113,01110001,80,01010000,193,11000001
5,00000101,28,00011100,33,00100001
90,01011010,61,00111101,151,10010111
73,01001001,82,01010010,155,10011011
31,00011111,56,00111000,87,01010111
66,01000010,126,01111110,192,11000000
9,00001001,75,01001011,84,01010100
24,00011000,79,01001111,103,01100111
117,01110101,96,01100000,213,11010101
49,00110001,14,00001110,63,00111111
27,00011011,82,01010010,109,01101101
107,01101011,94,01011110,201,11001001
40,00101000,26,00011010,66,01000010
57,00111001,53,00110101,110,01101110
90,01011010,73,01001001,163,10100011
33,00100001,113,01110001,146,10010010
122,01111010,33,00100001,155,10011011
68,01000100,8,00001000,76,01001100
94,01011110,42,00101010,136,10001000
112,01110000,27,00011011,139,10001011
100,01100100,28,00011100,128,10000000
71,01000111,7,00000111,78,01001110
28,00011100,20,00010100,48,00110000
76,01001100,104,01101000,180,10110100
121,01111001,43,00101011,164,10100100
57,00111001,0,00000000,57,00111001
85,01010101,36,00100100,121,01111001
126,01111110,4,00000100,130,10000010
45,00101101,104,01101000,149,10010101
49,00110001,7,00000111,56,00111000
79,01001111,17,00010001,96,01100000
92,01011100,107,01101011,199,11000111
101,01100101,50,00110010,151,10010111
87,01010111,3,00000011,90,01011010
92,01011100,80,01010000,172,10101100
72,01001000,36,00100100,108,01101100
79,01001111,0,00000000,79,01001111
50,00110010,15,00001111,65,01000001
66,01000010,4,00000100,70,01000110
90,01011010,21,00010101,111,01101111
27,00011011,83,01010011,110,01101110
10,00001010,11,00001011,21,00010101
84,01010100,126,01111110,210,11010010
47,00101111,16,00010000,63,00111111
73,01001001,30,00011110,103,01100111
39,00100111,28,00011100,67,01000011
100,01100100,52,00110100,152,10011000
75,01001011,109,01101101,184,10111000
30,00011110,50,00110010,80,01010000
112,01110000,48,00110000,160,10100000
62,00111110,23,00010111,85,01010101
106,01101010,107,01101011,213,11010101
67,01000011,39,00100111,106,01101010
40,00101000,18,00010010,58,00111010
99,01100011,125,01111101,224,11100000
91,01011011,86,01010110,177,10110001
19,00010011,55,00110111,74,01001010
6,00000110,123,01111011,129,10000001
77,01001101,5,00000101,82,01010010
75,01001011,89,01011001,164,10100100
1,00000001,124,01111100,125,01111101
52,00110100,114,01110010,166,10100110
36,00100100,79,01001111,115,01110011
108,01101100,56,00111000,164,10100100
27,00011011,91,01011011,118,01110110
22,00010110,12,00001100,34,00100010
77,01001101,37,00100101,114,01110010
86,01010110,34,00100010,120,01111000
85,01010101,39,00100111,124,01111100
117,01110101,119,01110111,236,11101100
114,01110010,61,00111101,175,10101111
122,01111010,22,00010110,144,10010000
92,01011100,89,01011001,181,10110101
2,00000010,92,01011100,94,01011110
60,00111100,73,01001001,133,10000101
57,00111001,126,01111110,183,10110111
16,00010000,115,01110011,131,10000011
112,01110000,42,00101010,154,10011010
39,00100111,124,01111100,163,10100011
22,00010110,31,00011111,53,00110101
14,00001110,127,01111111,141,10001101
120,01111000,89,01011001,209,11010001
23,00010111,119,01110111,142,10001110
0,00000000,100,01100100,100,01100100
60,00111100,87,01010111,147,10010011
51,00110011,38,00100110,89,01011001
82,01010010,3,00000011,85,01010101
110,01101110,117,01110101,227,11100011
57,00111001,66,01000010,123,01111011
13,00001101,14,00001110,27,00011011
100,01100100,119,01110111,219,11011011
104,01101000,52,00110100,156,10011100
110,01101110,57,00111001,167,10100111
101,01100101,17,00010001,118,01110110
5,00000101,106,01101010,111,01101111
23,00010111,37,00100101,60,00111100
54,00110110,64,01000000,118,01110110
31,00011111,38,00100110,69,01000101
27,00011011,115,01110011,142,10001110
109,01101101,123,01111011,232,11101000
111,01101111,52,00110100,163,10100011
78,01001110,94,01011110,172,10101100
6,00000110,39,00100111,45,00101101
39,00100111,54,00110110,93,01011101
41,00101001,36,00100100,77,01001101
78,01001110,97,01100001,175,10101111
78,01001110,43,00101011,121,01111001
29,00011101,84,01010100,113,01110001
97,01100001,93,01011101,190,10111110
73,01001001,106,01101010,179,10110011
23,00010111,102,01100110,125,01111101
40,00101000,126,01111110,166,10100110
14,00001110,95,01011111,109,01101101
87,01010111,26,00011010,113,01110001
82,01010010,19,00010011,101,01100101
86,01010110,70,01000110,156,10011100
4,00000100,76,01001100,80,01010000
95,01011111,60,00111100,155,10011011
106,01101010,39,00100111,145,10010001
8,00001000,5,00000101,13,00001101
29,00011101,55,00110111,84,01010100
42,00101010,45,00101101,87,01010111
103,01100111,67,01000011,170,10101010
48,00110000,53,00110101,101,01100101
92,01011100,9,00001001,101,01100101
62,00111110,46,00101110,108,01101100
39,00100111,6,00000110,45,00101101
46,00101110,4,00000100,50,00110010
8,00001000,122,01111010,130,10000010
17,00010001,120,01111000,137,10001001
38,00100110,47,00101111,85,01010101
14,00001110,86,01010110,100,01100100
75,01001011,12,00001100,87,01010111
78,01001110,56,00111000,134,10000110
91,01011011,71,01000111,162,10100010
28,00011100,99,01100011,127,01111111
10,00001010,33,00100001,43,00101011
90,01011010,113,01110001,203,11001011
95,01011111,87,01010111,182,10110110
17,00010001,63,00111111,80,01010000
109,01101101,120,01111000,229,11100101
29,00011101,19,00010011,48,00110000
38,00100110,98,01100010,136,10001000
5,00000101,96,01100000,101,01100101
64,01000000,28,00011100,92,01011100
4,00000100,65,01000001,69,01000101
85,01010101,27,00011011,112,01110000
26,00011010,15,00001111,41,00101001
77,01001101,65,01000001,142,10001110
87,01010111,14,00001110,101,01100101
88,01011000,89,01011001,177,10110001
123,01111011,26,00011010,149,10010101
36,00100100,18,00010010,54,00110110
88,01011000,105,01101001,193,11000001
29,00011101,67,01000011,96,01100000
51,00110011,117,01110101,168,10101000
19,00010011,112,01110000,131,10000011
52,00110100,82,01010010,134,10000110
30,00011110,68,01000100,98,01100010
7,00000111,81,01010001,88,01011000
12,00001100,104,01101000,116,01110100
32,00100000,60,00111100,92,01011100
6,00000110,55,00110111,61,00111101
102,01100110,62,00111110,164,10100100
125,01111101,68,01000100,193,11000001
56,00111000,41,00101001,97,01100001
110,01101110,5,00000101,115,01110011
64,01000000,127,01111111,191,10111111
15,00001111,90,01011010,105,01101001
121,01111001,34,00100010,155,10011011
66,01000010,32,00100000,98,01100010
42,00101010,57,00111001,99,01100011
65,01000001,87,01010111,152,10011000
78,01001110,87,01010111,165,10100101
25,00011001,32,00100000,57,00111001
26,00011010,68,01000100,94,01011110
76,01001100,21,00010101,97,01100001
79,01001111,62,00111110,141,10001101
114,01110010,60,00111100,174,10101110
13,00001101,87,01010111,100,01100100
97,01100001,56,00111000,153,10011001
67,01000011,105,01101001,172,10101100
95,01011111,23,00010111,118,01110110
4,00000100,48,00110000,52,00110100
6,00000110,39,00100111,45,00101101
46,00101110,108,01101100,154,10011010
125,01111101,94,01011110,219,11011011
68,01000100,56,00111000,124,01111100
36,00100100,88,01011000,124,01111100
17,00010001,13,00001101,30,00011110
123,01111011,84,01010100,207,11001111
12,00001100,15,00001111,27,00011011
91,01011011,110,01101110,201,11001001
30,00011110,101,01100101,131,10000011
18,00010010,111,01101111,129,10000001
57,00111001,14,00001110,71,01000111
98,01100010,122,01111010,220,11011100
123,01111011,85,01010101,208,11010000
74,01001010,104,01101000,178,10110010
4,00000100,3,00000011,7,00000111
65,01000001,4,00000100,69,01000101
88,01011000,46,00101110,134,10000110
90,01011010,29,00011101,119,01110111
52,00110100,34,00100010,86,01010110
8,00001000,58,00111010,66,01000010
85,01010101,5,00000101,90,01011010
50,00110010,47,00101111,97,01100001
125,01111101,89,01011001,214,11010110
10,00001010,24,00011000,34,00100010
98,01100010,110,01101110,208,11010000
106,01101010,121,01111001,227,11100011
43,00101011,59,00111011,102,01100110
96,01100000,41,00101001,137,10001001
114,01110010,79,01001111,193,11000001
39,00100111,62,00111110,101,01100101
63,00111111,58,00111010,121,01111001
10,00001010,120,01111000,130,10000010
38,00100110,106,01101010,144,10010000
49,00110001,64,01000000,113,01110001
12,00001100,69,01000101,81,01010001
13,00001101,70,01000110,83,01010011
26,00011010,97,01100001,123,01111011
28,00011100,11,00001011,39,00100111
67,01000011,41,00101001,108,01101100
101,01100101,61,00111101,162,10100010
70,01000110,71,01000111,141,10001101
105,01101001,50,00110010,155,10011011
111,01101111,75,01001011,186,10111010
21,00010101,58,00111010,79,01001111
27,00011011,4,00000100,31,00011111
87,01010111,126,01111110,213,11010101
108,01101100,82,01010010,190,10111110
119,01110111,41,00101001,160,10100000
75,01001011,52,00110100,127,01111111
93,01011101,58,00111010,151,10010111
2,00000010,41,00101001,43,00101011
27,00011011,118,01110110,145,10010001
101,01100101,88,01011000,189,10111101
61,00111101,1,00000001,62,00111110
83,01010011,0,00000000,83,01010011
24,00011000,66,01000010,90,01011010
90,01011010,42,00101010,132,10000100
28,00011100,23,00010111,51,00110011
119,01110111,24,00011000,143,10001111
57,00111001,23,00010111,80,01010000
2,00000010,45,00101101,47,00101111
93,01011101,34,00100010,127,01111111
75,01001011,24,00011000,99,01100011
52,00110100,69,01000101,121,01111001
68,01000100,25,00011001,93,01011101
119,01110111,18,00010010,137,10001001
83,01010011,75,01001011,158,10011110
112,01110000,54,00110110,166,10100110
99,01100011,8,00001000,107,01101011
31,00011111,108,01101100,139,10001011
73,01001001,64,01000000,137,10001001
12,00001100,112,01110000,124,01111100
9,00001001,100,01100100,109,01101101
8,00001000,88,01011000,96,01100000
45,00101101,84,01010100,129,10000001
21,00010101,69,01000101,90,01011010
78,01001110,9,00001001,87,01010111
68,01000100,119,01110111,187,10111011
22,00010110,6,00000110,28,00011100
97,01100001,30,00011110,127,01111111
75,01001011,83,01010011,158,10011110
29,00011101,32,00100000,61,00111101
70,01000110,104,01101000,174,10101110
23,00010111,117,01110101,140,10001100
4,00000100,5,00000101,9,00001001
87,01010111,45,00101101,132,10000100
42,00101010,103,01100111,145,10010001
105,01101001,77,01001101,182,10110110
51,00110011,71,01000111,122,01111010
7,00000111,94,01011110,101,01100101
27,00011011,7,00000111,34,00100010
64,01000000,68,01000100,132,10000100
125,01111101,110,01101110,235,11101011
120,01111000,114,01110010,234,11101010
76,01001100,0,00000000,76,01001100
109,01101101,75,01001011,184,10111000
9,00001001,36,00100100,45,00101101
31,00011111,49,00110001,80,01010000
12,00001100,29,00011101,41,00101001
17,00010001,44,00101100,61,00111101
98,01100010,79,01001111,177,10110001
6,00000110,111,01101111,117,01110101
33,00100001,70,01000110,103,01100111
15,00001111,3,00000011,18,00010010
120,01111000,94,01011110,214,11010110
71,01000111,112,01110000,183,10110111
72,01001000,36,00100100,108,01101100
98,01100010,79,01001111,177,10110001
57,00111001,0,00000000,57,00111001
71,01000111,97,01100001,168,10101000
78,01001110,16,00010000,94,01011110
2,00000010,57,00111001,59,00111011
93,01011101,5,00000101,98,01100010
78,01001110,115,01110011,193,11000001
1,00000001,104,01101000,105,01101001
0,00000000,31,00011111,31,00011111
89,01011001,101,01100101,190,10111110
37,00100101,82,01010010,119,01110111
102,01100110,18,00010010,120,01111000
124,01111100,46,00101110,170,10101010
116,01110100,70,01000110,186,10111010
41,00101001,114,01110010,155,10011011
56,00111000,106,01101010,162,10100010
95,01011111,9,00001001,104,01101000
1,00000001,69,01000101,70,01000110
59,00111011,81,01010001,140,10001100
25,00011001,78,01001110,103,01100111
127,01111111,123,01111011,250,11111010
104,01101000,114,01110010,218,11011010
98,01100010,111,01101111,209,11010001
19,00010011,114,01110010,133,10000101
14,00001110,127,01111111,141,10001101
20,00010100,14,00001110,34,00100010
39,00100111,6,00000110,45,00101101
111,01101111,21,00010101,132,10000100
42,00101010,103,01100111,145,10010001
74,01001010,48,00110000,122,01111010
67,01000011,94,01011110,161,10100001
48,00110000,103,01100111,151,10010111
117,01110101,71,01000111,188,10111100
75,01001011,77,01001101,152,10011000
42,00101010,80,01010000,122,01111010
61,00111101,95,01011111,156,10011100
119,01110111,86,01010110,205,11001101
57,00111001,94,01011110,151,10010111
56,00111000,38,00100110,94,01011110
120,01111000,10,00001010,130,10000010
40,00101000,95,01011111,135,10000111
65,01000001,115,01110011,180,10110100
54,00110110,45,00101101,99,01100011
112,01110000,16,00010000,128,10000000
52,00110100,88,01011000,140,10001100
109,01101101,46,00101110,155,10011011
89,01011001,69,01000101,158,10011110
90,01011010,45,00101101,135,10000111
55,00110111,49,00110001,104,01101000
8,00001000,47,00101111,55,00110111
65,01000001,20,00010100,85,01010101
33,00100001,76,01001100,109,01101101
99,01100011,87,01010111,186,10111010
29,00011101,78,01001110,107,01101011
62,00111110,66,01000010,128,10000000
36,00100100,17,00010001,53,00110101
102,01100110,123,01111011,225,11100001
20,00010100,48,00110000,68,01000100
88,01011000,23,00010111,111,01101111
5,00000101,80,01010000,85,01010101
123,01111011,71,01000111,194,11000010
118,01110110,87,01010111,205,11001101
70,01000110,95,01011111,165,10100101
95,01011111,104,01101000,199,11000111
60,00111100,106,01101010,166,10100110
54,00110110,59,00111011,113,01110001
122,01111010,13,00001101,135,10000111
78,01001110,18,00010010,96,01100000
106,01101010,54,00110110,160,10100000
84,01010100,58,00111010,142,10001110
34,00100010,42,00101010,76,01001100
45,00101101,37,00100101,82,01010010
43,00101011,122,01111010,165,10100101
95,01011111,35,00100011,130,10000010
88,01011000,50,00110010,138,10001010
122,01111010,5,00000101,127,01111111
92,01011100,103,01100111,195,11000011
118,01110110,76,01001100,194,11000010
102,01100110,100,01100100,202,11001010
85,01010101,6,00000110,91,01011011
124,01111100,28,00011100,152,10011000
8,00001000,78,01001110,86,01010110
102,01100110,49,00110001,151,10010111
92,01011100,88,01011000,180,10110100
49,00110001,57,00111001,106,01101010
48,00110000,12,00001100,60,00111100
107,01101011,65,01000001,172,10101100
87,01010111,8,00001000,95,01011111
49,00110001,40,00101000,89,01011001
20,00010100,119,01110111,139,10001011
93,01011101,104,01101000,197,11000101
67,01000011,55,00110111,122,01111010
95,01011111,29,00011101,124,01111100
115,01110011,58,00111010,173,10101101
103,01100111,93,01011101,196,11000100
94,01011110,124,01111100,218,11011010
25,00011001,76,01001100,101,01100101
5,00000101,123,01111011,128,10000000
96,01100000,112,01110000,208,11010000
122,01111010,114,01110010,236,11101100
46,00101110,64,01000000,110,01101110
58,00111010,123,01111011,181,10110101
120,01111000,41,00101001,161,10100001
30,00011110,74,01001010,104,01101000
118,01110110,60,00111100,178,10110010
44,00101100,72,01001000,116,01110100
79,01001111,91,01011011,170,10101010
48,00110000,18,00010010,66,01000010
71,01000111,0,00000000,71,01000111
75,01001011,61,00111101,136,10001000
95,01011111,13,00001101,108,01101100
7,00000111,11,00001011,18,00010010
117,01110101,6,00000110,123,01111011
13,00001101,119,01110111,132,10000100
111,01101111,68,01000100,179,10110011
96,01100000,123,01111011,219,11011011
41,00101001,79,01001111,120,01111000
121,01111001,25,00011001,146,10010010
103,01100111,91,01011011,194,11000010
55,00110111,95,01011111,150,10010110
117,01110101,83,01010011,200,11001000
7,00000111,72,01001000,79,01001111
94,01011110,99,01100011,193,11000001
40,00101000,89,01011001,129,10000001
115,01110011,93,01011101,208,11010000
126,01111110,27,00011011,153,10011001
19,00010011,52,00110100,71,01000111
62,00111110,106,01101010,168,10101000
49,00110001,75,01001011,124,01111100
16,00010000,120,01111000,136,10001000
110,01101110,106,01101010,216,11011000
83,01010011,61,00111101,144,10010000
53,00110101,102,01100110,155,10011011
67,01000011,24,00011000,91,01011011
80,01010000,67,01000011,147,10010011
52,00110100,20,00010100,72,01001000
58,00111010,8,00001000,66,01000010
58,00111010,73,01001001,131,10000011
126,01111110,13,00001101,139,10001011
2,00000010,112,01110000,114,01110010
50,00110010,69,01000101,119,01110111
113,01110001,86,01010110,199,11000111
62,00111110,94,01011110,156,10011100
71,01000111,17,00010001,88,01011000
3,00000011,67,01000011,70,01000110
46,00101110,111,01101111,157,10011101
45,00101101,4,00000100,49,00110001
20,00010100,45,00101101,65,01000001
72,01001000,49,00110001,121,01111001
35,00100011,51,00110011,86,01010110
9,00001001,41,00101001,50,00110010
83,01010011,1,00000001,84,01010100
94,01011110,82,01010010,176,10110000
95,01011111,16,00010000,111,01101111
20,00010100,0,00000000,20,00010100
38,00100110,63,00111111,101,01100101
42,00101010,118,01110110,160,10100000
53,00110101,29,00011101,82,01010010
94,01011110,1,00000001,95,01011111
96,01100000,57,00111001,153,10011001
83,01010011,16,00010000,99,01100011
94,01011110,67,01000011,161,10100001
124,01111100,45,00101101,169,10101001
107,01101011,97,01100001,204,11001100
69,01000101,121,01111001,190,10111110
59,00111011,58,00111010,117,01110101
55,00110111,93,01011101,148,10010100
80,01010000,91,01011011,171,10101011
15,00001111,27,00011011,42,00101010
94,01011110,104,01101000,198,11000110
79,01001111,120,01111000,199,11000111
109,01101101,72,01001000,181,10110101
54,00110110,9,00001001,63,00111111
86,01010110,52,00110100,138,10001010
10,00001010,37,00100101,47,00101111
16,00010000,111,01101111,127,01111111
107,01101011,109,01101101,216,11011000
19,00010011,27,00011011,46,00101110
57,00111001,60,00111100,117,01110101
59,00111011,12,00001100,71,01000111
76,01001100,82,01010010,158,10011110
72,01001000,71,01000111,143,10001111
80,01010000,88,01011000,168,10101000
18,00010010,108,01101100,126,01111110
29,00011101,108,01101100,137,10001001
109,01101101,20,00010100,129,10000001
101,01100101,107,01101011,208,11010000
120,01111000,2,00000010,122,01111010
49,00110001,53,00110101,102,01100110
24,00011000,112,01110000,136,10001000
108,01101100,9,00001001,117,01110101
98,01100010,57,00111001,155,10011011
32,00100000,71,01000111,103,01100111
71,01000111,118,01110110,189,10111101
6,00000110,11,00001011,17,00010001
47,00101111,82,01010010,129,10000001
52,00110100,54,00110110,106,01101010
113,01110001,0,00000000,113,01110001
71,01000111,100,01100100,171,10101011
97,01100001,33,00100001,130,10000010
109,01101101,21,00010101,130,10000010
46,00101110,32,00100000,78,01001110
41,00101001,118,01110110,159,10011111
113,01110001,84,01010100,197,11000101
17,00010001,71,01000111,88,01011000
39,00100111,31,00011111,70,01000110
93,01011101,112,01110000,205,11001101
105,01101001,18,00010010,123,01111011
23,00010111,11,00001011,34,00100010
0,00000000,67,01000011,67,01000011
26,00011010,109,01101101,135,10000111
125,01111101,61,00111101,186,10111010
91,01011011,13,00001101,104,01101000
24,00011000,82,01010010,106,01101010
127,01111111,100,01100100,227,11100011
63,00111111,89,01011001,152,10011000
105,01101001,122,01111010,227,11100011
42,00101010,92,01011100,134,10000110
80,01010000,114,01110010,194,11000010
6,00000110,125,01111101,131,10000011
122,01111010,16,00010000,138,10001010
28,00011100,119,01110111,147,10010011
7,00000111,18,00010010,25,00011001
116,01110100,62,00111110,178,10110010
14,00001110,98,01100010,112,01110000
57,00111001,42,00101010,99,01100011
48,00110000,57,00111001,105,01101001
35,00100011,39,00100111,74,01001010
112,01110000,57,00111001,169,10101001
12,00001100,115,01110011,127,01111111
103,01100111,96,01100000,199,11000111
51,00110011,46,00101110,97,01100001
37,00100101,37,00100101,74,01001010
84,01010100,35,00100011,119,01110111
38,00100110,110,01101110,148,10010100
5,00000101,70,01000110,75,01001011
104,01101000,49,00110001,153,10011001
85,01010101,45,00101101,130,10000010
65,01000001,79,01001111,144,10010000
25,00011001,28,00011100,53,00110101
59,00111011,89,01011001,148,10010100
125,01111101,106,01101010,231,11100111
106,01101010,114,01110010,220,11011100
78,01001110,51,00110011,129,10000001
64,01000000,27,00011011,91,01011011
44,00101100,24,00011000,68,01000100
12,00001100,53,00110101,65,01000001
0,00000000,60,00111100,60,00111100
102,01100110,27,00011011,129,10000001
117,01110101,7,00000111,124,01111100
95,01011111,93,01011101,188,10111100
31,00011111,17,00010001,48,00110000
99,01100011,25,00011001,124,01111100
113,01110001,3,00000011,116,01110100
19,00010011,70,01000110,89,01011001
14,00001110,58,00111010,72,01001000
120,01111000,101,01100101,221,11011101
45,00101101,85,01010101,130,10000010
127,01111111,92,01011100,219,11011011
80,01010000,61,00111101,141,10001101
3,00000011,37,00100101,40,00101000
29,00011101,62,00111110,91,01011011
18,00010010,1,00000001,19,00010011
120,01111000,23,00010111,143,10001111
52,00110100,13,00001101,65,01000001
5,00000101,40,00101000,45,00101101
2,00000010,101,01100101,103,01100111
20,00010100,54,00110110,74,01001010
68,01000100,35,00100011,103,01100111
113,01110001,97,01100001,210,11010010
87,01010111,3,00000011,90,01011010
111,01101111,67,01000011,178,10110010
111,01101111,60,00111100,171,10101011
79,01001111,94,01011110,173,10101101
10,00001010,85,01010101,95,01011111
41,00101001,126,01111110,167,10100111
65,01000001,109,01101101,174,10101110
46,00101110,119,01110111,165,10100101
73,01001001,59,00111011,132,10000100
84,01010100,88,01011000,172,10101100
104,01101000,6,00000110,110,01101110
31,00011111,74,01001010,105,01101001
75,01001011,42,00101010,117,01110101
116,01110100,33,00100001,149,10010101
116,01110100,46,00101110,162,10100010
44,00101100,113,01110001,157,10011101
29,00011101,20,00010100,49,00110001
62,00111110,59,00111011,121,01111001
19,00010011,7,00000111,26,00011010
11,00001011,0,00000000,11,00001011
119,01110111,44,00101100,163,10100011
83,01010011,89,01011001,172,10101100
95,01011111,97,01100001,192,11000000
5,00000101,106,01101010,111,01101111
51,00110011,4,00000100,55,00110111
95,01011111,65,01000001,160,10100000
37,00100101,53,00110101,90,01011010
93,01011101,91,01011011,184,10111000
4,00000100,115,01110011,119,01110111
114,01110010,78,01001110,192,11000000
77,01001101,59,00111011,136,10001000
104,01101000,76,01001100,180,10110100
103,01100111,89,01011001,192,11000000
59,00111011,0,00000000,59,00111011
62,00111110,28,00011100,90,01011010
57,00111001,85,01010101,142,10001110
124,01111100,85,01010101,209,11010001
25,00011001,96,01100000,121,01111001
10,00001010,80,01010000,90,01011010
22,00010110,60,00111100,82,01010010
38,00100110,64,01000000,102,01100110
81,01010001,17,00010001,98,01100010
47,00101111,17,00010001,64,01000000
101,01100101,104,01101000,205,11001101
75,01001011,45,00101101,120,01111000
88,01011000,42,00101010,130,10000010
14,00001110,112,01110000,126,01111110
11,00001011,100,01100100,111,01101111
68,01000100,97,01100001,165,10100101
64,01000000,116,01110100,180,10110100
118,01110110,40,00101000,158,10011110
83,01010011,74,01001010,157,10011101
9,00001001,73,01001001,82,01010010
4,00000100,83,01010011,87,01010111
93,01011101,105,01101001,198,11000110
101,01100101,79,01001111,180,10110100
126,01111110,116,01110100,242,11110010
103,01100111,112,01110000,215,11010111
70,01000110,36,00100100,106,01101010
41,00101001,77,01001101,118,01110110
74,01001010,16,00010000,90,01011010
33,00100001,60,00111100,93,01011101
74,01001010,53,00110101,127,01111111
1,00000001,2,00000010,3,00000011
42,00101010,127,01111111,169,10101001
52,00110100,36,00100100,88,01011000
108,01101100,65,01000001,173,10101101
95,01011111,52,00110100,147,10010011
57,00111001,41,00101001,98,01100010
88,01011000,94,01011110,182,10110110
90,01011010,100,01100100,190,10111110
81,01010001,4,00000100,85,01010101
100,01100100,58,00111010,158,10011110
46,00101110,25,00011001,71,01000111
62,00111110,74,01001010,136,10001000
21,00010101,123,01111011,144,10010000
117,01110101,25,00011001,142,10001110
29,00011101,76,01001100,105,01101001
55,00110111,89,01011001,144,10010000
23,00010111,125,01111101,148,10010100
35,00100011,58,00111010,93,01011101
16,00010000,86,01010110,102,01100110
33,00100001,100,01100100,133,10000101
24,00011000,63,00111111,87,01010111
23,00010111,100,01100100,123,01111011
114,01110010,58,00111010,172,10101100
18,00010010,112,01110000,130,10000010
5,00000101,83,01010011,88,01011000
52,00110100,97,01100001,149,10010101
15,00001111,27,00011011,42,00101010
44,00101100,20,00010100,64,01000000
72,01001000,19,00010011,91,01011011
97,01100001,118,01110110,215,11010111
54,00110110,63,00111111,117,01110101
30,00011110,59,00111011,89,01011001
87,01010111,77,01001101,164,10100100
6,00000110,20,00010100,26,00011010
57,00111001,51,00110011,108,01101100
91,01011011,0,00000000,91,01011011
103,01100111,99,01100011,202,11001010
48,00110000,32,00100000,80,01010000
120,01111000,101,01100101,221,11011101
43,00101011,28,00011100,71,01000111
109,01101101,58,00111010,167,10100111
96,01100000,3,00000011,99,01100011
98,01100010,97,01100001,195,11000011
106,01101010,74,01001010,180,10110100
119,01110111,92,01011100,211,11010011
5,00000101,26,00011010,31,00011111
19,00010011,46,00101110,65,01000001
18,00010010,110,01101110,128,10000000
69,01000101,79,01001111,148,10010100
15,00001111,86,01010110,101,01100101
5,00000101,17,00010001,22,00010110
12,00001100,52,00110100,64,01000000
39,00100111,41,00101001,80,01010000
53,00110101,34,00100010,87,01010111
43,00101011,55,00110111,98,01100010
87,01010111,94,01011110,181,10110101
80,01010000,57,00111001,137,10001001
29,00011101,58,00111010,87,01010111
97,01100001,60,00111100,157,10011101
53,00110101,94,01011110,147,10010011
19,00010011,66,01000010,85,01010101
102,01100110,60,00111100,162,10100010
76,01001100,28,00011100,104,01101000
55,00110111,68,01000100,123,01111011
32,00100000,83,01010011,115,01110011
113,01110001,96,01100000,209,11010001
6,00000110,54,00110110,60,00111100
69,01000101,109,01101101,178,10110010
65,01000001,47,00101111,112,01110000
36,00100100,54,00110110,90,01011010
49,00110001,48,00110000,97,01100001
69,01000101,35,00100011,104,01101000
109,01101101,4,00000100,113,01110001
117,01110101,81,01010001,198,11000110
127,01111111,68,01000100,195,11000011
46,00101110,69,01000101,115,01110011
22,00010110,79,01001111,101,01100101
116,01110100,26,00011010,142,10001110
74,01001010,42,00101010,116,01110100
127,01111111,87,01010111,214,11010110
19,00010011,67,01000011,86,01010110
32,00100000,59,00111011,91,01011011
68,01000100,52,00110100,120,01111000
80,01010000,41,00101001,121,01111001
17,00010001,74,01001010,91,01011011
1,00000001,118,01110110,119,01110111
103,01100111,78,01001110,181,10110101
55,00110111,114,01110010,169,10101001
81,01010001,125,01111101,206,11001110
62,00111110,15,00001111,77,01001101
49,00110001,75,01001011,124,01111100
96,01100000,13,00001101,109,01101101
28,00011100,118,01110110,146,10010010
106,01101010,93,01011101,199,11000111
52,00110100,127,01111111,179,10110011
73,01001001,22,00010110,95,01011111
76,01001100,37,00100101,113,01110001
97,01100001,5,00000101,102,01100110
30,00011110,22,00010110,52,00110100
72,01001000,113,01110001,185,10111001
119,01110111,94,01011110,213,11010101
72,01001000,109,01101101,181,10110101
22,00010110,79,01001111,101,01100101
6,00000110,5,00000101,11,00001011
102,01100110,88,01011000,190,10111110
20,00010100,90,01011010,110,01101110
9,00001001,77,01001101,86,01010110
4,00000100,52,00110100,56,00111000
63,00111111,87,01010111,150,10010110
1,00000001,98,01100010,99,01100011
43,00101011,47,00101111,90,01011010
54,00110110,60,00111100,114,01110010
50,00110010,115,01110011,165,10100101
120,01111000,89,01011001,209,11010001
55,00110111,67,01000011,122,01111010
75,01001011,120,01111000,195,11000011
93,01011101,105,01101001,198,11000110
126,01111110,61,00111101,187,10111011
58,00111010,32,00100000,90,01011010
70,01000110,119,01110111,189,10111101
123,01111011,74,01001010,197,11000101
20,00010100,78,01001110,98,01100010
122,01111010,44,00101100,166,10100110
26,00011010,9,00001001,35,00100011
11,00001011,56,00111000,67,01000011
108,01101100,110,01101110,218,11011010
19,00010011,72,01001000,91,01011011
18,00010010,84,01010100,102,01100110
84,01010100,19,00010011,103,01100111
78,01001110,97,01100001,175,10101111
102,01100110,78,01001110,180,10110100
28,00011100,53,00110101,81,01010001
75,01001011,31,00011111,106,01101010
75,01001011,76,01001100,151,10010111
25,00011001,14,00001110,39,00100111
4,00000100,38,00100110,42,00101010
2,00000010,2,00000010,4,00000100
21,00010101,0,00000000,21,00010101
126,01111110,100,01100100,226,11100010
62,00111110,88,01011000,150,10010110
93,01011101,60,00111100,153,10011001
59,00111011,51,00110011,110,01101110
18,00010010,41,00101001,59,00111011
6,00000110,47,00101111,53,00110101
78,01001110,84,01010100,162,10100010
26,00011010,76,01001100,102,01100110
14,00001110,63,00111111,77,01001101
22,00010110,59,00111011,81,01010001
101,01100101,117,01110101,218,11011010
33,00100001,123,01111011,156,10011100
6,00000110,56,00111000,62,00111110
77,01001101,84,01010100,161,10100001
114,01110010,48,00110000,162,10100010
8,00001000,9,00001001,17,00010001
69,01000101,17,00010001,86,01010110
92,01011100,66,01000010,158,10011110
67,01000011,56,00111000,123,01111011
70,01000110,55,00110111,125,01111101
50,00110010,35,00100011,85,01010101
112,01110000,83,01010011,195,11000011
70,01000110,119,01110111,189,10111101
6,00000110,51,00110011,57,00111001
14,00001110,98,01100010,112,01110000
45,00101101,33,00100001,78,01001110
13,00001101,55,00110111,68,01000100
34,00100010,34,00100010,68,01000100
79,01001111,74,01001010,153,10011001
0,00000000,106,01101010,106,01101010
50,00110010,5,00000101,55,00110111
65,01000001,77,01001101,142,10001110
32,00100000,48,00110000,80,01010000
68,01000100,90,01011010,158,10011110
18,00010010,5,00000101,23,00010111
126,01111110,42,00101010,168,10101000
117,01110101,120,01111000,237,11101101
72,01001000,52,00110100,124,01111100
54,00110110,73,01001001,127,01111111
47,00101111,109,01101101,156,10011100
58,00111010,31,00011111,89,01011001
3,00000011,116,01110100,119,01110111
83,01010011,93,01011101,176,10110000
25,00011001,28,00011100,53,00110101
59,00111011,93,01011101,152,10011000
57,00111001,26,00011010,83,01010011
84,01010100,112,01110000,196,11000100
112,01110000,27,00011011,139,10001011
123,01111011,91,01011011,214,11010110
49,00110001,42,00101010,91,01011011
77,01001101,19,00010011,96,01100000
108,01101100,19,00010011,127,01111111
126,01111110,35,00100011,161,10100001
113,01110001,81,01010001,194,11000010
12,00001100,0,00000000,12,00001100
97,01100001,73,01001001,170,10101010
75,01001011,71,01000111,146,10010010
123,01111011,79,01001111,202,11001010
57,00111001,46,00101110,103,01100111
85,01010101,58,00111010,143,10001111
115,01110011,36,00100100,151,10010111
35,00100011,118,01110110,153,10011001
58,00111010,102,01100110,160,10100000
74,01001010,64,01000000,138,10001010
33,00100001,24,00011000,57,00111001
126,01111110,44,00101100,170,10101010
17,00010001,24,00011000,41,00101001
86,01010110,2,00000010,88,01011000
12,00001100,9,00001001,21,00010101
61,00111101,121,01111001,182,10110110
10,00001010,74,01001010,84,01010100
33,00100001,101,01100101,134,10000110
41,00101001,15,00001111,56,00111000
71,01000111,39,00100111,110,01101110
35,00100011,57,00111001,92,01011100
4,00000100,117,01110101,121,01111001
83,01010011,57,00111001,140,10001100
121,01111001,54,00110110,175,10101111
94,01011110,6,00000110,100,01100100
84,01010100,101,01100101,185,10111001
25,00011001,42,00101010,67,01000011
119,01110111,28,00011100,147,10010011
28,00011100,5,00000101,33,00100001
15,00001111,111,01101111,126,01111110
43,00101011,68,01000100,111,01101111
116,01110100,2,00000010,118,01110110
20,00010100,107,01101011,127,01111111
41,00101001,64,01000000,105,01101001
78,01001110,56,00111000,134,10000110
21,00010101,122,01111010,143,10001111
17,00010001,41,00101001,58,00111010
70,01000110,102,01100110,172,10101100
9,00001001,78,01001110,87,01010111
27,00011011,29,00011101,56,00111000
78,01001110,14,00001110,92,01011100
4,00000100,98,01100010,102,01100110
57,00111001,15,00001111,72,01001000
80,01010000,0,00000000,80,01010000
56,00111000,41,00101001,97,01100001
76,01001100,56,00111000,132,10000100
0,00000000,14,00001110,14,00001110
45,00101101,79,01001111,124,01111100
61,00111101,31,00011111,92,01011100
116,01110100,25,00011001,141,10001101
106,01101010,52,00110100,158,10011110
1,00000001,77,01001101,78,01001110
5,00000101,43,00101011,48,00110000
63,00111111,29,00011101,92,01011100
37,00100101,99,01100011,136,10001000
110,01101110,15,00001111,125,01111101
120,01111000,85,01010101,205,11001101
101,01100101,47,00101111,148,10010100
18,00010010,110,01101110,128,10000000
46,00101110,113,01110001,159,10011111
114,01110010,34,00100010,148,10010100
117,01110101,12,00001100,129,10000001
2,00000010,56,00111000,58,00111010
120,01111000,26,00011010,146,10010010
62,00111110,74,01001010,136,10001000
105,01101001,26,00011010,131,10000011
40,00101000,72,01001000,112,01110000
91,01011011,85,01010101,176,10110000
2,00000010,55,00110111,57,00111001
121,01111001,11,00001011,132,10000100
75,01001011,75,01001011,150,10010110
99,01100011,32,00100000,131,10000011
28,00011100,115,01110011,143,10001111
117,01110101,65,01000001,182,10110110
110,01101110,116,01110100,226,11100010
40,00101000,127,01111111,167,10100111
114,01110010,85,01010101,199,11000111
84,01010100,77,01001101,161,10100001
91,01011011,86,01010110,177,10110001
70,01000110,12,00001100,82,01010010
30,00011110,60,00111100,90,01011010
82,01010010,65,01000001,147,10010011
3,00000011,4,00000100,7,00000111
92,01011100,73,01001001,165,10100101
43,00101011,20,00010100,63,00111111
19,00010011,2,00000010,21,00010101
36,00100100,52,00110100,88,01011000
88,01011000,102,01100110,190,10111110
42,00101010,108,01101100,150,10010110
6,00000110,40,00101000,46,00101110
62,00111110,14,00001110,76,01001100
58,00111010,96,01100000,154,10011010
112,01110000,107,01101011,219,11011011
3,00000011,28,00011100,31,00011111
102,01100110,109,01101101,211,11010011
40,00101000,122,01111010,162,10100010
73,01001001,33,00100001,106,01101010
65,01000001,69,01000101,134,10000110
70,01000110,100,01100100,170,10101010
33,00100001,94,01011110,127,01111111
101,01100101,72,01001000,173,10101101
63,00111111,25,00011001,88,01011000
110,01101110,36,00100100,146,10010010
123,01111011,113,01110001,236,11101100
95,01011111,94,01011110,189,10111101
101,01100101,65,01000001,166,10100110
7,00000111,50,00110010,57,00111001
82,01010010,103,01100111,185,10111001
9,00001001,107,01101011,116,01110100
75,01001011,38,00100110,113,01110001
5,00000101,53,00110101,58,00111010
10,00001010,25,00011001,35,00100011
105,01101001,42,00101010,147,10010011
49,00110001,0,00000000,49,00110001
90,01011010,51,00110011,141,10001101
28,00011100,120,01111000,148,10010100
1,00000001,117,01110101,118,01110110
126,01111110,107,01101011,233,11101001
127,01111111,12,00001100,139,10001011
119,01110111,41,00101001,160,10100000
54,00110110,1,00000001,55,00110111
39,00100111,127,01111111,166,10100110
45,00101101,100,01100100,145,10010001
72,01001000,4,00000100,76,01001100
78,01001110,40,00101000,118,01110110
48,00110000,118,01110110,166,10100110
19,00010011,107,01101011,126,01111110
107,01101011,8,00001000,115,01110011
29,00011101,49,00110001,78,01001110
54,00110110,10,00001010,64,01000000
24,00011000,102,01100110,126,01111110
35,00100011,67,01000011,102,01100110
51,00110011,29,00011101,80,01010000
63,00111111,113,01110001,176,10110000
45,00101101,66,01000010,111,01101111
49,00110001,51,00110011,100,01100100
45,00101101,43,00101011,88,01011000
53,00110101,63,00111111,116,01110100
87,01010111,9,00001001,96,01100000
110,01101110,22,00010110,132,10000100
6,00000110,90,01011010,96,01100000
76,01001100,45,00101101,121,01111001
98,01100010,100,01100100,198,11000110
34,00100010,36,00100100,70,01000110
107,01101011,61,00111101,168,10101000
58,00111010,38,00100110,96,01100000
114,01110010,49,00110001,163,10100011
7,00000111,80,01010000,87,01010111
21,00010101,111,01101111,132,10000100
44,00101100,16,00010000,60,00111100
20,00010100,20,00010100,40,00101000
75,01001011,87,01010111,162,10100010
100,01100100,34,00100010,134,10000110
69,01000101,104,01101000,173,10101101
32,00100000,3,00000011,35,00100011
121,01111001,50,00110010,171,10101011
77,01001101,121,01111001,198,11000110
58,00111010,117,01110101,175,10101111
94,01011110,74,01001010,168,10101000
71,01000111,63,00111111,134,10000110
97,01100001,30,00011110,127,01111111
94,01011110,69,01000101,163,10100011
33,00100001,32,00100000,65,01000001
15,00001111,58,00111010,73,01001001
49,00110001,98,01100010,147,10010011
23,00010111,29,00011101,52,00110100
10,00001010,65,01000001,75,01001011
45,00101101,35,00100011,80,01010000
33,00100001,125,01111101,158,10011110
95,01011111,77,01001101,172,10101100
66,01000010,101,01100101,167,10100111
64,01000000,43,00101011,107,01101011
87,01010111,58,00111010,145,10010001
11,00001011,54,00110110,65,01000001
19,00010011,39,00100111,58,00111010
65,01000001,54,00110110,119,01110111
106,01101010,63,00111111,169,10101001
75,01001011,71,01000111,146,10010010
118,01110110,22,00010110,140,10001100
19,00010011,13,00001101,32,00100000
52,00110100,123,01111011,175,10101111
89,01011001,124,01111100,213,11010101
71,01000111,22,00010110,93,01011101
33,00100001,64,01000000,97,01100001
77,01001101,120,01111000,197,11000101
76,01001100,96,01100000,172,10101100
36,00100100,49,00110001,85,01010101
66,01000010,27,00011011,93,01011101
87,01010111,11,00001011,98,01100010
59,00111011,31,00011111,90,01011010
38,00100110,63,00111111,101,01100101
20,00010100,30,00011110,50,00110010
49,00110001,13,00001101,62,00111110
81,01010001,74,01001010,155,10011011
111,01101111,64,01000000,175,10101111
59,00111011,91,01011011,150,10010110
51,00110011,65,01000001,116,01110100
23,00010111,100,01100100,123,01111011
120,01111000,29,00011101,149,10010101
63,00111111,54,00110110,117,01110101
72,01001000,102,01100110,174,10101110
62,00111110,8,00001000,70,01000110
11,00001011,54,00110110,65,01000001
96,01100000,54,00110110,150,10010110
103,01100111,36,00100100,139,10001011
92,01011100,84,01010100,176,10110000
102,01100110,65,01000001,167,10100111
26,00011010,82,01010010,108,01101100
10,00001010,89,01011001,99,01100011
62,00111110,84,01010100,146,10010010
102,01100110,2,00000010,104,01101000
107,01101011,14,00001110,121,01111001
85,01010101,82,01010010,167,10100111
22,00010110,37,00100101,59,00111011
76,01001100,62,00111110,138,10001010
6,00000110,28,00011100,34,00100010
96,01100000,115,01110011,211,11010011
64,01000000,81,01010001,145,10010001
124,01111100,40,00101000,164,10100100
72,01001000,35,00100011,107,01101011
120,01111000,36,00100100,156,10011100
54,00110110,51,00110011,105,01101001
47,00101111,92,01011100,139,10001011
72,01001000,94,01011110,166,10100110
113,01110001,126,01111110,239,11101111
81,01010001,60,00111100,141,10001101
83,01010011,85,01010101,168,10101000
12,00001100,98,01100010,110,01101110
112,01110000,99,01100011,211,11010011
41,00101001,26,00011010,67,01000011
41,00101001,29,00011101,70,01000110
90,01011010,0,00000000,90,01011010
45,00101101,95,01011111,140,10001100
27,00011011,5,00000101,32,00100000
0,00000000,93,01011101,93,01011101
115,01110011,9,00001001,124,01111100
87,01010111,48,00110000,135,10000111
83,01010011,47,00101111,130,10000010
7,00000111,6,00000110,13,00001101
25,00011001,56,00111000,81,01010001
42,00101010,58,00111010,100,01100100
71,01000111,126,01111110,197,11000101
0,00000000,59,00111011,59,00111011
61,00111101,97,01100001,158,10011110
8,00001000,0,00000000,8,00001000
116,01110100,47,00101111,163,10100011
91,01011011,115,01110011,206,11001110
121,01111001,40,00101000,161,10100001
90,01011010,103,01100111,193,11000001
58,00111010,124,01111100,182,10110110
97,01100001,69,01000101,166,10100110
0,00000000,123,01111011,123,01111011
54,00110110,123,01111011,177,10110001
84,01010100,3,00000011,87,01010111
99,01100011,58,00111010,157,10011101
124,01111100,49,00110001,173,10101101
54,00110110,66,01000010,120,01111000
76,01001100,60,00111100,136,10001000
62,00111110,96,01100000,158,10011110
108,01101100,70,01000110,178,10110010
117,01110101,52,00110100,169,10101001
36,00100100,50,00110010,86,01010110
96,01100000,120,01111000,216,11011000
42,00101010,58,00111010,100,01100100
84,01010100,38,00100110,122,01111010
32,00100000,60,00111100,92,01011100
11,00001011,85,01010101,96,01100000
12,00001100,70,01000110,82,01010010
108,01101100,62,00111110,170,10101010
22,00010110,75,01001011,97,01100001
47,00101111,57,00111001,104,01101000
0,00000000,37,00100101,37,00100101
95,01011111,45,00101101,140,10001100
48,00110000,40,00101000,88,01011000
90,01011010,12,00001100,102,01100110
78,01001110,23,00010111,101,01100101
19,00010011,22,00010110,41,00101001
34,00100010,104,01101000,138,10001010
63,00111111,96,01100000,159,10011111
42,00101010,12,00001100,54,00110110
17,00010001,110,01101110,127,01111111
49,00110001,79,01001111,128,10000000
13,00001101,4,00000100,17,00010001
27,00011011,57,00111001,84,01010100
28,00011100,55,00110111,83,01010011
37,00100101,64,01000000,101,01100101
95,01011111,105,01101001,200,11001000
67,01000011,49,00110001,116,01110100
33,00100001,54,00110110,87,01010111
36,00100100,94,01011110,130,10000010
45,00101101,59,00111011,104,01101000
99,01100011,7,00000111,106,01101010
57,00111001,95,01011111,152,10011000
13,00001101,11,00001011,24,00011000
43,00101011,71,01000111,114,01110010
19,00010011,51,00110011,70,01000110
51,00110011,101,01100101,152,10011000
71,01000111,99,01100011,170,10101010
65,01000001,50,00110010,115,01110011
113,01110001,106,01101010,219,11011011
55,00110111,79,01001111,134,10000110
13,00001101,125,01111101,138,10001010
40,00101000,89,01011001,129,10000001
81,01010001,15,00001111,96,01100000
16,00010000,3,00000011,19,00010011
86,01010110,100,01100100,186,10111010
6,00000110,23,00010111,29,00011101
81,01010001,50,00110010,131,10000011
16,00010000,62,00111110,78,01001110
5,00000101,57,00111001,62,00111110
26,00011010,89,01011001,115,01110011
59,00111011,43,00101011,102,01100110
23,00010111,117,01110101,140,10001100
54,00110110,16,00010000,70,01000110
37,00100101,27,00011011,64,01000000
116,01110100,120,01111000,236,11101100
10,00001010,92,01011100,102,01100110
35,00100011,31,00011111,66,01000010
57,00111001,100,01100100,157,10011101
68,01000100,89,01011001,157,10011101
118,01110110,84,01010100,202,11001010
68,01000100,22,00010110,90,01011010
96,01100000,92,01011100,188,10111100
33,00100001,112,01110000,145,10010001
101,01100101,117,01110101,218,11011010
2,00000010,42,00101010,44,00101100
40,00101000,105,01101001,145,10010001
3,00000011,117,01110101,120,01111000
7,00000111,77,01001101,84,01010100
98,01100010,39,00100111,137,10001001
101,01100101,34,00100010,135,10000111
42,00101010,124,01111100,166,10100110
72,01001000,89,01011001,161,10100001
5,00000101,84,01010100,89,01011001
65,01000001,31,00011111,96,01100000
41,00101001,80,01010000,121,01111001
13,00001101,4,00000100,17,00010001
76,01001100,19,00010011,95,01011111
1,00000001,87,01010111,88,01011000
113,01110001,17,00010001,130,10000010
59,00111011,4,00000100,63,00111111
95,01011111,41,00101001,136,10001000
7,00000111,90,01011010,97,01100001
17,00010001,93,01011101,110,01101110
88,01011000,103,01100111,191,10111111
109,01101101,84,01010100,193,11000001
36,00100100,35,00100011,71,01000111
16,00010000,110,01101110,126,01111110
82,01010010,91,01011011,173,10101101
5,00000101,120,01111000,125,01111101
62,00111110,11,00001011,73,01001001
63,00111111,118,01110110,181,10110101
53,00110101,30,00011110,83,01010011
60,00111100,1,00000001,61,00111101
36,00100100,36,00100100,72,01001000
121,01111001,48,00110000,169,10101001
87,01010111,101,01100101,188,10111100
108,01101100,46,00101110,154,10011010
77,01001101,72,01001000,149,10010101
90,01011010,65,01000001,155,10011011
23,00010111,79,01001111,102,01100110
25,00011001,3,00000011,28,00011100
21,00010101,78,01001110,99,01100011
17,00010001,20,00010100,37,00100101
117,01110101,82,01010010,199,11000111
85,01010101,98,01100010,183,10110111
54,00110110,119,01110111,173,10101101
104,01101000,80,01010000,184,10111000
40,00101000,24,00011000,64,01000000
93,01011101,3,00000011,96,01100000
13,00001101,26,00011010,39,00100111
116,01110100,126,01111110,242,11110010
75,01001011,115,01110011,190,10111110
38,00100110,122,01111010,160,10100000
100,01100100,96,01100000,196,11000100
102,01100110,26,00011010,128,10000000
16,00010000,11,00001011,27,00011011
30,00011110,125,01111101,155,10011011
12,00001100,23,00010111,35,00100011
63,00111111,17,00010001,80,01010000
116,01110100,94,01011110,210,11010010
29,00011101,61,00111101,90,01011010
62,00111110,104,01101000,166,10100110
52,00110100,102,01100110,154,10011010
113,01110001,91,01011011,204,11001100
31,00011111,109,01101101,140,10001100
28,00011100,80,01010000,108,01101100
21,00010101,27,00011011,48,00110000
56,00111000,28,00011100,84,01010100
109,01101101,40,00101000,149,10010101
30,00011110,115,01110011,145,10010001
86,01010110,34,00100010,120,01111000
75,01001011,80,01010000,155,10011011
116,01110100,87,01010111,203,11001011
10,00001010,20,00010100,30,00011110
88,01011000,91,01011011,179,10110011
83,01010011,97,01100001,180,10110100
39,00100111,94,01011110,133,10000101
73,01001001,94,01011110,167,10100111
27,00011011,85,01010101,112,01110000
45,00101101,79,01001111,124,01111100
118,01110110,58,00111010,176,10110000
98,01100010,97,01100001,195,11000011
74,01001010,13,00001101,87,01010111
98,01100010,22,00010110,120,01111000
39,00100111,48,00110000,87,01010111
61,00111101,44,00101100,105,01101001
31,00011111,98,01100010,129,10000001
15,00001111,61,00111101,76,01001100
19,00010011,59,00111011,78,01001110
95,01011111,81,01010001,176,10110000
57,00111001,54,00110110,111,01101111
39,00100111,117,01110101,156,10011100
51,00110011,22,00010110,73,01001001
65,01000001,10,00001010,75,01001011
97,01100001,20,00010100,117,01110101
93,01011101,70,01000110,163,10100011
85,01010101,115,01110011,200,11001000
75,01001011,102,01100110,177,10110001
34,00100010,50,00110010,84,01010100
67,01000011,88,01011000,155,10011011
69,01000101,95,01011111,164,10100100
115,01110011,71,01000111,186,10111010
8,00001000,118,01110110,126,01111110
122,01111010,54,00110110,176,10110000
27,00011011,34,00100010,61,00111101
16,00010000,3,00000011,19,00010011
63,00111111,29,00011101,92,01011100
22,00010110,100,01100100,122,01111010
76,01001100,78,01001110,154,10011010
80,01010000,122,01111010,202,11001010
46,00101110,96,01100000,142,10001110
34,00100010,72,01001000,106,01101010
89,01011001,37,00100101,126,01111110
72,01001000,91,01011011,163,10100011
66,01000010,87,01010111,153,10011001
109,01101101,10,00001010,119,01110111
56,00111000,38,00100110,94,01011110
73,01001001,25,00011001,98,01100010
123,01111011,73,01001001,196,11000100
11,00001011,33,00100001,44,00101100
110,01101110,116,01110100,226,11100010
44,00101100,43,00101011,87,01010111
68,01000100,109,01101101,177,10110001
107,01101011,25,00011001,132,10000100
92,01011100,48,00110000,140,10001100
104,01101000,17,00010001,121,01111001
103,01100111,35,00100011,138,10001010
42,00101010,48,00110000,90,01011010
83,01010011,28,00011100,111,01101111
51,00110011,118,01110110,169,10101001
95,01011111,70,01000110,165,10100101
34,00100010,92,01011100,126,01111110
35,00100011,61,00111101,96,01100000
76,01001100,61,00111101,137,10001001
19,00010011,97,01100001,116,01110100
7,00000111,31,00011111,38,00100110
10,00001010,93,01011101,103,01100111
62,00111110,21,00010101,83,01010011
80,01010000,42,00101010,122,01111010
21,00010101,87,01010111,108,01101100
88,01011000,118,01110110,206,11001110
69,01000101,123,01111011,192,11000000
59,00111011,64,01000000,123,01111011
27,00011011,94,01011110,121,01111001
108,01101100,86,01010110,194,11000010
99,01100011,109,01101101,208,11010000
122,01111010,116,01110100,238,11101110
70,01000110,89,01011001,159,10011111
67,01000011,50,00110010,117,01110101
33,00100001,36,00100100,69,01000101
12,00001100,69,01000101,81,01010001
89,01011001,69,01000101,158,10011110
90,01011010,23,00010111,113,01110001
120,01111000,39,00100111,159,10011111
19,00010011,6,00000110,25,00011001
58,00111010,29,00011101,87,01010111
103,01100111,97,01100001,200,11001000
52,00110100,33,00100001,85,01010101
1,00000001,102,01100110,103,01100111
83,01010011,86,01010110,169,10101001
109,01101101,117,01110101,226,11100010
13,00001101,91,01011011,104,01101000
36,00100100,23,00010111,59,00111011
31,00011111,62,00111110,93,01011101
117,01110101,42,00101010,159,10011111
23,00010111,4,00000100,27,00011011
94,01011110,116,01110100,210,11010010
90,01011010,3,00000011,93,01011101
89,01011001,35,00100011,124,01111100
126,01111110,1,00000001,127,01111111
10,00001010,99,01100011,109,01101101
15,00001111,25,00011001,40,00101000
4,00000100,126,01111110,130,10000010
96,01100000,26,00011010,122,01111010
114,01110010,66,01000010,180,10110100
103,01100111,112,01110000,215,11010111
66,01000010,4,00000100,70,01000110
79,01001111,4,00000100,83,01010011
40,00101000,89,01011001,129,10000001
22,00010110,11,00001011,33,00100001
92,01011100,41,00101001,133,10000101
111,01101111,27,00011011,138,10001010
59,00111011,67,01000011,126,01111110
84,01010100,23,00010111,107,01101011
119,01110111,79,01001111,198,11000110
16,00010000,36,00100100,52,00110100
71,01000111,70,01000110,141,10001101
56,00111000,126,01111110,182,10110110
108,01101100,91,01011011,199,11000111
7,00000111,23,00010111,30,00011110
111,01101111,85,01010101,196,11000100
97,01100001,68,01000100,165,10100101
26,00011010,126,01111110,152,10011000
89,01011001,6,00000110,95,01011111
4,00000100,19,00010011,23,00010111
115,01110011,26,00011010,141,10001101
24,00011000,37,00100101,61,00111101
69,01000101,73,01001001,142,10001110
60,00111100,89,01011001,149,10010101
54,00110110,121,01111001,175,10101111
59,00111011,85,01010101,144,10010000
86,01010110,62,00111110,148,10010100
85,01010101,7,00000111,92,01011100
90,01011010,61,00111101,151,10010111
123,01111011,25,00011001,148,10010100
88,01011000,81,01010001,169,10101001
114,01110010,82,01010010,196,11000100
27,00011011,84,01010100,111,01101111
117,01110101,109,01101101,226,11100010
120,01111000,21,00010101,141,10001101
28,00011100,14,00001110,42,00101010
31,00011111,84,01010100,115,01110011
74,01001010,97,01100001,171,10101011
79,01001111,121,01111001,200,11001000
120,01111000,37,00100101,157,10011101
15,00001111,105,01101001,120,01111000
92,01011100,99,01100011,191,10111111
3,00000011,122,01111010,125,01111101
41,00101001,48,00110000,89,01011001
97,01100001,33,00100001,130,10000010
107,01101011,48,00110000,155,10011011
40,00101000,103,01100111,143,10001111
11,00001011,123,01111011,134,10000110
22,00010110,16,00010000,38,00100110
125,01111101,120,01111000,245,11110101
3,00000011,86,01010110,89,01011001
38,00100110,20,00010100,58,00111010
54,00110110,86,01010110,140,10001100
41,00101001,10,00001010,51,00110011
29,00011101,35,00100011,64,01000000
99,01100011,31,00011111,130,10000010
14,00001110,71,01000111,85,01010101
21,00010101,13,00001101,34,00100010
35,00100011,69,01000101,104,01101000
23,00010111,42,00101010,65,01000001
7,00000111,10,00001010,17,00010001
64,01000000,53,00110101,117,01110101
47,00101111,31,00011111,78,01001110
82,01010010,62,00111110,144,10010000
111,01101111,87,01010111,198,11000110
65,01000001,23,00010111,88,01011000
106,01101010,39,00100111,145,10010001
78,01001110,94,01011110,172,10101100
53,00110101,57,00111001,110,01101110
103,01100111,85,01010101,188,10111100
105,01101001,7,00000111,112,01110000
118,01110110,125,01111101,243,11110011
96,01100000,45,00101101,141,10001101
28,00011100,25,00011001,53,00110101
57,00111001,109,01101101,166,10100110
31,00011111,113,01110001,144,10010000
58,00111010,77,01001101,135,10000111
70,01000110,111,01101111,181,10110101
91,01011011,104,01101000,195,11000011
6,00000110,7,00000111,13,00001101
111,01101111,34,00100010,145,10010001
48,00110000,103,01100111,151,10010111
33,00100001,73,01001001,106,01101010
70,01000110,21,00010101,91,01011011
58,00111010,94,01011110,152,10011000
42,00101010,62,00111110,104,01101000
121,01111001,28,00011100,149,10010101
15,00001111,6,00000110,21,00010101
19,00010011,23,00010111,42,00101010
30,00011110,74,01001010,104,01101000
48,00110000,53,00110101,101,01100101
47,00101111,123,01111011,170,10101010
94,01011110,80,01010000,174,10101110
8,00001000,83,01010011,91,01011011
14,00001110,31,00011111,45,00101101
50,00110010,30,00011110,80,01010000
84,01010100,69,01000101,153,10011001
41,00101001,49,00110001,90,01011010
109,01101101,76,01001100,185,10111001
89,01011001,77,01001101,166,10100110
55,00110111,54,00110110,109,01101101
0,00000000,77,01001101,77,01001101
1,00000001,14,00001110,15,00001111
18,00010010,48,00110000,66,01000010
109,01101101,70,01000110,179,10110011
14,00001110,107,01101011,121,01111001
31,00011111,29,00011101,60,00111100
100,01100100,72,01001000,172,10101100
104,01101000,67,01000011,171,10101011
43,00101011,97,01100001,140,10001100
114,01110010,35,00100011,149,10010101
98,01100010,58,00111010,156,10011100
30,00011110,108,01101100,138,10001010
108,01101100,16,00010000,124,01111100
65,01000001,4,00000100,69,01000101
108,01101100,93,01011101,201,11001001
113,01110001,106,01101010,219,11011011
57,00111001,18,00010010,75,01001011
82,01010010,111,01101111,193,11000001
28,00011100,50,00110010,78,01001110
55,00110111,44,00101100,99,01100011
17,00010001,110,01101110,127,01111111
35,00100011,92,01011100,127,01111111
49,00110001,61,00111101,110,01101110
68,01000100,67,01000011,135,10000111
4,00000100,12,00001100,16,00010000
93,01011101,16,00010000,109,01101101
22,00010110,123,01111011,145,10010001
6,00000110,103,01100111,109,01101101
95,01011111,106,01101010,201,11001001
92,01011100,27,00011011,119,01110111
30,00011110,5,00000101,35,00100011
125,01111101,34,00100010,159,10011111
58,00111010,54,00110110,112,01110000
19,00010011,12,00001100,31,00011111
18,00010010,49,00110001,67,01000011
109,01101101,44,00101100,153,10011001
62,00111110,16,00010000,78,01001110
23,00010111,97,01100001,120,01111000
54,00110110,6,00000110,60,00111100
93,01011101,87,01010111,180,10110100
95,01011111,26,00011010,121,01111001
90,01011010,76,01001100,166,10100110
41,00101001,72,01001000,113,01110001
67,01000011,62,00111110,129,10000001
73,01001001,75,01001011,148,10010100
48,00110000,110,01101110,158,10011110
75,01001011,111,01101111,186,10111010
63,00111111,2,00000010,65,01000001
3,00000011,68,01000100,71,01000111
89,01011001,12,00001100,101,01100101
94,01011110,73,01001001,167,10100111
23,00010111,93,01011101,116,01110100
111,01101111,43,00101011,154,10011010
114,01110010,118,01110110,232,11101000
116,01110100,78,01001110,194,11000010
75,01001011,44,00101100,119,01110111
91,01011011,42,00101010,133,10000101
110,01101110,64,01000000,174,10101110
64,01000000,55,00110111,119,01110111
123,01111011,83,01010011,206,11001110
109,01101101,63,00111111,172,10101100
124,01111100,5,00000101,129,10000001
86,01010110,50,00110010,136,10001000
50,00110010,49,00110001,99,01100011
59,00111011,15,00001111,74,01001010
56,00111000,44,00101100,100,01100100
62,00111110,55,00110111,117,01110101
36,00100100,110,01101110,146,10010010
41,00101001,104,01101000,145,10010001
113,01110001,32,00100000,145,10010001
48,00110000,64,01000000,112,01110000
51,00110011,6,00000110,57,00111001
60,00111100,37,00100101,97,01100001
22,00010110,84,01010100,106,01101010
59,00111011,76,01001100,135,10000111
96,01100000,95,01011111,191,10111111
70,01000110,75,01001011,145,10010001
61,00111101,80,01010000,141,10001101
79,01001111,88,01011000,167,10100111
102,01100110,96,01100000,198,11000110
53,00110101,8,00001000,61,00111101
105,01101001,97,01100001,202,11001010
85,01010101,15,00001111,100,01100100
57,00111001,11,00001011,68,01000100
6,00000110,39,00100111,45,00101101
107,01101011,83,01010011,190,10111110
96,01100000,118,01110110,214,11010110
29,00011101,0,00000000,29,00011101
59,00111011,121,01111001,180,10110100
101,01100101,59,00111011,160,10100000
46,00101110,63,00111111,109,01101101
25,00011001,100,01100100,125,01111101
65,01000001,13,00001101,78,01001110
40,00101000,11,00001011,51,00110011
46,00101110,45,00101101,91,01011011
43,00101011,102,01100110,145,10010001
23,00010111,23,00010111,46,00101110
64,01000000,105,01101001,169,10101001
51,00110011,9,00001001,60,00111100
0,00000000,121,01111001,121,01111001
37,00100101,1,00000001,38,00100110
52,00110100,54,00110110,106,01101010
8,00001000,30,00011110,38,00100110
104,01101000,49,00110001,153,10011001
86,01010110,17,00010001,103,01100111
44,00101100,43,00101011,87,01010111
56,00111000,87,01010111,143,10001111
17,00010001,93,01011101,110,01101110
52,00110100,30,00011110,82,01010010
28,00011100,96,01100000,124,01111100
71,01000111,119,01110111,190,10111110
87,01010111,4,00000100,91,01011011
120,01111000,32,00100000,152,10011000
87,01010111,93,01011101,180,10110100
94,01011110,59,00111011,153,10011001
100,01100100,43,00101011,143,10001111
21,00010101,47,00101111,68,01000100
38,00100110,69,01000101,107,01101011
36,00100100,9,00001001,45,00101101
32,00100000,94,01011110,126,01111110
19,00010011,111,01101111,130,10000010
81,01010001,50,00110010,131,10000011
35,00100011,11,00001011,46,00101110
60,00111100,3,00000011,63,00111111
83,01010011,91,01011011,174,10101110
3,00000011,92,01011100,95,01011111
4,00000100,2,00000010,6,00000110
8,00001000,11,00001011,19,00010011
69,01000101,4,00000100,73,01001001
70,01000110,66,01000010,136,10001000
90,01011010,99,01100011,189,10111101
93,01011101,49,00110001,142,10001110
107,01101011,65,01000001,172,10101100
71,01000111,84,01010100,155,10011011
87,01010111,51,00110011,138,10001010
10,00001010,20,00010100,30,00011110
38,00100110,10,00001010,48,00110000
111,01101111,34,00100010,145,10010001
99,01100011,61,00111101,160,10100000
104,01101000,16,00010000,120,01111000
113,01110001,10,00001010,123,01111011
38,00100110,100,01100100,138,10001010
77,01001101,102,01100110,179,10110011
74,01001010,99,01100011,173,10101101
124,01111100,67,01000011,191,10111111
74,01001010,127,01111111,201,11001001
126,01111110,18,00010010,144,10010000
120,01111000,89,01011001,209,11010001
15,00001111,63,00111111,78,01001110
34,00100010,0,00000000,34,00100010
79,01001111,64,01000000,143,10001111
99,01100011,67,01000011,166,10100110
113,01110001,53,00110101,166,10100110
46,00101110,32,00100000,78,01001110
41,00101001,36,00100100,77,01001101
30,00011110,25,00011001,55,00110111
43,00101011,67,01000011,110,01101110
104,01101000,107,01101011,211,11010011
17,00010001,55,00110111,72,01001000
110,01101110,39,00100111,149,10010101
72,01001000,94,01011110,166,10100110
29,00011101,12,00001100,41,00101001
118,01110110,73,01001001,191,10111111
27,00011011,67,01000011,94,01011110
123,01111011,36,00100100,159,10011111
40,00101000,91,01011011,131,10000011
51,00110011,36,00100100,87,01010111
51,00110011,47,00101111,98,01100010
27,00011011,120,01111000,147,10010011
59,00111011,112,01110000,171,10101011
59,00111011,24,00011000,83,01010011
121,01111001,66,01000010,187,10111011
37,00100101,97,01100001,134,10000110
106,01101010,50,00110010,156,10011100
126,01111110,78,01001110,204,11001100
124,01111100,93,01011101,217,11011001
90,01011010,18,00010010,108,01101100
55,00110111,91,01011011,146,10010010
64,01000000,104,01101000,168,10101000
54,00110110,52,00110100,106,01101010
44,00101100,40,00101000,84,01010100
17,00010001,103,01100111,120,01111000
32,00100000,116,01110100,148,10010100
85,01010101,107,01101011,192,11000000
86,01010110,8,00001000,94,01011110
25,00011001,28,00011100,53,00110101
67,01000011,33,00100001,100,01100100
68,01000100,99,01100011,167,10100111
76,01001100,94,01011110,170,10101010
126,01111110,41,00101001,167,10100111
115,01110011,113,01110001,228,11100100
57,00111001,74,01001010,131,10000011
9,00001001,10,00001010,19,00010011
85,01010101,55,00110111,140,10001100
87,01010111,84,01010100,171,10101011
23,00010111,52,00110100,75,01001011
86,01010110,25,00011001,111,01101111
125,01111101,70,01000110,195,11000011
29,00011101,39,00100111,68,01000100
54,00110110,57,00111001,111,01101111
7,00000111,124,01111100,131,10000011
92,01011100,122,01111010,214,11010110
3,00000011,87,01010111,90,01011010
17,00010001,37,00100101,54,00110110
75,01001011,56,00111000,131,10000011
48,00110000,82,01010010,130,10000010
3,00000011,8,00001000,11,00001011
49,00110001,115,01110011,164,10100100
20,00010100,68,01000100,88,01011000
118,01110110,78,01001110,196,11000100
125,01111101,23,00010111,148,10010100
42,00101010,32,00100000,74,01001010
39,00100111,19,00010011,58,00111010
3,00000011,58,00111010,61,00111101
22,00010110,10,00001010,32,00100000
28,00011100,76,01001100,104,01101000
15,00001111,115,01110011,130,10000010
45,00101101,94,01011110,139,10001011
87,01010111,88,01011000,175,10101111
121,01111001,21,00010101,142,10001110
53,00110101,32,00100000,85,01010101
38,00100110,125,01111101,163,10100011
38,00100110,52,00110100,90,01011010
37,00100101,67,01000011,104,01101000
55,00110111,3,00000011,58,00111010
53,00110101,93,01011101,146,10010010
80,01010000,115,01110011,195,11000011
8,00001000,45,00101101,53,00110101
93,01011101,61,00111101,154,10011010
111,01101111,50,00110010,161,10100001
103,01100111,87,01010111,190,10111110
4,00000100,9,00001001,13,00001101
118,01110110,89,01011001,207,11001111
18,00010010,124,01111100,142,10001110
8,00001000,7,00000111,15,00001111
24,00011000,111,01101111,135,10000111
93,01011101,118,01110110,211,11010011
41,00101001,54,00110110,95,01011111
33,00100001,13,00001101,46,00101110
15,00001111,44,00101100,59,00111011
20,00010100,17,00010001,37,00100101
95,01011111,45,00101101,140,10001100
49,00110001,25,00011001,74,01001010
56,00111000,105,01101001,161,10100001
5,00000101,67,01000011,72,01001000
46,00101110,58,00111010,104,01101000
65,01000001,80,01010000,145,10010001
92,01011100,24,00011000,116,01110100
83,01010011,104,01101000,187,10111011
12,00001100,79,01001111,91,01011011
82,01010010,74,01001010,156,10011100
81,01010001,99,01100011,180,10110100
17,00010001,84,01010100,101,01100101
22,00010110,67,01000011,89,01011001
112,01110000,123,01111011,235,11101011
80,01010000,16,00010000,96,01100000
89,01011001,9,00001001,98,01100010
44,00101100,19,00010011,63,00111111
12,00001100,70,01000110,82,01010010
14,00001110,23,00010111,37,00100101
20,00010100,54,00110110,74,01001010
6,00000110,14,00001110,20,00010100
17,00010001,103,01100111,120,01111000
126,01111110,42,00101010,168,10101000
47,00101111,106,01101010,153,10011001
61,00111101,61,00111101,122,01111010
21,00010101,28,00011100,49,00110001
46,00101110,15,00001111,61,00111101
44,00101100,26,00011010,70,01000110
68,01000100,28,00011100,96,01100000
24,00011000,95,01011111,119,01110111
71,01000111,33,00100001,104,01101000
6,00000110,49,00110001,55,00110111
123,01111011,93,01011101,216,11011000
112,01110000,8,00001000,120,01111000
19,00010011,40,00101000,59,00111011
63,00111111,44,00101100,107,01101011
4,00000100,121,01111001,125,01111101
110,01101110,78,01001110,188,10111100
19,00010011,40,00101000,59,00111011
33,00100001,56,00111000,89,01011001
88,01011000,19,00010011,107,01101011
27,00011011,56,00111000,83,01010011
65,01000001,8,00001000,73,01001001
7,00000111,33,00100001,40,00101000
25,00011001,102,01100110,127,01111111
79,01001111,112,01110000,191,10111111
117,01110101,73,01001001,190,10111110
9,00001001,100,01100100,109,01101101
43,00101011,103,01100111,146,10010010
65,01000001,61,00111101,126,01111110
11,00001011,125,01111101,136,10001000
46,00101110,117,01110101,163,10100011
46,00101110,76,01001100,122,01111010
111,01101111,27,00011011,138,10001010
90,01011010,63,00111111,153,10011001
83,01010011,99,01100011,182,10110110
106,01101010,121,01111001,227,11100011
127,01111111,64,01000000,191,10111111
82,01010010,100,01100100,182,10110110
53,00110101,100,01100100,153,10011001
18,00010010,5,00000101,23,00010111
76,01001100,45,00101101,121,01111001
79,01001111,70,01000110,149,10010101
41,00101001,75,01001011,116,01110100
62,00111110,64,01000000,126,01111110
50,00110010,26,00011010,76,01001100
113,01110001,1,00000001,114,01110010
110,01101110,55,00110111,165,10100101
70,01000110,14,00001110,84,01010100
60,00111100,7,00000111,67,01000011
27,00011011,11,00001011,38,00100110
7,00000111,2,00000010,9,00001001
17,00010001,117,01110101,134,10000110
118,01110110,127,01111111,245,11110101
52,00110100,92,01011100,144,10010000
86,01010110,82,01010010,168,10101000
13,00001101,127,01111111,140,10001100
58,00111010,26,00011010,84,01010100
106,01101010,103,01100111,209,11010001
42,00101010,104,01101000,146,10010010
64,01000000,115,01110011,179,10110011
105,01101001,72,01001000,177,10110001
116,01110100,100,01100100,216,11011000
74,01001010,127,01111111,201,11001001
20,00010100,23,00010111,43,00101011
127,01111111,55,00110111,182,10110110
13,00001101,100,01100100,113,01110001
50,00110010,11,00001011,61,00111101
98,01100010,111,01101111,209,11010001
25,00011001,86,01010110,111,01101111
51,00110011,97,01100001,148,10010100
25,00011001,5,00000101,30,00011110
109,01101101,20,00010100,129,10000001
104,01101000,18,00010010,122,01111010
19,00010011,107,01101011,126,01111110
50,00110010,117,01110101,167,10100111
78,01001110,50,00110010,128,10000000
84,01010100,127,01111111,211,11010011
35,00100011,83,01010011,118,01110110
84,01010100,46,00101110,130,10000010
100,01100100,29,00011101,129,10000001
29,00011101,46,00101110,75,01001011
51,00110011,76,01001100,127,01111111
24,00011000,23,00010111,47,00101111
67,01000011,10,00001010,77,01001101
124,01111100,100,01100100,224,11100000
37,00100101,42,00101010,79,01001111
109,01101101,72,01001000,181,10110101
35,00100011,115,01110011,150,10010110
38,00100110,106,01101010,144,10010000
99,01100011,121,01111001,220,11011100
6,00000110,82,01010010,88,01011000
56,00111000,69,01000101,125,01111101
41,00101001,94,01011110,135,10000111
28,00011100,37,00100101,65,01000001
19,00010011,101,01100101,120,01111000
32,00100000,19,00010011,51,00110011
77,01001101,100,01100100,177,10110001
34,00100010,87,01010111,121,01111001
86,01010110,97,01100001,183,10110111
106,01101010,6,00000110,112,01110000
31,00011111,60,00111100,91,01011011
113,01110001,31,00011111,144,10010000
79,01001111,19,00010011,98,01100010
75,01001011,4,00000100,79,01001111
37,00100101,103,01100111,140,10001100
16,00010000,112,01110000,128,10000000
7,00000111,44,00101100,51,00110011
67,01000011,75,01001011,142,10001110
41,00101001,3,00000011,44,00101100
100,01100100,6,00000110,106,01101010
68,01000100,63,00111111,131,10000011
1,00000001,43,00101011,44,00101100
4,00000100,34,00100010,38,00100110
66,01000010,43,00101011,109,01101101
125,01111101,109,01101101,234,11101010
74,01001010,69,01000101,143,10001111
38,00100110,80,01010000,118,01110110
127,01111111,89,01011001,216,11011000
121,01111001,36,00100100,157,10011101
28,00011100,8,00001000,36,00100100
93,01011101,17,00010001,110,01101110
64,01000000,117,01110101,181,10110101
104,01101000,66,01000010,170,10101010
73,01001001,113,01110001,186,10111010
78,01001110,31,00011111,109,01101101
116,01110100,126,01111110,242,11110010
29,00011101,4,00000100,33,00100001
90,01011010,61,00111101,151,10010111
53,00110101,53,00110101,106,01101010
37,00100101,37,00100101,74,01001010
50,00110010,10,00001010,60,00111100
62,00111110,23,00010111,85,01010101
123,01111011,71,01000111,194,11000010
78,01001110,125,01111101,203,11001011
31,00011111,9,00001001,40,00101000
17,00010001,81,01010001,98,01100010
113,01110001,75,01001011,188,10111100
63,00111111,66,01000010,129,10000001
16,00010000,81,01010001,97,01100001
93,01011101,52,00110100,145,10010001
32,00100000,90,01011010,122,01111010
18,00010010,80,01010000,98,01100010
32,00100000,31,00011111,63,00111111
113,01110001,96,01100000,209,11010001
93,01011101,45,00101101,138,10001010
7,00000111,111,01101111,118,01110110
55,00110111,8,00001000,63,00111111
24,00011000,59,00111011,83,01010011
10,00001010,31,00011111,41,00101001
104,01101000,60,00111100,164,10100100
19,00010011,16,00010000,35,00100011
102,01100110,33,00100001,135,10000111
12,00001100,116,01110100,128,10000000
64,01000000,48,00110000,112,01110000
87,01010111,9,00001001,96,01100000
71,01000111,120,01111000,191,10111111
17,00010001,93,01011101,110,01101110
38,00100110,126,01111110,164,10100100
6,00000110,107,01101011,113,01110001
71,01000111,30,00011110,101,01100101
100,01100100,50,00110010,150,10010110
68,01000100,70,01000110,138,10001010
33,00100001,87,01010111,120,01111000
24,00011000,84,01010100,108,01101100
75,01001011,20,00010100,95,01011111
76,01001100,26,00011010,102,01100110
45,00101101,61,00111101,106,01101010
15,00001111,12,00001100,27,00011011
75,01001011,50,00110010,125,01111101
13,00001101,66,01000010,79,01001111
41,00101001,12,00001100,53,00110101
46,00101110,42,00101010,88,01011000
88,01011000,115,01110011,203,11001011
33,00100001,30,00011110,63,00111111
76,01001100,69,01000101,145,10010001
84,01010100,63,00111111,147,10010011
119,01110111,122,01111010,241,11110001
81,01010001,83,01010011,164,10100100
117,01110101,107,01101011,224,11100000
1,00000001,107,01101011,108,01101100
127,01111111,95,01011111,222,11011110
56,00111000,14,00001110,70,01000110
110,01101110,37,00100101,147,10010011
35,00100011,99,01100011,134,10000110
34,00100010,123,01111011,157,10011101
19,00010011,122,01111010,141,10001101
92,01011100,32,00100000,124,01111100
18,00010010,105,01101001,123,01111011
54,00110110,6,00000110,60,00111100
99,01100011,96,01100000,195,11000011
89,01011001,64,01000000,153,10011001
93,01011101,105,01101001,198,11000110
64,01000000,38,00100110,102,01100110
3,00000011,61,00111101,64,01000000
20,00010100,47,00101111,67,01000011
18,00010010,21,00010101,39,00100111
2,00000010,97,01100001,99,01100011
64,01000000,58,00111010,122,01111010
116,01110100,61,00111101,177,10110001
81,01010001,1,00000001,82,01010010
17,00010001,106,01101010,123,01111011
66,01000010,105,01101001,171,10101011
82,01010010,87,01010111,169,10101001
94,01011110,114,01110010,208,11010000
13,00001101,58,00111010,71,01000111
60,00111100,45,00101101,105,01101001
49,00110001,91,01011011,140,10001100
71,01000111,74,01001010,145,10010001
62,00111110,18,00010010,80,01010000
15,00001111,9,00001001,24,00011000
127,01111111,127,01111111,254,11111110
11,00001011,46,00101110,57,00111001
95,01011111,50,00110010,145,10010001
15,00001111,122,01111010,137,10001001
104,01101000,32,00100000,136,10001000
82,01010010,14,00001110,96,01100000
57,00111001,23,00010111,80,01010000
1,00000001,98,01100010,99,01100011
34,00100010,87,01010111,121,01111001
47,00101111,99,01100011,146,10010010
16,00010000,45,00101101,61,00111101
100,01100100,77,01001101,177,10110001
67,01000011,120,01111000,187,10111011
111,01101111,6,00000110,117,01110101
1,00000001,18,00010010,19,00010011
120,01111000,125,01111101,245,11110101
62,00111110,56,00111000,118,01110110
59,00111011,58,00111010,117,01110101
27,00011011,11,00001011,38,00100110
97,01100001,117,01110101,214,11010110
31,00011111,9,00001001,40,00101000
13,00001101,64,01000000,77,01001101
98,01100010,10,00001010,108,01101100
9,00001001,6,00000110,15,00001111
73,01001001,51,00110011,124,01111100
17,00010001,26,00011010,43,00101011
91,01011011,115,01110011,206,11001110
2,00000010,106,01101010,108,01101100
77,01001101,17,00010001,94,01011110
101,01100101,54,00110110,155,10011011
23,00010111,109,01101101,132,10000100
66,01000010,14,00001110,80,01010000
33,00100001,82,01010010,115,01110011
117,01110101,40,00101000,157,10011101
72,01001000,38,00100110,110,01101110
60,00111100,73,01001001,133,10000101
11,00001011,63,00111111,74,01001010
72,01001000,94,01011110,166,10100110
54,00110110,92,01011100,146,10010010
78,01001110,117,01110101,195,11000011
92,01011100,65,01000001,157,10011101
47,00101111,84,01010100,131,10000011
53,00110101,87,01010111,140,10001100
112,01110000,18,00010010,130,10000010
99,01100011,126,01111110,225,11100001
30,00011110,126,01111110,156,10011100
77,01001101,8,00001000,85,01010101
40,00101000,101,01100101,141,10001101
118,01110110,98,01100010,216,11011000
108,01101100,97,01100001,205,11001101
112,01110000,9,00001001,121,01111001
63,00111111,58,00111010,121,01111001
4,00000100,102,01100110,106,01101010
108,01101100,72,01001000,180,10110100
7,00000111,55,00110111,62,00111110
67,01000011,117,01110101,184,10111000
113,01110001,79,01001111,192,11000000
114,01110010,77,01001101,191,10111111
19,00010011,70,01000110,89,01011001
59,00111011,18,00010010,77,01001101
124,01111100,123,01111011,247,11110111
92,01011100,43,00101011,135,10000111
110,01101110,101,01100101,211,11010011
122,01111010,126,01111110,248,11111000
37,00100101,90,01011010,127,01111111
10,00001010,124,01111100,134,10000110
8,00001000,20,00010100,28,00011100
71,01000111,62,00111110,133,10000101
127,01111111,6,00000110,133,10000101
104,01101000,67,01000011,171,10101011
46,00101110,54,00110110,100,01100100
28,00011100,80,01010000,108,01101100
62,00111110,100,01100100,162,10100010
57,00111001,17,00010001,74,01001010
13,00001101,76,01001100,89,01011001
33,00100001,94,01011110,127,01111111
60,00111100,88,01011000,148,10010100
100,01100100,12,00001100,112,01110000
27,00011011,17,00010001,44,00101100
34,00100010,63,00111111,97,01100001
125,01111101,66,01000010,191,10111111
88,01011000,75,01001011,163,10100011
43,00101011,13,00001101,56,00111000
82,01010010,11,00001011,93,01011101
25,00011001,48,00110000,73,01001001
68,01000100,102,01100110,170,10101010
72,01001000,105,01101001,177,10110001
74,01001010,42,00101010,116,01110100
46,00101110,101,01100101,147,10010011
122,01111010,123,01111011,245,11110101
22,00010110,28,00011100,50,00110010
127,01111111,123,01111011,250,11111010
13,00001101,124,01111100,137,10001001
103,01100111,79,01001111,182,10110110
111,01101111,58,00111010,169,10101001
51,00110011,50,00110010,101,01100101
123,01111011,86,01010110,209,11010001
79,01001111,45,00101101,124,01111100
15,00001111,35,00100011,50,00110010
119,01110111,75,01001011,194,11000010
121,01111001,74,01001010,195,11000011
15,00001111,70,01000110,85,01010101
87,01010111,7,00000111,94,01011110
47,00101111,100,01100100,147,10010011
66,01000010,40,00101000,106,01101010
117,01110101,42,00101010,159,10011111
97,01100001,35,00100011,132,10000100
46,00101110,40,00101000,86,01010110
104,01101000,20,00010100,124,01111100
55,00110111,57,00111001,112,01110000
127,01111111,87,01010111,214,11010110
43,00101011,47,00101111,90,01011010
31,00011111,37,00100101,68,01000100
22,00010110,106,01101010,128,10000000
109,01101101,123,01111011,232,11101000
53,00110101,19,00010011,72,01001000
60,00111100,93,01011101,153,10011001
20,00010100,80,01010000,100,01100100
44,00101100,79,01001111,123,01111011
70,01000110,100,01100100,170,10101010
73,01001001,33,00100001,106,01101010
65,01000001,126,01111110,191,10111111
127,01111111,76,01001100,203,11001011
96,01100000,69,01000101,165,10100101
26,00011010,25,00011001,51,00110011
105,01101001,82,01010010,187,10111011
124,01111100,10,00001010,134,10000110
124,01111100,47,00101111,171,10101011
118,01110110,24,00011000,142,10001110
73,01001001,33,00100001,106,01101010
104,01101000,88,01011000,192,11000000
47,00101111,111,01101111,158,10011110
89,01011001,17,00010001,106,01101010
126,01111110,33,00100001,159,10011111
101,01100101,28,00011100,129,10000001
32,00100000,115,01110011,147,10010011
116,01110100,107,01101011,223,11011111
35,00100011,42,00101010,77,01001101
88,01011000,68,01000100,156,10011100
99,01100011,105,01101001,204,11001100
41,00101001,34,00100010,75,01001011
51,00110011,84,01010100,135,10000111
62,00111110,101,01100101,163,10100011
81,01010001,73,01001001,154,10011010
105,01101001,72,01001000,177,10110001
27,00011011,109,01101101,136,10001000
86,01010110,74,01001010,160,10100000
113,01110001,71,01000111,184,10111000
53,00110101,79,01001111,132,10000100
30,00011110,52,00110100,82,01010010
89,01011001,65,01000001,154,10011010
28,00011100,3,00000011,31,00011111
86,01010110,115,01110011,201,11001001
9,00001001,69,01000101,78,01001110
86,01010110,20,00010100,106,01101010
57,00111001,35,00100011,92,01011100
75,01001011,72,01001000,147,10010011
66,01000010,51,00110011,117,01110101
75,01001011,41,00101001,116,01110100
96,01100000,89,01011001,185,10111001
73,01001001,81,01010001,154,10011010
104,01101000,101,01100101,205,11001101
36,00100100,32,00100000,68,01000100
98,01100010,73,01001001,171,10101011
40,00101000,59,00111011,99,01100011
69,01000101,50,00110010,119,01110111
73,01001001,51,00110011,124,01111100
122,01111010,11,00001011,133,10000101
77,01001101,8,00001000,85,01010101
76,01001100,55,00110111,131,10000011
48,00110000,97,01100001,145,10010001
86,01010110,125,01111101,211,11010011
120,01111000,21,00010101,141,10001101
55,00110111,75,01001011,130,10000010
113,01110001,117,01110101,230,11100110
108,01101100,127,01111111,235,11101011
79,01001111,99,01100011,178,10110010
91,01011011,20,00010100,111,01101111
33,00100001,63,00111111,96,01100000
35,00100011,111,01101111,146,10010010
97,01100001,57,00111001,154,10011010
16,00010000,120,01111000,136,10001000
12,00001100,105,01101001,117,01110101
44,00101100,84,01010100,128,10000000
115,01110011,20,00010100,135,10000111
52,00110100,43,00101011,95,01011111
86,01010110,44,00101100,130,10000010
23,00010111,14,00001110,37,00100101
16,00010000,84,01010100,100,01100100
85,01010101,115,01110011,200,11001000
23,00010111,112,01110000,135,10000111
43,00101011,80,01010000,123,01111011
20,00010100,31,00011111,51,00110011
94,01011110,112,01110000,206,11001110
104,01101000,120,01111000,224,11100000
20,00010100,124,01111100,144,10010000
98,01100010,83,01010011,181,10110101
65,01000001,36,00100100,101,01100101
45,00101101,59,00111011,104,01101000
65,01000001,121,01111001,186,10111010
34,00100010,24,00011000,58,00111010
120,01111000,59,00111011,179,10110011
96,01100000,6,00000110,102,01100110
21,00010101,26,00011010,47,00101111
51,00110011,2,00000010,53,00110101
22,00010110,88,01011000,110,01101110
121,01111001,47,00101111,168,10101000
85,01010101,77,01001101,162,10100010
72,01001000,114,01110010,186,10111010
88,01011000,119,01110111,207,11001111
96,01100000,85,01010101,181,10110101
45,00101101,104,01101000,149,10010101
106,01101010,24,00011000,130,10000010
127,01111111,33,00100001,160,10100000
118,01110110,56,00111000,174,10101110
14,00001110,41,00101001,55,00110111
76,01001100,22,00010110,98,01100010
115,01110011,97,01100001,212,11010100
72,01001000,10,00001010,82,01010010
63,00111111,112,01110000,175,10101111
34,00100010,101,01100101,135,10000111
120,01111000,115,01110011,235,11101011
9,00001001,56,00111000,65,01000001
100,01100100,92,01011100,192,11000000
29,00011101,30,00011110,59,00111011
57,00111001,66,01000010,123,01111011
66,01000010,59,00111011,125,01111101
14,00001110,68,01000100,82,01010010
9,00001001,67,01000011,76,01001100
90,01011010,51,00110011,141,10001101
76,01001100,6,00000110,82,01010010
106,01101010,44,00101100,150,10010110
64,01000000,103,01100111,167,10100111
37,00100101,24,00011000,61,00111101
125,01111101,28,00011100,153,10011001
31,00011111,15,00001111,46,00101110
3,00000011,5,00000101,8,00001000
26,00011010,51,00110011,77,01001101
28,00011100,103,01100111,131,10000011
22,00010110,102,01100110,124,01111100
65,01000001,122,01111010,187,10111011
46,00101110,13,00001101,59,00111011
31,00011111,31,00011111,62,00111110
104,01101000,73,01001001,177,10110001
83,01010011,31,00011111,114,01110010
49,00110001,126,01111110,175,10101111
80,01010000,81,01010001,161,10100001
80,01010000,55,00110111,135,10000111
96,01100000,4,00000100,100,01100100
1,00000001,96,01100000,97,01100001
57,00111001,39,00100111,96,01100000
103,01100111,52,00110100,155,10011011
13,00001101,107,01101011,120,01111000
77,01001101,6,00000110,83,01010011
61,00111101,57,00111001,118,01110110
70,01000110,53,00110101,123,01111011
59,00111011,120,01111000,179,10110011
124,01111100,31,00011111,155,10011011
55,00110111,31,00011111,86,01010110
120,01111000,63,00111111,183,10110111
56,00111000,47,00101111,103,01100111
0,00000000,80,01010000,80,01010000
117,01110101,103,01100111,220,11011100
66,01000010,120,01111000,186,10111010
87,01010111,88,01011000,175,10101111
11,00001011,113,01110001,124,01111100
3,00000011,122,01111010,125,01111101
112,01110000,43,00101011,155,10011011
6,00000110,19,00010011,25,00011001
13,00001101,21,00010101,34,00100010
104,01101000,111,01101111,215,11010111
66,01000010,28,00011100,94,01011110
82,01010010,21,00010101,103,01100111
93,01011101,54,00110110,147,10010011
19,00010011,17,00010001,36,00100100
85,01010101,10,00001010,95,01011111
82,01010010,124,01111100,206,11001110
82,01010010,15,00001111,97,01100001
93,01011101,100,01100100,193,11000001
93,01011101,76,01001100,169,10101001
52,00110100,5,00000101,57,00111001
72,01001000,82,01010010,154,10011010
127,01111111,9,00001001,136,10001000
12,00001100,37,00100101,49,00110001
38,00100110,83,01010011,121,01111001
54,00110110,24,00011000,78,01001110
73,01001001,71,01000111,144,10010000
8,00001000,51,00110011,59,00111011
3,00000011,99,01100011,102,01100110
64,01000000,70,01000110,134,10000110
104,01101000,24,00011000,128,10000000
52,00110100,22,00010110,74,01001010
126,01111110,102,01100110,228,11100100
11,00001011,52,00110100,63,00111111
115,01110011,122,01111010,237,11101101
79,01001111,28,00011100,107,01101011
22,00010110,70,01000110,92,01011100
108,01101100,94,01011110,202,11001010
116,01110100,53,00110101,169,10101001
28,00011100,91,01011011,119,01110111
16,00010000,8,00001000,24,00011000
74,01001010,8,00001000,82,01010010
75,01001011,121,01111001,196,11000100
66,01000010,42,00101010,108,01101100
79,01001111,21,00010101,100,01100100
18,00010010,68,01000100,86,01010110
91,01011011,36,00100100,127,01111111
56,00111000,112,01110000,168,10101000
44,00101100,76,01001100,120,01111000
123,01111011,106,01101010,229,11100101
108,01101100,4,00000100,112,01110000
124,01111100,9,00001001,133,10000101
45,00101101,9,00001001,54,00110110
126,01111110,27,00011011,153,10011001
72,01001000,80,01010000,152,10011000
49,00110001,54,00110110,103,01100111
31,00011111,72,01001000,103,01100111
60,00111100,38,00100110,98,01100010
57,00111001,8,00001000,65,01000001
63,00111111,12,00001100,75,01001011
123,01111011,96,01100000,219,11011011
116,01110100,10,00001010,126,01111110
66,01000010,1,00000001,67,01000011
97,01100001,43,00101011,140,10001100
25,00011001,56,00111000,81,01010001
17,00010001,15,00001111,32,00100000
55,00110111,127,01111111,182,10110110
88,01011000,91,01011011,179,10110011
33,00100001,106,01101010,139,10001011
18,00010010,78,01001110,96,01100000
108,01101100,74,01001010,182,10110110
0,00000000,6,00000110,6,00000110
1,00000001,86,01010110,87,01010111
14,00001110,36,00100100,50,00110010
50,00110010,114,01110010,164,10100100
46,00101110,43,00101011,89,01011001
114,01110010,51,00110011,165,10100101
28,00011100,107,01101011,135,10000111
42,00101010,111,01101111,153,10011001
85,01010101,119,01110111,204,11001100
40,00101000,47,00101111,87,01010111
27,00011011,5,00000101,32,00100000
67,01000011,92,01011100,159,10011111
90,01011010,2,00000010,92,01011100
96,01100000,110,01101110,206,11001110
94,01011110,12,00001100,106,01101010
44,00101100,14,00001110,58,00111010
72,01001000,124,01111100,196,11000100
113,01110001,14,00001110,127,01111111
10,00001010,62,00111110,72,01001000
32,00100000,28,00011100,60,00111100
46,00101110,14,00001110,60,00111100
43,00101011,10,00001010,53,00110101
119,01110111,109,01101101,228,11100100
7,00000111,26,00011010,33,00100001
85,01010101,124,01111100,209,11010001
62,00111110,127,01111111,189,10111101
23,00010111,109,01101101,132,10000100
100,01100100,117,01110101,217,11011001
38,00100110,112,01110000,150,10010110
45,00101101,97,01100001,142,10001110
67,01000011,29,00011101,96,01100000
13,00001101,2,00000010,15,00001111
54,00110110,70,01000110,124,01111100
29,00011101,33,00100001,62,00111110
16,00010000,105,01101001,121,01111001
1,00000001,40,00101000,41,00101001
1,00000001,92,01011100,93,01011101
58,00111010,119,01110111,177,10110001
85,01010101,17,00010001,102,01100110
23,00010111,107,01101011,130,10000010
40,00101000,5,00000101,45,00101101
111,01101111,113,01110001,224,11100000
7,00000111,15,00001111,22,00010110
37,00100101,31,00011111,68,01000100
110,01101110,31,00011111,141,10001101
1,00000001,51,00110011,52,00110100
30,00011110,14,00001110,44,00101100
65,01000001,86,01010110,151,10010111
10,00001010,68,01000100,78,01001110
28,00011100,20,00010100,48,00110000
90,01011010,12,00001100,102,01100110
91,01011011,37,00100101,128,10000000
19,00010011,118,01110110,137,10001001
49,00110001,5,00000101,54,00110110
88,01011000,41,00101001,129,10000001
44,00101100,34,00100010,78,01001110
46,00101110,26,00011010,72,01001000
41,00101001,110,01101110,151,10010111
124,01111100,11,00001011,135,10000111
111,01101111,73,01001001,184,10111000
70,01000110,120,01111000,190,10111110
18,00010010,96,01100000,114,01110010
13,00001101,45,00101101,58,00111010
75,01001011,46,00101110,121,01111001
13,00001101,29,00011101,42,00101010
90,01011010,97,01100001,187,10111011
11,00001011,32,00100000,43,00101011
40,00101000,124,01111100,164,10100100
95,01011111,10,00001010,105,01101001
115,01110011,44,00101100,159,10011111
21,00010101,98,01100010,119,01110111
49,00110001,74,01001010,123,01111011
102,01100110,62,00111110,164,10100100
114,01110010,11,00001011,125,01111101
1,00000001,127,01111111,128,10000000
88,01011000,73,01001001,161,10100001
89,01011001,16,00010000,105,01101001
118,01110110,92,01011100,210,11010010
124,01111100,41,00101001,165,10100101
24,00011000,1,00000001,25,00011001
15,00001111,28,00011100,43,00101011
118,01110110,14,00001110,132,10000100
6,00000110,39,00100111,45,00101101
43,00101011,28,00011100,71,01000111
76,01001100,113,01110001,189,10111101
64,01000000,26,00011010,90,01011010
6,00000110,71,01000111,77,01001101
80,01010000,98,01100010,178,10110010
99,01100011,82,01010010,181,10110101
16,00010000,113,01110001,129,10000001
86,01010110,35,00100011,121,01111001
85,01010101,81,01010001,166,10100110
0,00000000,32,00100000,32,00100000
120,01111000,16,00010000,136,10001000
116,01110100,111,01101111,227,11100011
114,01110010,18,00010010,132,10000100
77,01001101,97,01100001,174,10101110
22,00010110,98,01100010,120,01111000
51,00110011,111,01101111,162,10100010
104,01101000,59,00111011,163,10100011
31,00011111,34,00100010,65,01000001
101,01100101,114,01110010,215,11010111
119,01110111,124,01111100,243,11110011
97,01100001,24,00011000,121,01111001
92,01011100,105,01101001,197,11000101
75,01001011,21,00010101,96,01100000
82,01010010,85,01010101,167,10100111
13,00001101,103,01100111,116,01110100
66,01000010,117,01110101,183,10110111
35,00100011,36,00100100,71,01000111
24,00011000,39,00100111,63,00111111
75,01001011,84,01010100,159,10011111
58,00111010,27,00011011,85,01010101
82,01010010,29,00011101,111,01101111
48,00110000,79,01001111,127,01111111
8,00001000,11,00001011,19,00010011
106,01101010,50,00110010,156,10011100
26,00011010,98,01100010,124,01111100
14,00001110,94,01011110,108,01101100
101,01100101,47,00101111,148,10010100
79,01001111,124,01111100,203,11001011
16,00010000,23,00010111,39,00100111
64,01000000,6,00000110,70,01000110
76,01001100,56,00111000,132,10000100
89,01011001,93,01011101,182,10110110
114,01110010,74,01001010,188,10111100
25,00011001,83,01010011,108,01101100
106,01101010,80,01010000,186,10111010
44,00101100,94,01011110,138,10001010
1,00000001,64,01000000,65,01000001
92,01011100,77,01001101,169,10101001
94,01011110,75,01001011,169,10101001
59,00111011,52,00110100,111,01101111
119,01110111,6,00000110,125,01111101
41,00101001,57,00111001,98,01100010
34,00100010,110,01101110,144,10010000
56,00111000,79,01001111,135,10000111
54,00110110,121,01111001,175,10101111
78,01001110,24,00011000,102,01100110
120,01111000,41,00101001,161,10100001
23,00010111,44,00101100,67,01000011
30,00011110,94,01011110,124,01111100
103,01100111,3,00000011,106,01101010
26,00011010,85,01010101,111,01101111
26,00011010,61,00111101,87,01010111
81,01010001,96,01100000,177,10110001
19,00010011,72,01001000,91,01011011
59,00111011,8,00001000,67,01000011
9,00001001,109,01101101,118,01110110
88,01011000,24,00011000,112,01110000
31,00011111,14,00001110,45,00101101
17,00010001,13,00001101,30,00011110
114,01110010,120,01111000,234,11101010
5,00000101,75,01001011,80,01010000
80,01010000,80,01010000,160,10100000
72,01001000,21,00010101,93,01011101
59,00111011,123,01111011,182,10110110
55,00110111,45,00101101,100,01100100
52,00110100,127,01111111,179,10110011
35,00100011,57,00111001,92,01011100
66,01000010,1,00000001,67,01000011
61,00111101,112,01110000,173,10101101
7,00000111,99,01100011,106,01101010
54,00110110,29,00011101,83,01010011
57,00111001,17,00010001,74,01001010
61,00111101,84,01010100,145,10010001
15,00001111,33,00100001,48,00110000
112,01110000,101,01100101,213,11010101
0,00000000,82,01010010,82,01010010
61,00111101,21,00010101,82,01010010
18,00010010,125,01111101,143,10001111
59,00111011,16,00010000,75,01001011
82,01010010,70,01000110,152,10011000
71,01000111,51,00110011,122,01111010
104,01101000,35,00100011,139,10001011
26,00011010,39,00100111,65,01000001
45,00101101,125,01111101,170,10101010
81,01010001,48,00110000,129,10000001
4,00000100,95,01011111,99,01100011
56,00111000,63,00111111,119,01110111
0,00000000,59,00111011,59,00111011
73,01001001,84,01010100,157,10011101
117,01110101,87,01010111,204,11001100
51,00110011,50,00110010,101,01100101
98,01100010,4,00000100,102,01100110
61,00111101,82,01010010,143,10001111
67,01000011,113,01110001,180,10110100
60,00111100,56,00111000,116,01110100
58,00111010,54,00110110,112,01110000
112,01110000,60,00111100,172,10101100
127,01111111,47,00101111,174,10101110
73,01001001,78,01001110,151,10010111
36,00100100,3,00000011,39,00100111
102,01100110,95,01011111,197,11000101
68,01000100,124,01111100,192,11000000
47,00101111,54,00110110,101,01100101
84,01010100,73,01001001,157,10011101
103,01100111,113,01110001,216,11011000
29,00011101,95,01011111,124,01111100
83,01010011,116,01110100,199,11000111
62,00111110,7,00000111,69,01000101
54,00110110,94,01011110,148,10010100
46,00101110,33,00100001,79,01001111
43,00101011,62,00111110,105,01101001
118,01110110,2,00000010,120,01111000
91,01011011,9,00001001,100,01100100
95,01011111,39,00100111,134,10000110
62,00111110,49,00110001,111,01101111
13,00001101,15,00001111,28,00011100
81,01010001,65,01000001,146,10010010
123,01111011,50,00110010,173,10101101
87,01010111,40,00101000,127,01111111
126,01111110,58,00111010,184,10111000
48,00110000,20,00010100,68,01000100
40,00101000,36,00100100,76,01001100
62,00111110,116,01110100,178,10110010
117,01110101,111,01101111,228,11100100
41,00101001,119,01110111,160,10100000
20,00010100,69,01000101,89,01011001
46,00101110,21,00010101,67,01000011
45,00101101,64,01000000,109,01101101
75,01001011,88,01011000,163,10100011
7,00000111,50,00110010,57,00111001
51,00110011,69,01000101,120,01111000
110,01101110,105,01101001,215,11010111
101,01100101,21,00010101,122,01111010
9,00001001,41,00101001,50,00110010
53,00110101,95,01011111,148,10010100
76,01001100,57,00111001,133,10000101
7,00000111,98,01100010,105,01101001
52,00110100,121,01111001,173,10101101
103,01100111,40,00101000,143,10001111
90,01011010,114,01110010,204,11001100
88,01011000,78,01001110,166,10100110
78,01001110,125,01111101,203,11001011
2,00000010,97,01100001,99,01100011
102,01100110,56,00111000,158,10011110
13,00001101,27,00011011,40,00101000
79,01001111,5,00000101,84,01010100
52,00110100,10,00001010,62,00111110
5,00000101,15,00001111,20,00010100
26,00011010,14,00001110,40,00101000
19,00010011,42,00101010,61,00111101
2,00000010,101,01100101,103,01100111
108,01101100,61,00111101,169,10101001
42,00101010,54,00110110,96,01100000
107,01101011,91,01011011,198,11000110
5,00000101,3,00000011,8,00001000
74,01001010,85,01010101,159,10011111
96,01100000,13,00001101,109,01101101
59,00111011,0,00000000,59,00111011
56,00111000,53,00110101,109,01101101
35,00100011,37,00100101,72,01001000
100,01100100,23,00010111,123,01111011
90,01011010,88,01011000,178,10110010
112,01110000,35,00100011,147,10010011
41,00101001,91,01011011,132,10000100
77,01001101,120,01111000,197,11000101
103,01100111,25,00011001,128,10000000
95,01011111,52,00110100,147,10010011
34,00100010,70,01000110,104,01101000
115,01110011,71,01000111,186,10111010
99,01100011,43,00101011,142,10001110
38,00100110,95,01011111,133,10000101
49,00110001,30,00011110,79,01001111
1,00000001,21,00010101,22,00010110
48,00110000,17,00010001,65,01000001
1,00000001,70,01000110,71,01000111
42,00101010,101,01100101,143,10001111
34,00100010,120,01111000,154,10011010
52,00110100,86,01010110,138,10001010
86,01010110,97,01100001,183,10110111
7,00000111,33,00100001,40,00101000
80,01010000,65,01000001,145,10010001
54,00110110,31,00011111,85,01010101
59,00111011,11,00001011,70,01000110
58,00111010,102,01100110,160,10100000
69,01000101,90,01011010,159,10011111
67,01000011,53,00110101,120,01111000
106,01101010,84,01010100,190,10111110
79,01001111,4,00000100,83,01010011
86,01010110,22,00010110,108,01101100
53,00110101,34,00100010,87,01010111
18,00010010,74,01001010,92,01011100
61,00111101,112,01110000,173,10101101
94,01011110,126,01111110,220,11011100
109,01101101,115,01110011,224,11100000
14,00001110,13,00001101,27,00011011
7,00000111,115,01110011,122,01111010
27,00011011,114,01110010,141,10001101
86,01010110,66,01000010,152,10011000
106,01101010,98,01100010,204,11001100
32,00100000,80,01010000,112,01110000
99,01100011,6,00000110,105,01101001
67,01000011,85,01010101,152,10011000
35,00100011,17,00010001,52,00110100
90,01011010,17,00010001,107,01101011
90,01011010,105,01101001,195,11000011
77,01001101,22,00010110,99,01100011
70,01000110,115,01110011,185,10111001
106,01101010,25,00011001,131,10000011
92,01011100,99,01100011,191,10111111
57,00111001,7,00000111,64,01000000
116,01110100,31,00011111,147,10010011
118,01110110,78,01001110,196,11000100
60,00111100,51,00110011,111,01101111
111,01101111,42,00101010,153,10011001
23,00010111,22,00010110,45,00101101
111,01101111,109,01101101,220,11011100
104,01101000,15,00001111,119,01110111
114,01110010,123,01111011,237,11101101
74,01001010,102,01100110,176,10110000
111,01101111,91,01011011,202,11001010
72,01001000,82,01010010,154,10011010
4,00000100,105,01101001,109,01101101
2,00000010,2,00000010,4,00000100
57,00111001,80,01010000,137,10001001
14,00001110,58,00111010,72,01001000
38,00100110,4,00000100,42,00101010
46,00101110,75,01001011,121,01111001
97,01100001,40,00101000,137,10001001
34,00100010,28,00011100,62,00111110
58,00111010,36,00100100,94,01011110
58,00111010,49,00110001,107,01101011
104,01101000,55,00110111,159,10011111
97,01100001,38,00100110,135,10000111
32,00100000,116,01110100,148,10010100
29,00011101,122,01111010,151,10010111
62,00111110,30,00011110,92,01011100
69,01000101,74,01001010,143,10001111
16,00010000,93,01011101,109,01101101
42,00101010,38,00100110,80,01010000
51,00110011,30,00011110,81,01010001
77,01001101,70,01000110,147,10010011
107,01101011,104,01101000,211,11010011
101,01100101,64,01000000,165,10100101
86,01010110,99,01100011,185,10111001
109,01101101,69,01000101,178,10110010
106,01101010,71,01000111,177,10110001
112,01110000,113,01110001,225,11100001
105,01101001,113,01110001,218,11011010
126,01111110,70,01000110,196,11000100
93,01011101,30,00011110,123,01111011
78,01001110,59,00111011,137,10001001
2,00000010,54,00110110,56,00111000
16,00010000,65,01000001,81,01010001
3,00000011,68,01000100,71,01000111
6,00000110,40,00101000,46,00101110
18,00010010,91,01011011,109,01101101
69,01000101,99,01100011,168,10101000
121,01111001,5,00000101,126,01111110
124,01111100,87,01010111,211,11010011
65,01000001,74,01001010,139,10001011
105,01101001,96,01100000,201,11001001
18,00010010,23,00010111,41,00101001
126,01111110,116,01110100,242,11110010
121,01111001,0,00000000,121,01111001
74,01001010,43,00101011,117,01110101
71,01000111,38,00100110,109,01101101
9,00001001,104,01101000,113,01110001
44,00101100,123,01111011,167,10100111
114,01110010,115,01110011,229,11100101
108,01101100,51,00110011,159,10011111
92,01011100,90,01011010,182,10110110
79,01001111,13,00001101,92,01011100
79,01001111,79,01001111,158,10011110
16,00010000,23,00010111,39,00100111
45,00101101,114,01110010,159,10011111
89,01011001,60,00111100,149,10010101
21,00010101,24,00011000,45,00101101
82,01010010,81,01010001,163,10100011
93,01011101,109,01101101,202,11001010
78,01001110,55,00110111,133,10000101
98,01100010,22,00010110,120,01111000
39,00100111,35,00100011,74,01001010
126,01111110,127,01111111,253,11111101
43,00101011,91,01011011,134,10000110
34,00100010,102,01100110,136,10001000
11,00001011,70,01000110,81,01010001
123,01111011,99,01100011,222,11011110
97,01100001,121,01111001,218,11011010
7,00000111,90,01011010,97,01100001
28,00011100,51,00110011,79,01001111
66,01000010,67,01000011,133,10000101
94,01011110,13,00001101,107,01101011
21,00010101,61,00111101,82,01010010
111,01101111,15,00001111,126,01111110
96,01100000,100,01100100,196,11000100
40,00101000,106,01101010,146,10010010
34,00100010,42,00101010,76,01001100
77,01001101,68,01000100,145,10010001
106,01101010,106,01101010,212,11010100
69,01000101,121,01111001,190,10111110
114,01110010,44,00101100,158,10011110
113,01110001,54,00110110,167,10100111
49,00110001,107,01101011,156,10011100
29,00011101,111,01101111,140,10001100
123,01111011,21,00010101,144,10010000
51,00110011,15,00001111,66,01000010
7,00000111,38,00100110,45,00101101
29,00011101,76,01001100,105,01101001
93,01011101,117,01110101,210,11010010
1,00000001,88,01011000,89,01011001
61,00111101,31,00011111,92,01011100
10,00001010,43,00101011,53,00110101
112,01110000,36,00100100,148,10010100
31,00011111,85,01010101,116,01110100
18,00010010,103,01100111,121,01111001
18,00010010,61,00111101,79,01001111
107,01101011,25,00011001,132,10000100
112,01110000,86,01010110,198,11000110
86,01010110,52,00110100,138,10001010
47,00101111,79,01001111,126,01111110
79,01001111,15,00001111,94,01011110
20,00010100,43,00101011,63,00111111
16,00010000,31,00011111,47,00101111
48,00110000,99,01100011,147,10010011
67,01000011,107,01101011,174,10101110
103,01100111,27,00011011,130,10000010
101,01100101,6,00000110,107,01101011
101,01100101,41,00101001,142,10001110
81,01010001,75,01001011,156,10011100
11,00001011,45,00101101,56,00111000
12,00001100,121,01111001,133,10000101
64,01000000,102,01100110,166,10100110
35,00100011,7,00000111,42,00101010
57,00111001,93,01011101,150,10010110
78,01001110,79,01001111,157,10011101
52,00110100,45,00101101,97,01100001
78,01001110,94,01011110,172,10101100
5,00000101,102,01100110,107,01101011
32,00100000,73,01001001,105,01101001
51,00110011,119,01110111,170,10101010
33,00100001,48,00110000,81,01010001
36,00100100,126,01111110,162,10100010
124,01111100,47,00101111,171,10101011
105,01101001,66,01000010,171,10101011
85,01010101,125,01111101,210,11010010
109,01101101,104,01101000,213,11010101
89,01011001,88,01011000,177,10110001
99,01100011,115,01110011,214,11010110
21,00010101,118,01110110,139,10001011
48,00110000,69,01000101,117,01110101
109,01101101,26,00011010,135,10000111
79,01001111,101,01100101,180,10110100
103,01100111,33,00100001,136,10001000
42,00101010,92,01011100,134,10000110
123,01111011,26,00011010,149,10010101
32,00100000,2,00000010,34,00100010
10,00001010,63,00111111,73,01001001
98,01100010,123,01111011,221,11011101
6,00000110,57,00111001,63,00111111
6,00000110,19,00010011,25,00011001
63,00111111,99,01100011,162,10100010
88,01011000,114,01110010,202,11001010
20,00010100,120,01111000,140,10001100
52,00110100,95,01011111,147,10010011
76,01001100,26,00011010,102,01100110
64,01000000,114,01110010,178,10110010
81,01010001,47,00101111,128,10000000
90,01011010,44,00101100,134,10000110
45,00101101,53,00110101,98,01100010
82,01010010,85,01010101,167,10100111
118,01110110,70,01000110,188,10111100
21,00010101,82,01010010,103,01100111
118,01110110,25,00011001,143,10001111
55,00110111,26,00011010,81,01010001
86,01010110,117,01110101,203,11001011
126,01111110,116,01110100,242,11110010
31,00011111,76,01001100,107,01101011
116,01110100,123,01111011,239,11101111
99,01100011,127,01111111,226,11100010
124,01111100,67,01000011,191,10111111
85,01010101,50,00110010,135,10000111
1,00000001,123,01111011,124,01111100
84,01010100,87,01010111,171,10101011
119,01110111,5,00000101,124,01111100
123,01111011,66,01000010,189,10111101
108,01101100,35,00100011,143,10001111
44,00101100,111,01101111,155,10011011
28,00011100,106,01101010,134,10000110
121,01111001,67,01000011,188,10111100
52,00110100,46,00101110,98,01100010
72,01001000,47,00101111,119,01110111
0,00000000,7,00000111,7,00000111
89,01011001,63,00111111,152,10011000
88,01011000,18,00010010,106,01101010
36,00100100,35,00100011,71,01000111
90,01011010,50,00110010,140,10001100
42,00101010,55,00110111,97,01100001
124,01111100,4,00000100,128,10000000
25,00011001,20,00010100,45,00101101
78,01001110,100,01100100,178,10110010
30,00011110,56,00111000,86,01010110
75,01001011,63,00111111,138,10001010
57,00111001,98,01100010,155,10011011
59,00111011,30,00011110,89,01011001
75,01001011,99,01100011,174,10101110
36,00100100,60,00111100,96,01100000
74,01001010,85,01010101,159,10011111
77,01001101,112,01110000,189,10111101
30,00011110,16,00010000,46,00101110
57,00111001,103,01100111,160,10100000
12,00001100,110,01101110,122,01111010
29,00011101,96,01100000,125,01111101
70,01000110,24,00011000,94,01011110
55,00110111,22,00010110,77,01001101
43,00101011,0,00000000,43,00101011
24,00011000,123,01111011,147,10010011
58,00111010,127,01111111,185,10111001
111,01101111,39,00100111,150,10010110
68,01000100,60,00111100,128,10000000
125,01111101,90,01011010,215,11010111
63,00111111,40,00101000,103,01100111
2,00000010,116,01110100,118,01110110
2,00000010,104,01101000,106,01101010
1,00000001,78,01001110,79,01001111
58,00111010,115,01110011,173,10101101
7,00000111,43,00101011,50,00110010
62,00111110,121,01111001,183,10110111
13,00001101,81,01010001,94,01011110
23,00010111,25,00011001,48,00110000
82,01010010,71,01000111,153,10011001
123,01111011,13,00001101,136,10001000
46,00101110,58,00111010,104,01101000
51,00110011,109,01101101,160,10100000
50,00110010,10,00001010,60,00111100
20,00010100,57,00111001,77,01001101
53,00110101,9,00001001,62,00111110
57,00111001,14,00001110,71,01000111
34,00100010,0,00000000,34,00100010
27,00011011,116,01110100,143,10001111
43,00101011,88,01011000,131,10000011
1,00000001,114,01110010,115,01110011
72,01001000,68,01000100,140,10001100
15,00001111,100,01100100,115,01110011
119,01110111,50,00110010,169,10101001
84,01010100,53,00110101,137,10001001
7,00000111,68,01000100,75,01001011
63,00111111,99,01100011,162,10100010
61,00111101,85,01010101,146,10010010
75,01001011,53,00110101,128,10000000
58,00111010,58,00111010,116,01110100
25,00011001,7,00000111,32,00100000
123,01111011,73,01001001,196,11000100
83,01010011,68,01000100,151,10010111
39,00100111,74,01001010,113,01110001
5,00000101,44,00101100,49,00110001
18,00010010,83,01010011,101,01100101
117,01110101,14,00001110,131,10000011
61,00111101,77,01001101,138,10001010
4,00000100,119,01110111,123,01111011
60,00111100,126,01111110,186,10111010
126,01111110,55,00110111,181,10110101
60,00111100,117,01110101,177,10110001
111,01101111,41,00101001,152,10011000
50,00110010,101,01100101,151,10010111
106,01101010,68,01000100,174,10101110
88,01011000,42,00101010,130,10000010
112,01110000,92,01011100,204,11001100
16,00010000,38,00100110,54,00110110
35,00100011,121,01111001,156,10011100
67,01000011,103,01100111,170,10101010
127,01111111,45,00101101,172,10101100
44,00101100,106,01101010,150,10010110
7,00000111,1,00000001,8,00001000
3,00000011,32,00100000,35,00100011
19,00010011,117,01110101,136,10001000
27,00011011,74,01001010,101,01100101
107,01101011,17,00010001,124,01111100
73,01001001,93,01011101,166,10100110
99,01100011,35,00100011,134,10000110
104,01101000,63,00111111,167,10100111
59,00111011,52,00110100,111,01101111
48,00110000,74,01001010,122,01111010
53,00110101,44,00101100,97,01100001
60,00111100,93,01011101,153,10011001
40,00101000,45,00101101,85,01010101
34,00100010,122,01111010,156,10011100
36,00100100,122,01111010,158,10011110
69,01000101,67,01000011,136,10001000
55,00110111,99,01100011,154,10011010
78,01001110,4,00000100,82,01010010
3,00000011,59,00111011,62,00111110
62,00111110,109,01101101,171,10101011
77,01001101,80,01010000,157,10011101
58,00111010,97,01100001,155,10011011
5,00000101,43,00101011,48,00110000
119,01110111,93,01011101,212,11010100
83,01010011,120,01111000,203,11001011
53,00110101,24,00011000,77,01001101
111,01101111,57,00111001,168,10101000
12,00001100,31,00011111,43,00101011
116,01110100,79,01001111,195,11000011
30,00011110,56,00111000,86,01010110
116,01110100,34,00100010,150,10010110
64,01000000,115,01110011,179,10110011
5,00000101,72,01001000,77,01001101
117,01110101,99,01100011,216,11011000
29,00011101,126,01111110,155,10011011
65,01000001,99,01100011,164,10100100
57,00111001,51,00110011,108,01101100
57,00111001,38,00100110,95,01011111
67,01000011,24,00011000,91,01011011
102,01100110,38,00100110,140,10001100
8,00001000,15,00001111,23,00010111
62,00111110,72,01001000,134,10000110
11,00001011,102,01100110,113,01110001
66,01000010,103,01100111,169,10101001
104,01101000,97,01100001,201,11001001
123,01111011,70,01000110,193,11000001
122,01111010,18,00010010,140,10001100
74,01001010,57,00111001,131,10000011
38,00100110,24,00011000,62,00111110
70,01000110,10,00001010,80,01010000
24,00011000,119,01110111,143,10001111
55,00110111,14,00001110,69,01000101
3,00000011,5,00000101,8,00001000
105,01101001,87,01010111,192,11000000
104,01101000,21,00010101,125,01111101
64,01000000,16,00010000,80,01010000
1,00000001,25,00011001,26,00011010
95,01011111,40,00101000,135,10000111
65,01000001,108,01101100,173,10101101
92,01011100,122,01111010,214,11010110
99,01100011,31,00011111,130,10000010
104,01101000,105,01101001,209,11010001
60,00111100,27,00011011,87,01010111
78,01001110,126,01111110,204,11001100
7,00000111,46,00101110,53,00110101
50,00110010,49,00110001,99,01100011
116,01110100,25,00011001,141,10001101
11,00001011,76,01001100,87,01010111
76,01001100,47,00101111,123,01111011
16,00010000,8,00001000,24,00011000
12,00001100,35,00100011,47,00101111
41,00101001,53,00110101,94,01011110
0,00000000,126,01111110,126,01111110
70,01000110,97,01100001,167,10100111
58,00111010,81,01010001,139,10001011
76,01001100,10,00001010,86,01010110
37,00100101,10,00001010,47,00101111
4,00000100,8,00001000,12,00001100
109,01101101,48,00110000,157,10011101
40,00101000,10,00001010,50,00110010
124,01111100,104,01101000,228,11100100
67,01000011,82,01010010,149,10010101
107,01101011,75,01001011,182,10110110
38,00100110,73,01001001,111,01101111
115,01110011,50,00110010,165,10100101
74,01001010,34,00100010,108,01101100
34,00100010,125,01111101,159,10011111
43,00101011,95,01011111,138,10001010
81,01010001,108,01101100,189,10111101
95,01011111,38,00100110,133,10000101
40,00101000,71,01000111,111,01101111
21,00010101,92,01011100,113,01110001
75,01001011,32,00100000,107,01101011
33,00100001,36,00100100,69,01000101
116,01110100,51,00110011,167,10100111
9,00001001,68,01000100,77,01001101
9,00001001,110,01101110,119,01110111
50,00110010,11,00001011,61,00111101
67,01000011,0,00000000,67,01000011
119,01110111,44,00101100,163,10100011
19,00010011,90,01011010,109,01101101
25,00011001,115,01110011,140,10001100
9,00001001,9,00001001,18,00010010
14,00001110,88,01011000,102,01100110
101,01100101,94,01011110,195,11000011
72,01001000,121,01111001,193,11000001
26,00011010,83,01010011,109,01101101
68,01000100,85,01010101,153,10011001
105,01101001,6,00000110,111,01101111
86,01010110,38,00100110,124,01111100
95,01011111,51,00110011,146,10010010
98,01100010,97,01100001,195,11000011
63,00111111,69,01000101,132,10000100
36,00100100,34,00100010,70,01000110
35,00100011,18,00010010,53,00110101
112,01110000,34,00100010,146,10010010
81,01010001,126,01111110,207,11001111
95,01011111,38,00100110,133,10000101
42,00101010,29,00011101,71,01000111
32,00100000,35,00100011,67,01000011
115,01110011,109,01101101,224,11100000
66,01000010,43,00101011,109,01101101
3,00000011,41,00101001,44,00101100
75,01001011,11,00001011,86,01010110
127,01111111,96,01100000,223,11011111
82,01010010,52,00110100,134,10000110
102,01100110,123,01111011,225,11100001
36,00100100,57,00111001,93,01011101
21,00010101,24,00011000,45,00101101
64,01000000,29,00011101,93,01011101
26,00011010,109,01101101,135,10000111
1,00000001,103,01100111,104,01101000
21,00010101,81,01010001,102,01100110
125,01111101,114,01110010,239,11101111
60,00111100,39,00100111,99,01100011
102,01100110,96,01100000,198,11000110
32,00100000,103,01100111,135,10000111
36,00100100,34,00100010,70,01000110
34,00100010,54,00110110,88,01011000
27,00011011,78,01001110,105,01101001
20,00010100,83,01010011,103,01100111
117,01110101,71,01000111,188,10111100
14,00001110,41,00101001,55,00110111
96,01100000,69,01000101,165,10100101
111,01101111,100,01100100,211,11010011
124,01111100,58,00111010,182,10110110
92,01011100,109,01101101,201,11001001
47,00101111,28,00011100,75,01001011
30,00011110,13,00001101,43,00101011
69,01000101,46,00101110,115,01110011
91,01011011,82,01010010,173,10101101
20,00010100,22,00010110,42,00101010
39,00100111,70,01000110,109,01101101
101,01100101,115,01110011,216,11011000
94,01011110,54,00110110,148,10010100
100,01100100,16,00010000,116,01110100
112,01110000,47,00101111,159,10011111
14,00001110,112,01110000,126,01111110
107,01101011,63,00111111,170,10101010
88,01011000,30,00011110,118,01110110
82,01010010,127,01111111,209,11010001
13,00001101,42,00101010,55,00110111
43,00101011,62,00111110,105,01101001
70,01000110,126,01111110,196,11000100
16,00010000,120,01111000,136,10001000
13,00001101,123,01111011,136,10001000
49,00110001,50,00110010,99,01100011
44,00101100,91,01011011,135,10000111
33,00100001,45,00101101,78,01001110
101,01100101,67,01000011,168,10101000
116,01110100,68,01000100,184,10111000
48,00110000,122,01111010,170,10101010
67,01000011,70,01000110,137,10001001
35,00100011,17,00010001,52,00110100
3,00000011,100,01100100,103,01100111
99,01100011,50,00110010,149,10010101
92,01011100,62,00111110,154,10011010
20,00010100,53,00110101,73,01001001
125,01111101,41,00101001,166,10100110
77,01001101,30,00011110,107,01101011
13,00001101,34,00100010,47,00101111
123,01111011,38,00100110,161,10100001
122,01111010,46,00101110,168,10101000
109,01101101,120,01111000,229,11100101
87,01010111,84,01010100,171,10101011
99,01100011,104,01101000,203,11001011
12,00001100,65,01000001,77,01001101
104,01101000,124,01111100,228,11100100
29,00011101,7,00000111,36,00100100
26,00011010,87,01010111,113,01110001
53,00110101,9,00001001,62,00111110
24,00011000,124,01111100,148,10010100
80,01010000,87,01010111,167,10100111
18,00010010,31,00011111,49,00110001
95,01011111,103,01100111,198,11000110
102,01100110,23,00010111,125,01111101
27,00011011,65,01000001,92,01011100
33,00100001,2,00000010,35,00100011
5,00000101,26,00011010,31,00011111
8,00001000,31,00011111,39,00100111
108,01101100,63,00111111,171,10101011
73,01001001,64,01000000,137,10001001
124,01111100,106,01101010,230,11100110
0,00000000,53,00110101,53,00110101
83,01010011,74,01001010,157,10011101
39,00100111,87,01010111,126,01111110
45,00101101,26,00011010,71,01000111
31,00011111,113,01110001,144,10010000
86,01010110,20,00010100,106,01101010
118,01110110,115,01110011,233,11101001
8,00001000,125,01111101,133,10000101
76,01001100,40,00101000,116,01110100
111,01101111,7,00000111,118,01110110
82,01010010,124,01111100,206,11001110
105,01101001,22,00010110,127,01111111
85,01010101,2,00000010,87,01010111
114,01110010,75,01001011,189,10111101
80,01010000,45,00101101,125,01111101
73,01001001,73,01001001,146,10010010
1,00000001,23,00010111,24,00011000
63,00111111,58,00111010,121,01111001
7,00000111,34,00100010,41,00101001
119,01110111,15,00001111,134,10000110
22,00010110,51,00110011,73,01001001
86,01010110,111,01101111,197,11000101
84,01010100,120,01111000,204,11001100
64,01000000,111,01101111,175,10101111
94,01011110,122,01111010,216,11011000
5,00000101,91,01011011,96,01100000
32,00100000,53,00110101,85,01010101
56,00111000,91,01011011,147,10010011
120,01111000,47,00101111,167,10100111
14,00001110,11,00001011,25,00011001
63,00111111,44,00101100,107,01101011
109,01101101,16,00010000,125,01111101
37,00100101,122,01111010,159,10011111
63,00111111,18,00010010,81,01010001
21,00010101,41,00101001,62,00111110
42,00101010,30,00011110,72,01001000
115,01110011,56,00111000,171,10101011
1,00000001,75,01001011,76,01001100
10,00001010,110,01101110,120,01111000
12,00001100,6,00000110,18,00010010
122,01111010,113,01110001,235,11101011
108,01101100,125,01111101,233,11101001
82,01010010,70,01000110,152,10011000
117,01110101,3,00000011,120,01111000
16,00010000,44,00101100,60,00111100
10,00001010,77,01001101,87,01010111
126,01111110,12,00001100,138,10001010
41,00101001,44,00101100,85,01010101
53,00110101,120,01111000,173,10101101
61,00111101,38,00100110,99,01100011
7,00000111,117,01110101,124,01111100
122,01111010,96,01100000,218,11011010
94,01011110,74,01001010,168,10101000
32,00100000,103,01100111,135,10000111
51,00110011,82,01010010,133,10000101
80,01010000,99,01100011,179,10110011
31,00011111,61,00111101,92,01011100
98,01100010,52,00110100,150,10010110
8,00001000,68,01000100,76,01001100
108,01101100,13,00001101,121,01111001
121,01111001,45,00101101,166,10100110
5,00000101,51,00110011,56,00111000
82,01010010,7,00000111,89,01011001
105,01101001,42,00101010,147,10010011
21,00010101,10,00001010,31,00011111
127,01111111,74,01001010,201,11001001
17,00010001,68,01000100,85,01010101
25,00011001,2,00000010,27,00011011
113,01110001,106,01101010,219,11011011
126,01111110,118,01110110,244,11110100
94,01011110,17,00010001,111,01101111
76,01001100,116,01110100,192,11000000
119,01110111,28,00011100,147,10010011
69,01000101,6,00000110,75,01001011
87,01010111,42,00101010,129,10000001
74,01001010,19,00010011,93,01011101
103,01100111,104,01101000,207,11001111
78,01001110,101,01100101,179,10110011
32,00100000,126,01111110,158,10011110
120,01111000,55,00110111,175,10101111
28,00011100,96,01100000,124,01111100
58,00111010,120,01111000,178,10110010
39,00100111,69,01000101,108,01101100
65,01000001,44,00101100,109,01101101
72,01001000,127,01111111,199,11000111
56,00111000,73,01001001,129,10000001
127,01111111,86,01010110,213,11010101
127,01111111,62,00111110,189,10111101
109,01101101,27,00011011,136,10001000
107,01101011,40,00101000,147,10010011
4,00000100,41,00101001,45,00101101
124,01111100,97,01100001,221,11011101
68,01000100,28,00011100,96,01100000
14,00001110,2,00000010,16,00010000
90,01011010,74,01001010,164,10100100
41,00101001,108,01101100,149,10010101
88,01011000,29,00011101,117,01110101
46,00101110,19,00010011,65,01000001
3,00000011,122,01111010,125,01111101
16,00010000,1,00000001,17,00010001
44,00101100,13,00001101,57,00111001
52,00110100,75,01001011,127,01111111
98,01100010,65,01000001,163,10100011
29,00011101,67,01000011,96,01100000
20,00010100,65,01000001,85,01010101
19,00010011,83,01010011,102,01100110
5,00000101,3,00000011,8,00001000
10,00001010,41,00101001,51,00110011
3,00000011,15,00001111,18,00010010
97,01100001,3,00000011,100,01100100
105,01101001,83,01010011,188,10111100
2,00000010,122,01111010,124,01111100
15,00001111,25,00011001,40,00101000
80,01010000,44,00101100,124,01111100
24,00011000,114,01110010,138,10001010
72,01001000,88,01011000,160,10100000
11,00001011,55,00110111,66,01000010
18,00010010,14,00001110,32,00100000
42,00101010,41,00101001,83,01010011
52,00110100,111,01101111,163,10100011
61,00111101,31,00011111,92,01011100
56,00111000,51,00110011,107,01101011
48,00110000,100,01100100,148,10010100
32,00100000,12,00001100,44,00101100
118,01110110,29,00011101,147,10010011
29,00011101,22,00010110,51,00110011
66,01000010,48,00110000,114,01110010
115,01110011,52,00110100,167,10100111
78,01001110,17,00010001,95,01011111
12,00001100,42,00101010,54,00110110
108,01101100,32,00100000,140,10001100
78,01001110,74,01001010,152,10011000
57,00111001,73,01001001,130,10000010
119,01110111,10,00001010,129,10000001
26,00011010,11,00001011,37,00100101
124,01111100,99,01100011,223,11011111
13,00001101,42,00101010,55,00110111
8,00001000,25,00011001,33,00100001
93,01011101,115,01110011,208,11010000
32,00100000,77,01001101,109,01101101
64,01000000,117,01110101,181,10110101
23,00010111,123,01111011,146,10010010
16,00010000,78,01001110,94,01011110
47,00101111,49,00110001,96,01100000
72,01001000,55,00110111,127,01111111
52,00110100,124,01111100,176,10110000
95,01011111,61,00111101,156,10011100
104,01101000,90,01011010,194,11000010
21,00010101,116,01110100,137,10001001
90,01011010,29,00011101,119,01110111
108,01101100,113,01110001,221,11011101
87,01010111,6,00000110,93,01011101
33,00100001,38,00100110,71,01000111
100,01100100,84,01010100,184,10111000
0,00000000,121,01111001,121,01111001
31,00011111,76,01001100,107,01101011
81,01010001,110,01101110,191,10111111
74,01001010,16,00010000,90,01011010
106,01101010,59,00111011,165,10100101
93,01011101,28,00011100,121,01111001
122,01111010,67,01000011,189,10111101
126,01111110,125,01111101,251,11111011
44,00101100,78,01001110,122,01111010
106,01101010,38,00100110,144,10010000
104,01101000,107,01101011,211,11010011
4,00000100,34,00100010,38,00100110
116,01110100,61,00111101,177,10110001
2,00000010,126,01111110,128,10000000
34,00100010,107,01101011,141,10001101
64,01000000,22,00010110,86,01010110
38,00100110,47,00101111,85,01010101
115,01110011,63,00111111,178,10110010
83,01010011,77,01001101,160,10100000
78,01001110,55,00110111,133,10000101
75,01001011,13,00001101,88,01011000
60,00111100,40,00101000,100,01100100
74,01001010,88,01011000,162,10100010
7,00000111,11,00001011,18,00010010
90,01011010,16,00010000,106,01101010
3,00000011,25,00011001,28,00011100
91,01011011,61,00111101,152,10011000
47,00101111,13,00001101,60,00111100
102,01100110,110,01101110,212,11010100
44,00101100,119,01110111,163,10100011
104,01101000,49,00110001,153,10011001
17,00010001,28,00011100,45,00101101
36,00100100,25,00011001,61,00111101
97,01100001,33,00100001,130,10000010
30,00011110,62,00111110,92,01011100
106,01101010,88,01011000,194,11000010
44,00101100,26,00011010,70,01000110
112,01110000,112,01110000,224,11100000
70,01000110,96,01100000,166,10100110
97,01100001,39,00100111,136,10001000
82,01010010,95,01011111,177,10110001
103,01100111,84,01010100,187,10111011
55,00110111,38,00100110,93,01011101
101,01100101,23,00010111,124,01111100
48,00110000,47,00101111,95,01011111
101,01100101,3,00000011,104,01101000
95,01011111,98,01100010,193,11000001
26,00011010,70,01000110,96,01100000
9,00001001,36,00100100,45,00101101
122,01111010,102,01100110,224,11100000
63,00111111,118,01110110,181,10110101
81,01010001,65,01000001,146,10010010
67,01000011,31,00011111,98,01100010
99,01100011,124,01111100,223,11011111
61,00111101,112,01110000,173,10101101
121,01111001,108,01101100,229,11100101
93,01011101,112,01110000,205,11001101
40,00101000,89,01011001,129,10000001
70,01000110,41,00101001,111,01101111
80,01010000,16,00010000,96,01100000
96,01100000,73,01001001,169,10101001
84,01010100,2,00000010,86,01010110
110,01101110,46,00101110,156,10011100
12,00001100,113,01110001,125,01111101
126,01111110,93,01011101,219,11011011
24,00011000,107,01101011,131,10000011
124,01111100,127,01111111,251,11111011
104,01101000,46,00101110,150,10010110
92,01011100,27,00011011,119,01110111
61,00111101,37,00100101,98,01100010
37,00100101,124,01111100,161,10100001
33,00100001,0,00000000,33,00100001
63,00111111,119,01110111,182,10110110
4,00000100,59,00111011,63,00111111
33,00100001,92,01011100,125,01111101
12,00001100,107,01101011,119,01110111
18,00010010,31,00011111,49,00110001
29,00011101,52,00110100,81,01010001
18,00010010,125,01111101,143,10001111
65,01000001,33,00100001,98,01100010
114,01110010,110,01101110,224,11100000
85,01010101,16,00010000,101,01100101
40,00101000,116,01110100,156,10011100
25,00011001,61,00111101,86,01010110
95,01011111,52,00110100,147,10010011
125,01111101,79,01001111,204,11001100
61,00111101,43,00101011,104,01101000
3,00000011,39,00100111,42,00101010
101,01100101,3,00000011,104,01101000
113,01110001,89,01011001,202,11001010
117,01110101,18,00010010,135,10000111
119,01110111,94,01011110,213,11010101
89,01011001,119,01110111,208,11010000
60,00111100,30,00011110,90,01011010
38,00100110,70,01000110,108,01101100
124,01111100,88,01011000,212,11010100
63,00111111,4,00000100,67,01000011
11,00001011,31,00011111,42,00101010
45,00101101,122,01111010,167,10100111
36,00100100,13,00001101,49,00110001
48,00110000,112,01110000,160,10100000
106,01101010,79,01001111,185,10111001
17,00010001,29,00011101,46,00101110
65,01000001,55,00110111,120,01111000
114,01110010,104,01101000,218,11011010
99,01100011,77,01001101,176,10110000
2,00000010,75,01001011,77,01001101
52,00110100,102,01100110,154,10011010
103,01100111,11,00001011,114,01110010
109,01101101,123,01111011,232,11101000
1,00000001,27,00011011,28,00011100
61,00111101,71,01000111,132,10000100
48,00110000,25,00011001,73,01001001
75,01001011,58,00111010,133,10000101
18,00010010,4,00000100,22,00010110
106,01101010,60,00111100,166,10100110
10,00001010,108,01101100,118,01110110
115,01110011,49,00110001,164,10100100
58,00111010,54,00110110,112,01110000
49,00110001,0,00000000,49,00110001
5,00000101,48,00110000,53,00110101
77,01001101,103,01100111,180,10110100
88,01011000,44,00101100,132,10000100
13,00001101,70,01000110,83,01010011
17,00010001,71,01000111,88,01011000
20,00010100,8,00001000,28,00011100
87,01010111,52,00110100,139,10001011
70,01000110,43,00101011,113,01110001
34,00100010,106,01101010,140,10001100
7,00000111,51,00110011,58,00111010
17,00010001,106,01101010,123,01111011
60,00111100,108,01101100,168,10101000
3,00000011,87,01010111,90,01011010
86,01010110,107,01101011,193,11000001
20,00010100,78,01001110,98,01100010
126,01111110,91,01011011,217,11011001
40,00101000,114,01110010,154,10011010
19,00010011,3,00000011,22,00010110
121,01111001,11,00001011,132,10000100
63,00111111,20,00010100,83,01010011
112,01110000,10,00001010,122,01111010
115,01110011,88,01011000,203,11001011
119,01110111,91,01011011,210,11010010
83,01010011,106,01101010,189,10111101
22,00010110,90,01011010,112,01110000
97,01100001,33,00100001,130,10000010
26,00011010,78,01001110,104,01101000
93,01011101,6,00000110,99,01100011
45,00101101,40,00101000,85,01010101
84,01010100,54,00110110,138,10001010
41,00101001,71,01000111,112,01110000
68,01000100,123,01111011,191,10111111
53,00110101,109,01101101,162,10100010
68,01000100,37,00100101,105,01101001
98,01100010,11,00001011,109,01101101
125,01111101,108,01101100,233,11101001
112,01110000,82,01010010,194,11000010
96,01100000,68,01000100,164,10100100
48,00110000,40,00101000,88,01011000
79,01001111,112,01110000,191,10111111
0,00000000,42,00101010,42,00101010
7,00000111,18,00010010,25,00011001
126,01111110,71,01000111,197,11000101
35,00100011,25,00011001,60,00111100
8,00001000,104,01101000,112,01110000
108,01101100,32,00100000,140,10001100
44,00101100,57,00111001,101,01100101
79,01001111,89,01011001,168,10101000
93,01011101,14,00001110,107,01101011
16,00010000,61,00111101,77,01001101
126,01111110,22,00010110,148,10010100
41,00101001,62,00111110,103,01100111
106,01101010,119,01110111,225,11100001
61,00111101,3,00000011,64,01000000
16,00010000,67,01000011,83,01010011
91,01011011,117,01110101,208,11010000
51,00110011,118,01110110,169,10101001
65,01000001,10,00001010,75,01001011
107,01101011,70,01000110,177,10110001
6,00000110,113,01110001,119,01110111
69,01000101,68,01000100,137,10001001
103,01100111,116,01110100,219,11011011
77,01001101,88,01011000,165,10100101
39,00100111,108,01101100,147,10010011
95,01011111,85,01010101,180,10110100
37,00100101,22,00010110,59,00111011
19,00010011,102,01100110,121,01111001
0,00000000,100,01100100,100,01100100
88,01011000,116,01110100,204,11001100
0,00000000,107,01101011,107,01101011
117,01110101,61,00111101,178,10110010
23,00010111,84,01010100,107,01101011
115,01110011,4,00000100,119,01110111
70,01000110,73,01001001,143,10001111
100,01100100,115,01110011,215,11010111
53,00110101,117,01110101,170,10101010
125,01111101,121,01111001,246,11110110
79,01001111,59,00111011,138,10001010
4,00000100,94,01011110,98,01100010
56,00111000,63,00111111,119,01110111
36,00100100,8,00001000,44,00101100
119,01110111,39,00100111,158,10011110
85,01010101,108,01101100,193,11000001
103,01100111,48,00110000,151,10010111
52,00110100,59,00111011,111,01101111
9,00001001,109,01101101,118,01110110
36,00100100,17,00010001,53,00110101
72,01001000,37,00100101,109,01101101
125,01111101,126,01111110,251,11111011
10,00001010,117,01110101,127,01111111
46,00101110,103,01100111,149,10010101
44,00101100,7,00000111,51,00110011
118,01110110,3,00000011,121,01111001
65,01000001,18,00010010,83,01010011
105,01101001,92,01011100,197,11000101
30,00011110,44,00101100,74,01001010
52,00110100,38,00100110,90,01011010
23,00010111,7,00000111,30,00011110
95,01011111,46,00101110,141,10001101
42,00101010,41,00101001,83,01010011
14,00001110,103,01100111,117,01110101
2,00000010,68,01000100,70,01000110
4,00000100,50,00110010,54,00110110
42,00101010,61,00111101,103,01100111
80,01010000,3,00000011,83,01010011
74,01001010,8,00001000,82,01010010
56,00111000,95,01011111,151,10010111
10,00001010,96,01100000,106,01101010
71,01000111,103,01100111,174,10101110
127,01111111,75,01001011,202,11001010
10,00001010,115,01110011,125,01111101
42,00101010,51,00110011,93,01011101
105,01101001,120,01111000,225,11100001
49,00110001,1,00000001,50,00110010
78,01001110,20,00010100,98,01100010
36,00100100,35,00100011,71,01000111
8,00001000,76,01001100,84,01010100
38,00100110,15,00001111,53,00110101
98,01100010,51,00110011,149,10010101
0,00000000,87,01010111,87,01010111
118,01110110,82,01010010,200,11001000
22,00010110,26,00011010,48,00110000
126,01111110,16,00010000,142,10001110
27,00011011,106,01101010,133,10000101
65,01000001,23,00010111,88,01011000
102,01100110,102,01100110,204,11001100
16,00010000,94,01011110,110,01101110
46,00101110,35,00100011,81,01010001
42,00101010,122,01111010,164,10100100
105,01101001,21,00010101,126,01111110
14,00001110,36,00100100,50,00110010
27,00011011,109,01101101,136,10001000
16,00010000,122,01111010,138,10001010
26,00011010,85,01010101,111,01101111
89,01011001,109,01101101,198,11000110
123,01111011,112,01110000,235,11101011
87,01010111,59,00111011,146,10010010
119,01110111,22,00010110,141,10001101
65,01000001,123,01111011,188,10111100
84,01010100,21,00010101,105,01101001
36,00100100,111,01101111,147,10010011
118,01110110,120,01111000,238,11101110
113,01110001,47,00101111,160,10100000
68,01000100,54,00110110,122,01111010
67,01000011,60,00111100,127,01111111
21,00010101,34,00100010,55,00110111
80,01010000,33,00100001,113,01110001
22,00010110,107,01101011,129,10000001
0,00000000,6,00000110,6,00000110
20,00010100,13,00001101,33,00100001
102,01100110,63,00111111,165,10100101
115,01110011,55,00110111,170,10101010
36,00100100,4,00000100,40,00101000
103,01100111,87,01010111,190,10111110
119,01110111,82,01010010,201,11001001
47,00101111,53,00110101,100,01100100
76,01001100,23,00010111,99,01100011
122,01111010,77,01001101,199,11000111
92,01011100,94,01011110,186,10111010
50,00110010,8,00001000,58,00111010
55,00110111,71,01000111,126,01111110
114,01110010,111,01101111,225,11100001
30,00011110,11,00001011,41,00101001
41,00101001,94,01011110,135,10000111
63,00111111,63,00111111,126,01111110
89,01011001,117,01110101,206,11001110
119,01110111,68,01000100,187,10111011
41,00101001,4,00000100,45,00101101
21,00010101,64,01000000,85,01010101
77,01001101,54,00110110,131,10000011
60,00111100,37,00100101,97,01100001
66,01000010,28,00011100,94,01011110
80,01010000,17,00010001,97,01100001
52,00110100,30,00011110,82,01010010
111,01101111,76,01001100,187,10111011
81,01010001,101,01100101,182,10110110
71,01000111,12,00001100,83,01010011
24,00011000,8,00001000,32,00100000
64,01000000,38,00100110,102,01100110
53,00110101,82,01010010,135,10000111
85,01010101,25,00011001,110,01101110
85,01010101,82,01010010,167,10100111
83,01010011,29,00011101,112,01110000
49,00110001,67,01000011,116,01110100
30,00011110,3,00000011,33,00100001
53,00110101,103,01100111,156,10011100
20,00010100,115,01110011,135,10000111
6,00000110,56,00111000,62,00111110
42,00101010,22,00010110,64,01000000
108,01101100,44,00101100,152,10011000
106,01101010,123,01111011,229,11100101
14,00001110,45,00101101,59,00111011
48,00110000,104,01101000,152,10011000
10,00001010,51,00110011,61,00111101
86,01010110,127,01111111,213,11010101
65,01000001,94,01011110,159,10011111
109,01101101,64,01000000,173,10101101
48,00110000,80,01010000,128,10000000
114,01110010,82,01010010,196,11000100
68,01000100,65,01000001,133,10000101
21,00010101,1,00000001,22,00010110
64,01000000,109,01101101,173,10101101
21,00010101,93,01011101,114,01110010
79,01001111,59,00111011,138,10001010
11,00001011,72,01001000,83,01010011
0,00000000,1,00000001,1,00000001
114,01110010,15,00001111,129,10000001
80,01010000,51,00110011,131,10000011
73,01001001,110,01101110,183,10110111
104,01101000,4,00000100,108,01101100
5,00000101,104,01101000,109,01101101
34,00100010,109,01101101,143,10001111
8,00001000,21,00010101,29,00011101
84,01010100,97,01100001,181,10110101
68,01000100,125,01111101,193,11000001
48,00110000,75,01001011,123,01111011
45,00101101,102,01100110,147,10010011
117,01110101,60,00111100,177,10110001
4,00000100,54,00110110,58,00111010
110,01101110,115,01110011,225,11100001
93,01011101,106,01101010,199,11000111
48,00110000,83,01010011,131,10000011
3,00000011,35,00100011,38,00100110
102,01100110,15,00001111,117,01110101
22,00010110,44,00101100,66,01000010
11,00001011,8,00001000,19,00010011
108,01101100,27,00011011,135,10000111
116,01110100,40,00101000,156,10011100
14,00001110,71,01000111,85,01010101
21,00010101,20,00010100,41,00101001
117,01110101,105,01101001,222,11011110
83,01010011,2,00000010,85,01010101
32,00100000,20,00010100,52,00110100
7,00000111,63,00111111,70,01000110
97,01100001,47,00101111,144,10010000
55,00110111,93,01011101,148,10010100
42,00101010,0,00000000,42,00101010
82,01010010,1,00000001,83,01010011
11,00001011,127,01111111,138,10001010
114,01110010,29,00011101,143,10001111
99,01100011,18,00010010,117,01110101
14,00001110,103,01100111,117,01110101
95,01011111,41,00101001,136,10001000
120,01111000,96,01100000,216,11011000
119,01110111,12,00001100,131,10000011
70,01000110,105,01101001,175,10101111
105,01101001,8,00001000,113,01110001
109,01101101,98,01100010,207,11001111
80,01010000,45,00101101,125,01111101
8,00001000,61,00111101,69,01000101
107,01101011,10,00001010,117,01110101
24,00011000,98,01100010,122,01111010
95,01011111,6,00000110,101,01100101
16,00010000,61,00111101,77,01001101
125,01111101,72,01001000,197,11000101
1,00000001,126,01111110,127,01111111
112,01110000,57,00111001,169,10101001
7,00000111,66,01000010,73,01001001
79,01001111,86,01010110,165,10100101
114,01110010,96,01100000,210,11010010
40,00101000,79,01001111,119,01110111
18,00010010,43,00101011,61,00111101
55,00110111,102,01100110,157,10011101
28,00011100,21,00010101,49,00110001
62,00111110,64,01000000,126,01111110
120,01111000,103,01100111,223,11011111
113,01110001,26,00011010,139,10001011
34,00100010,115,01110011,149,10010101
64,01000000,33,00100001,97,01100001
118,01110110,13,00001101,131,10000011
102,01100110,66,01000010,168,10101000
48,00110000,73,01001001,121,01111001
114,01110010,8,00001000,122,01111010
97,01100001,81,01010001,178,10110010
80,01010000,41,00101001,121,01111001
93,01011101,9,00001001,102,01100110
88,01011000,82,01010010,170,10101010
73,01001001,122,01111010,195,11000011
75,01001011,81,01010001,156,10011100
12,00001100,120,01111000,132,10000100
108,01101100,84,01010100,192,11000000
46,00101110,58,00111010,104,01101000
105,01101001,125,01111101,230,11100110
84,01010100,15,00001111,99,01100011
116,01110100,37,00100101,153,10011001
119,01110111,11,00001011,130,10000010
53,00110101,110,01101110,163,10100011
5,00000101,62,00111110,67,01000011
61,00111101,73,01001001,134,10000110
50,00110010,95,01011111,145,10010001
59,00111011,104,01101000,163,10100011
11,00001011,53,00110101,64,01000000
39,00100111,16,00010000,55,00110111
11,00001011,52,00110100,63,00111111
26,00011010,17,00010001,43,00101011
105,01101001,39,00100111,144,10010000
88,01011000,112,01110000,200,11001000
52,00110100,13,00001101,65,01000001
121,01111001,62,00111110,183,10110111
76,01001100,74,01001010,150,10010110
105,01101001,110,01101110,215,11010111
97,01100001,54,00110110,151,10010111
125,01111101,12,00001100,137,10001001
39,00100111,60,00111100,99,01100011
11,00001011,119,01110111,130,10000010
79,01001111,40,00101000,119,01110111
95,01011111,49,00110001,144,10010000
116,01110100,37,00100101,153,10011001
96,01100000,19,00010011,115,01110011
50,00110010,17,00010001,67,01000011
114,01110010,88,01011000,202,11001010
118,01110110,24,00011000,142,10001110
105,01101001,119,01110111,224,11100000
52,00110100,27,00011011,79,01001111
93,01011101,37,00100101,130,10000010
33,00100001,78,01001110,111,01101111
67,01000011,9,00001001,76,01001100
82,01010010,126,01111110,208,11010000
84,01010100,69,01000101,153,10011001
49,00110001,79,01001111,128,10000000
76,01001100,84,01010100,160,10100000
81,01010001,56,00111000,137,10001001
115,01110011,92,01011100,207,11001111
2,00000010,12,00001100,14,00001110
98,01100010,36,00100100,134,10000110
104,01101000,51,00110011,155,10011011
35,00100011,84,01010100,119,01110111
113,01110001,60,00111100,173,10101101
17,00010001,37,00100101,54,00110110
86,01010110,111,01101111,197,11000101
56,00111000,105,01101001,161,10100001
10,00001010,76,01001100,86,01010110
19,00010011,10,00001010,29,00011101
114,01110010,5,00000101,119,01110111
83,01010011,98,01100010,181,10110101
1,00000001,115,01110011,116,01110100
55,00110111,90,01011010,145,10010001
6,00000110,69,01000101,75,01001011
112,01110000,28,00011100,140,10001100
47,00101111,87,01010111,134,10000110
12,00001100,107,01101011,119,01110111
36,00100100,125,01111101,161,10100001
47,00101111,80,01010000,127,01111111
88,01011000,1,00000001,89,01011001
115,01110011,60,00111100,175,10101111
49,00110001,44,00101100,93,01011101
7,00000111,32,00100000,39,00100111
43,00101011,2,00000010,45,00101101
86,01010110,66,01000010,152,10011000
81,01010001,39,00100111,120,01111000
87,01010111,11,00001011,98,01100010
15,00001111,79,01001111,94,01011110
126,01111110,127,01111111,253,11111101
12,00001100,19,00010011,31,00011111
72,01001000,59,00111011,131,10000011
23,00010111,57,00111001,80,01010000
89,01011001,30,00011110,119,01110111
96,01100000,83,01010011,179,10110011
22,00010110,68,01000100,90,01011010
89,01011001,13,00001101,102,01100110
115,01110011,40,00101000,155,10011011
81,01010001,57,00111001,138,10001010
123,01111011,41,00101001,164,10100100
92,01011100,106,01101010,198,11000110
107,01101011,59,00111011,166,10100110
72,01001000,68,01000100,140,10001100
82,01010010,115,01110011,197,11000101
43,00101011,19,00010011,62,00111110
126,01111110,121,01111001,247,11110111
88,01011000,49,00110001,137,10001001
87,01010111,40,00101000,127,01111111
53,00110101,89,01011001,142,10001110
77,01001101,121,01111001,198,11000110
51,00110011,30,00011110,81,01010001
22,00010110,15,00001111,37,00100101
24,00011000,42,00101010,66,01000010
27,00011011,47,00101111,74,01001010
105,01101001,104,01101000,209,11010001
121,01111001,61,00111101,182,10110110
117,01110101,47,00101111,164,10100100
122,01111010,117,01110101,239,11101111
57,00111001,17,00010001,74,01001010
0,00000000,8,00001000,8,00001000
56,00111000,4,00000100,60,00111100
66,01000010,27,00011011,93,01011101
24,00011000,0,00000000,24,00011000
49,00110001,109,01101101,158,10011110
127,01111111,106,01101010,233,11101001
125,01111101,18,00010010,143,10001111
105,01101001,54,00110110,159,10011111
100,01100100,68,01000100,168,10101000
105,01101001,26,00011010,131,10000011
112,01110000,34,00100010,146,10010010
34,00100010,35,00100011,69,01000101
16,00010000,77,01001101,93,01011101
100,01100100,78,01001110,178,10110010
112,01110000,84,01010100,196,11000100
79,01001111,30,00011110,109,01101101
58,00111010,115,01110011,173,10101101
77,01001101,77,01001101,154,10011010
17,00010001,112,01110000,129,10000001
106,01101010,124,01111100,230,11100110
97,01100001,60,00111100,157,10011101
76,01001100,28,00011100,104,01101000
70,01000110,5,00000101,75,01001011
43,00101011,43,00101011,86,01010110
115,01110011,18,00010010,133,10000101
30,00011110,58,00111010,88,01011000
39,00100111,35,00100011,74,01001010
21,00010101,14,00001110,35,00100011
17,00010001,95,01011111,112,01110000
120,01111000,103,01100111,223,11011111
71,01000111,4,00000100,75,01001011
74,01001010,23,00010111,97,01100001
92,01011100,19,00010011,111,01101111
106,01101010,93,01011101,199,11000111
107,01101011,77,01001101,184,10111000
8,00001000,89,01011001,97,01100001
98,01100010,87,01010111,185,10111001
23,00010111,21,00010101,44,00101100
31,00011111,46,00101110,77,01001101
116,01110100,51,00110011,167,10100111
0,00000000,57,00111001,57,00111001
109,01101101,105,01101001,214,11010110
87,01010111,111,01101111,198,11000110
57,00111001,5,00000101,62,00111110
15,00001111,63,00111111,78,01001110
71,01000111,63,00111111,134,10000110
56,00111000,122,01111010,178,10110010
118,01110110,30,00011110,148,10010100
55,00110111,95,01011111,150,10010110
2,00000010,104,01101000,106,01101010
38,00100110,0,00000000,38,00100110
7,00000111,105,01101001,112,01110000
119,01110111,15,00001111,134,10000110
56,00111000,116,01110100,172,10101100
66,01000010,114,01110010,180,10110100
36,00100100,87,01010111,123,01111011
36,00100100,29,00011101,65,01000001
23,00010111,18,00010010,41,00101001
21,00010101,104,01101000,125,01111101
99,01100011,81,01010001,180,10110100
36,00100100,101,01100101,137,10001001
9,00001001,87,01010111,96,01100000
112,01110000,95,01011111,207,11001111
17,00010001,77,01001101,94,01011110
112,01110000,47,00101111,159,10011111
45,00101101,21,00010101,66,01000010
35,00100011,24,00011000,59,00111011
89,01011001,72,01001000,161,10100001
25,00011001,116,01110100,141,10001101
109,01101101,111,01101111,220,11011100
32,00100000,117,01110101,149,10010101
6,00000110,121,01111001,127,01111111
68,01000100,50,00110010,118,01110110
24,00011000,1,00000001,25,00011001
1,00000001,28,00011100,29,00011101
96,01100000,38,00100110,134,10000110
66,01000010,117,01110101,183,10110111
109,01101101,39,00100111,148,10010100
83,01010011,125,01111101,208,11010000
126,01111110,30,00011110,156,10011100
46,00101110,15,00001111,61,00111101
98,01100010,54,00110110,152,10011000
35,00100011,80,01010000,115,01110011
51,00110011,117,01110101,168,10101000
71,01000111,96,01100000,167,10100111
16,00010000,113,01110001,129,10000001
81,01010001,50,00110010,131,10000011
43,00101011,4,00000100,47,00101111
86,01010110,109,01101101,195,11000011
101,01100101,52,00110100,153,10011001
97,01100001,18,00010010,115,01110011
8,00001000,127,01111111,135,10000111
88,01011000,74,01001010,162,10100010
68,01000100,13,00001101,81,01010001
56,00111000,122,01111010,178,10110010
26,00011010,64,01000000,90,01011010
1,00000001,20,00010100,21,00010101
11,00001011,73,01001001,84,01010100
6,00000110,60,00111100,66,01000010
120,01111000,88,01011000,208,11010000
44,00101100,15,00001111,59,00111011
44,00101100,11,00001011,55,00110111
11,00001011,23,00010111,34,00100010
99,01100011,110,01101110,209,11010001
31,00011111,93,01011101,124,01111100
50,00110010,9,00001001,59,00111011
107,01101011,80,01010000,187,10111011
65,01000001,10,00001010,75,01001011
80,01010000,99,01100011,179,10110011
105,01101001,84,01010100,189,10111101
4,00000100,20,00010100,24,00011000
121,01111001,71,01000111,192,11000000
3,00000011,65,01000001,68,01000100
6,00000110,41,00101001,47,00101111
121,01111001,17,00010001,138,10001010
110,01101110,20,00010100,130,10000010
57,00111001,98,01100010,155,10011011
105,01101001,67,01000011,172,10101100
126,01111110,21,00010101,147,10010011
123,01111011,9,00001001,132,10000100
42,00101010,41,00101001,83,01010011
112,01110000,112,01110000,224,11100000
5,00000101,52,00110100,57,00111001
11,00001011,78,01001110,89,01011001
53,00110101,113,01110001,166,10100110
13,00001101,100,01100100,113,01110001
117,01110101,89,01011001,206,11001110
96,01100000,72,01001000,168,10101000
23,00010111,22,00010110,45,00101101
54,00110110,90,01011010,144,10010000
71,01000111,122,01111010,193,11000001
50,00110010,38,00100110,88,01011000
113,01110001,15,00001111,128,10000000
117,01110101,53,00110101,170,10101010
91,01011011,107,01101011,198,11000110
106,01101010,0,00000000,106,01101010
37,00100101,71,01000111,108,01101100
85,01010101,52,00110100,137,10001001
73,01001001,88,01011000,161,10100001
69,01000101,112,01110000,181,10110101
81,01010001,26,00011010,107,01101011
57,00111001,92,01011100,149,10010101
36,00100100,56,00111000,92,01011100
74,01001010,41,00101001,115,01110011
41,00101001,16,00010000,57,00111001
124,01111100,98,01100010,222,11011110
56,00111000,78,01001110,134,10000110
16,00010000,101,01100101,117,01110101
91,01011011,28,00011100,119,01110111
36,00100100,110,01101110,146,10010010
123,01111011,106,01101010,229,11100101
50,00110010,36,00100100,86,01010110
111,01101111,126,01111110,237,11101101
126,01111110,49,00110001,175,10101111
74,01001010,44,00101100,118,01110110
110,01101110,59,00111011,169,10101001
120,01111000,119,01110111,239,11101111
71,01000111,70,01000110,141,10001101
1,00000001,114,01110010,115,01110011
10,00001010,32,00100000,42,00101010
33,00100001,4,00000100,37,00100101
41,00101001,85,01010101,126,01111110
75,01001011,51,00110011,126,01111110
109,01101101,23,00010111,132,10000100
24,00011000,76,01001100,100,01100100
99,01100011,84,01010100,183,10110111
72,01001000,69,01000101,141,10001101
104,01101000,26,00011010,130,10000010
21,00010101,46,00101110,67,01000011
76,01001100,53,00110101,129,10000001
49,00110001,4,00000100,53,00110101
1,00000001,119,01110111,120,01111000
27,00011011,75,01001011,102,01100110
3,00000011,92,01011100,95,01011111
44,00101100,76,01001100,120,01111000
90,01011010,29,00011101,119,01110111
34,00100010,38,00100110,72,01001000
47,00101111,115,01110011,162,10100010
116,01110100,54,00110110,170,10101010
68,01000100,23,00010111,91,01011011
84,01010100,65,01000001,149,10010101
97,01100001,52,00110100,149,10010101
24,00011000,48,00110000,72,01001000
83,01010011,33,00100001,116,01110100
39,00100111,14,00001110,53,00110101
8,00001000,31,00011111,39,00100111
21,00010101,105,01101001,126,01111110
65,01000001,84,01010100,149,10010101
0,00000000,35,00100011,35,00100011
42,00101010,83,01010011,125,01111101
97,01100001,55,00110111,152,10011000
124,01111100,81,01010001,205,11001101
34,00100010,3,00000011,37,00100101
95,01011111,42,00101010,137,10001001
49,00110001,64,01000000,113,01110001
22,00010110,54,00110110,76,01001100
41,00101001,56,00111000,97,01100001
118,01110110,79,01001111,197,11000101
32,00100000,124,01111100,156,10011100
45,00101101,23,00010111,68,01000100
44,00101100,93,01011101,137,10001001
58,00111010,62,00111110,120,01111000
37,00100101,30,00011110,67,01000011
66,01000010,25,00011001,91,01011011
90,01011010,41,00101001,131,10000011
99,01100011,50,00110010,149,10010101
111,01101111,68,01000100,179,10110011
83,01010011,50,00110010,133,10000101
46,00101110,60,00111100,106,01101010
76,01001100,106,01101010,182,10110110
29,00011101,127,01111111,156,10011100
22,00010110,21,00010101,43,00101011
55,00110111,39,00100111,94,01011110
101,01100101,45,00101101,146,10010010
93,01011101,84,01010100,177,10110001
60,00111100,5,00000101,65,01000001
93,01011101,2,00000010,95,01011111
80,01010000,34,00100010,114,01110010
45,00101101,110,01101110,155,10011011
103,01100111,104,01101000,207,11001111
92,01011100,61,00111101,153,10011001
73,01001001,10,00001010,83,01010011
120,01111000,106,01101010,226,11100010
29,00011101,121,01111001,150,10010110
11,00001011,62,00111110,73,01001001
77,01001101,63,00111111,140,10001100
108,01101100,8,00001000,116,01110100
14,00001110,53,00110101,67,01000011
43,00101011,27,00011011,70,01000110
60,00111100,70,01000110,130,10000010
64,01000000,42,00101010,106,01101010
18,00010010,118,01110110,136,10001000
121,01111001,32,00100000,153,10011001
78,01001110,125,01111101,203,11001011
3,00000011,31,00011111,34,00100010
27,00011011,47,00101111,74,01001010
82,01010010,83,01010011,165,10100101
14,00001110,111,01101111,125,01111101
62,00111110,14,00001110,76,01001100
10,00001010,84,01010100,94,01011110
50,00110010,65,01000001,115,01110011
115,01110011,49,00110001,164,10100100
98,01100010,99,01100011,197,11000101
1,00000001,6,00000110,7,00000111
65,01000001,89,01011001,154,10011010
54,00110110,119,01110111,173,10101101
1,00000001,43,00101011,44,00101100
110,01101110,102,01100110,212,11010100
36,00100100,39,00100111,75,01001011
93,01011101,54,00110110,147,10010011
59,00111011,95,01011111,154,10011010
5,00000101,87,01010111,92,01011100
122,01111010,72,01001000,194,11000010
4,00000100,47,00101111,51,00110011
123,01111011,55,00110111,178,10110010
44,00101100,10,00001010,54,00110110
38,00100110,84,01010100,122,01111010
115,01110011,34,00100010,149,10010101
43,00101011,99,01100011,142,10001110
121,01111001,20,00010100,141,10001101
112,01110000,93,01011101,205,11001101
102,01100110,79,01001111,181,10110101
93,01011101,46,00101110,139,10001011
109,01101101,16,00010000,125,01111101
98,01100010,45,00101101,143,10001111
21,00010101,116,01110100,137,10001001
67,01000011,116,01110100,183,10110111
104,01101000,119,01110111,223,11011111
84,01010100,87,01010111,171,10101011
97,01100001,16,00010000,113,01110001
106,01101010,63,00111111,169,10101001
0,00000000,102,01100110,102,01100110
56,00111000,8,00001000,64,01000000
91,01011011,14,00001110,105,01101001
84,01010100,20,00010100,104,01101000
99,01100011,85,01010101,184,10111000
22,00010110,117,01110101,139,10001011
73,01001001,104,01101000,177,10110001
75,01001011,111,01101111,186,10111010
56,00111000,24,00011000,80,01010000
89,01011001,15,00001111,104,01101000
104,01101000,64,01000000,168,10101000
38,00100110,96,01100000,134,10000110
50,00110010,14,00001110,64,01000000
32,00100000,114,01110010,146,10010010
25,00011001,54,00110110,79,01001111
25,00011001,80,01010000,105,01101001
119,01110111,114,01110010,233,11101001
82,01010010,101,01100101,183,10110111
90,01011010,11,00001011,101,01100101
52,00110100,62,00111110,114,01110010
72,01001000,3,00000011,75,01001011
43,00101011,25,00011001,68,01000100
116,01110100,18,00010010,134,10000110
122,01111010,67,01000011,189,10111101
17,00010001,14,00001110,31,00011111
118,01110110,63,00111111,181,10110101
115,01110011,67,01000011,182,10110110
9,00001001,20,00010100,29,00011101
28,00011100,66,01000010,94,01011110
94,01011110,126,01111110,220,11011100
47,00101111,58,00111010,105,01101001
47,00101111,63,00111111,110,01101110
21,00010101,43,00101011,64,01000000
31,00011111,4,00000100,35,00100011
24,00011000,82,01010010,106,01101010
121,01111001,20,00010100,141,10001101
2,00000010,76,01001100,78,01001110
43,00101011,30,00011110,73,01001001
103,01100111,33,00100001,136,10001000
86,01010110,67,01000011,153,10011001
105,01101001,125,01111101,230,11100110
75,01001011,79,01001111,154,10011010
86,01010110,22,00010110,108,01101100
98,01100010,27,00011011,125,01111101
26,00011010,108,01101100,134,10000110
19,00010011,10,00001010,29,00011101
96,01100000,118,01110110,214,11010110
111,01101111,40,00101000,151,10010111
92,01011100,33,00100001,125,01111101
98,01100010,41,00101001,139,10001011
99,01100011,108,01101100,207,11001111
66,01000010,80,01010000,146,10010010
11,00001011,0,00000000,11,00001011
94,01011110,54,00110110,148,10010100
81,01010001,75,01001011,156,10011100
85,01010101,5,00000101,90,01011010
58,00111010,18,00010010,76,01001100
48,00110000,41,00101001,89,01011001
127,01111111,105,01101001,232,11101000
10,00001010,78,01001110,88,01011000
54,00110110,29,00011101,83,01010011
92,01011100,33,00100001,125,01111101
15,00001111,49,00110001,64,01000000
11,00001011,72,01001000,83,01010011
61,00111101,82,01010010,143,10001111
45,00101101,48,00110000,93,01011101
120,01111000,13,00001101,133,10000101
110,01101110,22,00010110,132,10000100
33,00100001,38,00100110,71,01000111
54,00110110,118,01110110,172,10101100
26,00011010,61,00111101,87,01010111
62,00111110,113,01110001,175,10101111
32,00100000,20,00010100,52,00110100
125,01111101,6,00000110,131,10000011
45,00101101,100,01100100,145,10010001
119,01110111,84,01010100,203,11001011
10,00001010,54,00110110,64,01000000
74,01001010,33,00100001,107,01101011
26,00011010,121,01111001,147,10010011
71,01000111,116,01110100,187,10111011
113,01110001,9,00001001,122,01111010
51,00110011,77,01001101,128,10000000
34,00100010,116,01110100,150,10010110
3,00000011,6,00000110,9,00001001
91,01011011,45,00101101,136,10001000
114,01110010,58,00111010,172,10101100
88,01011000,88,01011000,176,10110000
67,01000011,17,00010001,84,01010100
12,00001100,16,00010000,28,00011100
54,00110110,43,00101011,97,01100001
74,01001010,56,00111000,130,10000010
8,00001000,8,00001000,16,00010000
90,01011010,19,00010011,109,01101101
74,01001010,62,00111110,136,10001000
31,00011111,46,00101110,77,01001101
97,01100001,12,00001100,109,01101101
58,00111010,93,01011101,151,10010111
55,00110111,49,00110001,104,01101000
83,01010011,47,00101111,130,10000010
48,00110000,119,01110111,167,10100111
118,01110110,51,00110011,169,10101001
63,00111111,66,01000010,129,10000001
119,01110111,103,01100111,222,11011110
36,00100100,23,00010111,59,00111011
53,00110101,10,00001010,63,00111111
41,00101001,53,00110101,94,01011110
47,00101111,40,00101000,87,01010111
39,00100111,88,01011000,127,01111111
65,01000001,54,00110110,119,01110111
91,01011011,46,00101110,137,10001001
